UI_ID,Caption,Character Count,Comments Count,Likes Count,Total Actions,Media Type,Includes Hashtag
CompanyJ_1,The New Years Party we want to see ,35,1340,198986,200326,video,FALSE
CompanyJ_2,"James Harden joins Kobe and MJ as 3rd player in last 30 years to drop 400 points in 10-game span, per Elias Sports Bureau",121,5240,447820,453060,image,FALSE
CompanyJ_3,Harden is in MVP form ,22,1880,278107,279987,image,FALSE
CompanyJ_4,Russ wishes everyone a Happy New Year and gives away his shoes to a lucky fan on the way out  (@brkicks),104,694,261846,262540,video,FALSE
CompanyJ_5,Jimmy Butler made his NBA debut on this day in 2012. His road to get there was incredible.  No. 73 SG in Texas  No D-I offers  Went to JuCo  Faxed acceptance to Marquette from McDonalds  Had no idea he was an NBA prospect,221,2223,536990,539213,image,FALSE
CompanyJ_6,KD showed this fan so much love  (via @jordanpruneau),53,2135,292894,295029,video,FALSE
CompanyJ_7,40.8 PPG over his last 10 games ,32,3348,295651,298999,image,FALSE
CompanyJ_8,The Bears remixed the Super Bowl Shuffle for 2019 #GridironHeights,66,1104,95838,96942,video,FALSE
CompanyJ_9,UCF finally loses ,18,2795,212893,215688,image,FALSE
CompanyJ_10,Dwayne Haskins and the Buckeyes win the Rose Bowl 28-23! ,57,845,183928,184773,image,FALSE
CompanyJ_11,GIANNIS ,8,5243,474809,480052,video,FALSE
CompanyJ_12,Kawhi dropped a career-high 45 points on the Jazz ,50,1277,191878,193155,video,FALSE
CompanyJ_13,Giannis dunked Jon Leuer back to 2018 ,38,478,103245,103723,video,FALSE
CompanyJ_14,"Tyler Trent, former Purdue student and Boilermakers superfan, has died at 20 years old. Tyler was an inspiration to all. This is his story ",139,561,110031,110592,video,FALSE
CompanyJ_15,Kobe and Vanessa announce theyre expecting their 4th baby girl ,63,9458,491949,501407,image,FALSE
CompanyJ_16,Whyd Plumlee do his own teammate like that? ,44,4397,329328,333725,video,FALSE
CompanyJ_17,"Things are getting chippy in LA. First Pat Bev and Embiid get into it, then Jimmy and Avery Bradley both get ejected ",117,2319,336930,339249,video,FALSE
CompanyJ_18,This Ben Simmons inbounds play ,31,7664,661020,668684,video,FALSE
CompanyJ_19,Chelsea signs Christian Pulisic from Dortmund for $73 million . The USMNT star will remain with BVB until this summer then join his new team (@brfootball),154,1528,176414,177942,image,FALSE
CompanyJ_20,Legendary 5x5 for Nurkic.,25,2814,411995,414809,image,FALSE
CompanyJ_21,"Raheem Sterling's 1-year-old son with an absolute BOOT  (via @sterling7, @brfootball)",85,2121,254127,256248,video,FALSE
CompanyJ_22,Remember the girl who wrote to Steph Curry asking why his sneakers werent available for girls? She got a Christmas surprise from the 2x MVP  @brkicks,149,800,179767,180567,video,FALSE
CompanyJ_23,The 2x league leader in interceptions raised the bar for cornerbacks. From B/R x @ford #PFHOF19,95,170,20117,20287,video,FALSE
CompanyJ_24,"After a convincing win over the Titans, NFL analyst Shaun O'Hara gives the Colts OLOTW for Week 17",98,148,14931,15079,video,FALSE
CompanyJ_25,@chrisjohnsontwo8 thinks it was rigged when John Ross broke his 4.24 40 time: The combine was getting boring ,109,530,72280,72810,video,FALSE
CompanyJ_26,Young Dirk or Doncic?,21,5865,412983,418848,image,FALSE
CompanyJ_27,Jarvis Landrys recruiting efforts havent gone unnoticed...,58,3408,308449,311857,image,FALSE
CompanyJ_28,These answers...Terry Rozier definitely doesn't watch TV ,57,1420,141425,142845,video,FALSE
CompanyJ_29,When you see yourself on the jumbotron ,39,2482,437452,439934,video,FALSE
CompanyJ_30,Russ hit Lance with the air guitar after PG scored on him ,58,9086,532835,541921,video,FALSE
CompanyJ_31,Lonzo denies Russ   Russ went 3-20 tonight and the Thunder still won.,69,3787,271449,275236,video,FALSE
CompanyJ_32,Embiid put up 42 & 18 tonight ,30,1413,277584,278997,image,FALSE
CompanyJ_33,"Respect, @deandrehopkins ",25,1363,266487,267850,image,FALSE
CompanyJ_34,The reigning MVP is on an absolute scoring tear. Rockets vs. Warriors tonight should be good ,93,823,96468,97291,video,FALSE
CompanyJ_35,Thoughts on the first round of voting results?,46,7752,422888,430640,carousel,FALSE
CompanyJ_36,Kawhi makes his return to San Antonio tonight ,46,865,280854,281719,image,FALSE
CompanyJ_37,3x Super Bowl champion 7x Pro Bowler Does Richard Seymour deserve your 2019 Pro Football Hall of Fame vote? #PFHOF19,116,111,15804,15915,video,FALSE
CompanyJ_38,Danny Ainge chimes in.,22,9747,365422,375169,image,FALSE
CompanyJ_39,The tribute video the Spurs really want to show ,48,2519,388328,390847,image,FALSE
CompanyJ_40,Kawhi gets booed on 1st bucket and Danny Green couldn't hold back a smile,73,1440,292730,294170,video,FALSE
CompanyJ_41,DeMar is ready for the Raptors ,31,970,232360,233330,video,FALSE
CompanyJ_42,Spurs fans chant traitor while Kawhi shoots FTs ,48,2004,114356,116360,video,FALSE
CompanyJ_43,DeMar did it all against his old squad ,39,2294,417722,420016,image,FALSE
CompanyJ_44,Kawhis mom was not having it with this Spurs fan  (via David Shetler/TW) *NSFW*,79,5789,503927,509716,video,FALSE
CompanyJ_45,JAMES HARDEN FOR THE WIN.,25,6026,355045,361071,video,FALSE
CompanyJ_46,Was KD not out of bounds here? ,31,11385,378977,390362,video,FALSE
CompanyJ_47,James Harden had words for Draymond Green right after the game-winner ,70,7684,512534,520218,video,FALSE
CompanyJ_48,James Harden wants it ,22,3355,472346,475701,image,FALSE
CompanyJ_49,Pop still has respect for Kawhi.,32,2357,408837,411194,image,FALSE
CompanyJ_50,He holds the league record for career receptions and receiving yards by a TE. Is Tony Gonzalez a first ballot Hall of Famer? From B/R x @ford #PFHOF19,150,186,17481,17667,video,FALSE
CompanyJ_51,"13 years since the 2006 Rose Bowl, arguably the greatest CFB game of all time  All 3 top Heisman candidates played  Highest rated BCS game in TV history  Vince Young: 467 yards, 3 TDs/0 TOs, inc. game winner with :19 left  62 players later appear in at least 1 NFL game",269,2912,337643,340555,image,FALSE
CompanyJ_52,This angle of Hardens game-winner  (via @colinfraser),53,1976,290085,292061,video,FALSE
CompanyJ_53,Club Dub was open for business 12x this season and Chicago is hoping its not over yet ,86,1335,106054,107389,video,FALSE
CompanyJ_54,D-Rose reflects on the initial results of this years All-Star Voting.,69,2153,386003,388156,image,FALSE
CompanyJ_55,Won 9 of 10 5th in PPG Career year for Luck  This offense makes the Colts dangerous ( @hulu),92,486,38956,39442,video,FALSE
CompanyJ_56,Kuzma trying to get more calls?  (via @kuz),43,2108,269856,271964,image,FALSE
CompanyJ_57,Giannis wants to go 1-on-1 with The Great One ,46,6851,556620,563471,image,FALSE
CompanyJ_58,Dipo called game but what if LaVines shot counted ,50,2302,383623,385925,video,FALSE
CompanyJ_59,"Everyone at TD Garden wanted Dirk to hit a 3, but he fell just short ",69,2276,361906,364182,video,FALSE
CompanyJ_60,Lakers fall to 1-4 without The King ,36,5009,315671,320680,image,FALSE
CompanyJ_61,LaMelo and SPIRE brought the show to Kentucky last night  @br_hoops,67,1195,145262,146457,video,FALSE
CompanyJ_62,"Triple-Double for Kyle Anderson, 17 assists for Kris Dunn. Dont ",64,1125,203065,204190,image,FALSE
CompanyJ_63,The journey to Atlanta starts today. Who will face off on Super Bowl Sunday?  ( @turbotax),90,618,61395,62013,video,FALSE
CompanyJ_64,Texans CB Johnathan Joseph didnt like T.Y. Hilton calling NRG his second home and said the comment was for clowns. This is how Hilton showed up for their matchup  (via @colts),175,1952,210218,212170,video,FALSE
CompanyJ_65,LaVar warming up to play MJ  @br_hoops,38,9542,363632,373174,video,FALSE
CompanyJ_66,Uber driver was talking smack about the Chargers until he found out who his passenger was  (via @iammelvingordoniii),116,7895,628340,636235,carousel,FALSE
CompanyJ_67,Houstons No. 1 hypeman  (via @thecheckdown),43,3569,313004,316573,video,FALSE
CompanyJ_68,OBJ catching passes from a new QB,33,1954,171133,173087,video,FALSE
CompanyJ_69,"Fans storm into AT&T Stadium for Cowboys-Seahawks  (via @jonmachota, @thecheckdown)",83,10559,402040,412599,video,FALSE
CompanyJ_70,Luck and the Colts punch the Texans out of the playoffs!,56,1528,155012,156540,video,FALSE
CompanyJ_71," ""BEAT THE TRAFFIC!"" This Colts fan in Houston was letting everyone have it (via DEExGUILL/TW)",94,5989,432661,438650,video,FALSE
CompanyJ_72,Shoutout @brkicks for hitting 1M followers ,43,402,133649,134051,carousel,FALSE
CompanyJ_73,Luka checked in with the cameraman after a bad collision ,57,2054,400847,402901,video,FALSE
CompanyJ_74,The Bucks arena played Kawhis laugh after Raptors turnover ,59,12839,543460,556299,video,FALSE
CompanyJ_75,Zions 360 dunk had Cameron Indoor Stadium LIVE  (via @alee923),62,3873,481041,484914,video,FALSE
CompanyJ_76,Dak powers the Cowboys to a win over the Seahawks!,50,1666,121582,123248,video,FALSE
CompanyJ_77,Dak sealed the win with a BIG TIME run  (via @nfl),50,3108,178684,181792,video,FALSE
CompanyJ_78,Embiid wants Simmons to shoot.,30,994,250016,251010,image,FALSE
CompanyJ_79,Playoff Dak in full effect ,27,1952,249837,251789,image,FALSE
CompanyJ_80,Steph tried Harden's step-back and got called for a travel ,59,19226,683035,702261,video,FALSE
CompanyJ_81,Steph dropped Justin Jackson with one jab step he also dropped 10 triples as the Warriors and Kings set the all-time record for threes (41) ,140,3910,394429,398339,video,FALSE
CompanyJ_82,"Dak: 226 yards, 2 TD Zeke: 169 yards, TD Coop: 7 catches, 106 yards  The young stars showed up in their first playoff win ",122,1228,174820,176048,image,FALSE
CompanyJ_83,Young Flash  @zmane2s game is too smooth. (@br_hoops),53,525,89451,89976,video,FALSE
CompanyJ_84,#NAME?,55,797,108741,109538,video,FALSE
CompanyJ_85,Curry thought he could get away with it ,40,4806,281293,286099,video,FALSE
CompanyJ_86,Philip Rivers and the Chargers fry the Ravens 23-17,51,1467,90029,91496,video,FALSE
CompanyJ_87,"When you go through life, everythings not gonna be perfect. D-Rose speaks to a young fan with Leukemia pregame  (via @timberwolves)",131,4236,659847,664083,video,FALSE
CompanyJ_88,Coach Harbaugh let Lamar work through the growing pains.,56,4147,341371,345518,image,FALSE
CompanyJ_89,"Breaking: Timberwolves have fired Tom Thibodeau, per @shamsnba and Jon Krawczynski",82,4481,289992,294473,image,FALSE
CompanyJ_90,Playoff Foles keeps the Eagles season alive!,44,3016,148036,151052,video,FALSE
CompanyJ_91,Cody Parkey's potential game-winning FG hits crossbar twice as Eagles advance to Divisional Round  (via @nfl),109,2509,136083,138592,video,FALSE
CompanyJ_92,All of Chicago.,15,3937,373717,377654,image,FALSE
CompanyJ_93,Whos advancing to the Conference Championship? ,47,2550,147630,150180,carousel,FALSE
CompanyJ_94,Coach Thibs time in Minnesota is up!,36,326,62894,63220,video,FALSE
CompanyJ_95,D-Wade x Trae Young jersey exchange ,36,581,229627,230208,image,FALSE
CompanyJ_96,Millidelphia ,13,1777,328556,330333,image,FALSE
CompanyJ_97,More accomplishments for Flash  #OneLastDance,45,2469,369913,372382,image,FALSE
CompanyJ_98,Beasley told the ref he wanted to fight KAT then the ref gave KAT a tech ,73,4995,597140,602135,video,FALSE
CompanyJ_99,Kemba comes up clutch with the nasty step back ,47,1273,178165,179438,video,FALSE
CompanyJ_100,The Mamba offers his words of wisdom even though hes an Eagles fan.,67,3010,342423,345433,image,FALSE
CompanyJ_101,The legendary @tonyhawk breaks down some of his best moves  (via @skatejam),75,542,53213,53755,video,FALSE
CompanyJ_102,The NFL officially changes Cody Parkeys missed FG to a blocked kick by Treyvon Hester,85,3825,322093,325918,image,FALSE
CompanyJ_103,@stephencurry30 had these high school basketball teams hype after surprising them with 250+ pairs of the Curry 6  (@brkicks),124,165,25723,25888,video,FALSE
CompanyJ_104,Everyone wants to dance like Lance ,35,1145,187935,189080,video,FALSE
CompanyJ_105,DeMar and Coach Casey reunite  (via @nba),41,1363,295278,296641,video,FALSE
CompanyJ_106,The Brow breaks out the Shammgod ,33,1214,140407,141621,video,FALSE
CompanyJ_107,HARDEN DROPPED HIM.,19,10263,486090,496353,video,FALSE
CompanyJ_108,Fox told Vuc dont jump after he posterized him ,47,1761,245563,247324,video,FALSE
CompanyJ_109,Clemson adds its 2nd title to the Dabo Era!,43,1338,334732,336070,image,FALSE
CompanyJ_110,Theres a new dynasty in college football,40,861,145458,146319,video,FALSE
CompanyJ_111,Clemson has Bama's number ,26,1589,264105,265694,image,FALSE
CompanyJ_112,"What a night for the freshman.  347 yards, 3 TDs. 1 National Championship.",74,3408,423700,427108,image,FALSE
CompanyJ_113,Trevor Lawrence left Clemson fans starstruck ,45,1272,144113,145385,video,FALSE
CompanyJ_114,Career-high for Capela. Hes been EATING ,40,940,162131,163071,image,FALSE
CompanyJ_115,Which Harden ankle breaker was better? ,39,3059,153288,156347,video,FALSE
CompanyJ_116,"8 years ago today: Marshawn Lynchs Beast Quake, one of the greatest runs ever (via @nflthrowback)",97,3678,288696,292374,video,FALSE
CompanyJ_117,Trevor wants to fill up the trophy case ,40,1678,315926,317604,image,FALSE
CompanyJ_118,"Arizona Cardinals are hiring USC OC Kliff Kingsbury as their next head coach, per Peter Schrager",96,1501,159663,161164,image,FALSE
CompanyJ_119,The top playoff seeds spent the bye week trying to not freak out  #GridironHeights,82,1474,139109,140583,video,FALSE
CompanyJ_120,"7 years ago today, Tim Tebow threw for a career-high 316 yards + 2 TDs and led the Broncos to a 29-23 OT playoff win over Big Ben and the Steelers",146,3424,283567,286991,image,FALSE
CompanyJ_121,Zion is dunking everything ,27,760,134554,135314,video,FALSE
CompanyJ_122,Where does Embiids skill set rank among big men?,48,2223,264281,266504,image,FALSE
CompanyJ_123,Tonight could be Vince Carters last trip to Toronto. Never forget his 7 years up North:  5x All-Star  1999 Rookie of the Year  Helped the Raptors to their first ever playoff appearance in 2000  Threw down arguably the most memorable jam ever in the 2000 Dunk Contest,266,1205,322972,324177,image,FALSE
CompanyJ_124,"Not a bad night for Zion: 30 points (13-16), 10 boards, 5 assist, 4 steals. First Duke freshman in history to record 30/10/5 ",125,2586,447125,449711,image,FALSE
CompanyJ_125,"Prayers up for Nerlens Noel. The Thunder big man caught an elbow, hit his head and had to be stretchered off ",109,4777,492320,497097,video,FALSE
CompanyJ_126,The Joker gets the triple double and the tough game-winner ,59,928,175942,176870,video,FALSE
CompanyJ_127,"Sixers rookie @landryshamet hit 8 (!) threes tonight, so Embiid had to check his temperature ",93,1552,261915,263467,video,FALSE
CompanyJ_128,Russ went for the win...twice ,30,7979,298011,305990,video,FALSE
CompanyJ_129,"32-year-old Ryan Saunders, son of the late Flip Saunders, became the Timberwolves interim head coach after Thibs was fired on Sunday. Tonight he won his first game  (Via @timberwolves)",184,1317,287289,288606,video,FALSE
CompanyJ_130,Catch and shoot at its best.,28,4487,448142,452629,image,FALSE
CompanyJ_131,#NAME?,80,2575,289793,292368,image,FALSE
CompanyJ_132,"Sean Payton went into the Saints locker room with the Lombardi trophy on top of $225k in cash (Saints players SB bonus) and said Yall want this? Win 3 f--king games,"" per @nolalawyer",182,10336,516232,526568,image,FALSE
CompanyJ_133,Bucks vs. Rockets tonight. Who has the better MVP case?,55,2322,211854,214176,image,FALSE
CompanyJ_134,This Steelers Super Bowl XLIII hero knew they were going to winso he snuck his video camera onto the field at halftime ,119,185,49464,49649,video,FALSE
CompanyJ_135,Steph Curry is launching an 'Underrated Tour' to find overlooked high school prospects.  Curry was a 3-star recruit ranked 256th overall in the 2006 class,154,4129,381022,385151,image,FALSE
CompanyJ_136,Oubre slapped the floor then got scored on by Luka ,51,5957,463633,469590,video,FALSE
CompanyJ_137,The Beard has been on a tear lately ,36,1874,234988,236862,image,FALSE
CompanyJ_138,"Oakland As expect Kyler Murray to declare for NFL Draft, per susanslusser/Twitter",81,5941,367527,373468,image,FALSE
CompanyJ_139,The only way to stop Harden ,28,2834,168808,171642,video,FALSE
CompanyJ_140,Dame switched mid air ,22,1975,226513,228488,video,FALSE
CompanyJ_141,Harden is never trying to hear Sicko Mode again...,50,2987,313954,316941,video,FALSE
CompanyJ_142,"About a month ago, UCF QB McKenzie Milton almost lost his leg after a catastrophic knee injury. Today he leg pressed 40 pounds  (via @mckenziemil10)",148,1085,160367,161452,video,FALSE
CompanyJ_143,Lonzo was doing a little bit of everything tonight ,51,3327,375649,378976,video,FALSE
CompanyJ_144,Kyle Kuzma couldnt be stopped tonight ,38,1474,328370,329844,image,FALSE
CompanyJ_145,"95% of players surveyed think Colin Kaepernick should be on an NFL roster, per @theathletichq",93,13761,500840,514601,image,FALSE
CompanyJ_146,Lakers players shared their most common celebrity look-alike... cant unsee,74,4091,232134,236225,video,FALSE
CompanyJ_147,These fans traveled from Pakistan to see Giannis and all they wanted was photo proof of how huge his hands are (via @nba),121,1957,344621,346578,video,FALSE
CompanyJ_148,At least he was honest ,23,2147,376197,378344,image,FALSE
CompanyJ_149,Russell Wilson will join the Yankees for spring training,56,3685,382931,386616,image,FALSE
CompanyJ_150,"Tarik Cohen tried it, but then ended up getting mixed by a fan at the gym  (via @z.aia.merza, @nathanmihulet637)",112,2794,256979,259773,video,FALSE
CompanyJ_151,DeMar DeRozan. Goodness. ,25,732,146734,147466,video,FALSE
CompanyJ_152,They couldn't believe Tyler Johnson's tongue injury ,52,665,157670,158335,video,FALSE
CompanyJ_153,"Final score: Spurs 154, Thunder 147 in double OT  SA hit 14-straight 3's to start the game Four OKC players drop 20+ PTS LMA goes for a 50-piece Brodie records 24 PTS and 24 AST",177,3663,471369,475032,image,FALSE
CompanyJ_154,LMA with a career-high 56 in the win over the Thunder ,54,1865,339438,341303,image,FALSE
CompanyJ_155,"Drew Brees is the NFLs all-time passing leader, but never gets included in  talk. Is he the most underrated QB in history?",122,3864,160550,164414,video,FALSE
CompanyJ_156,"In 2001, Randy Moss wore custom Jordan 11s in the Divisional Round: 2 catches, 121 yards, 2 TD @brkicks  (via @nflthrowback)",124,2643,235864,238507,video,FALSE
CompanyJ_157,Have the Cardinals found the next Sean McVay in Kliff Kingsbury?,64,883,76560,77443,video,FALSE
CompanyJ_158,The Sixers are retiring the late Moses Malones number. One of the NBA/ABAs most underrated icons.  3x MVP 1983 Finals MVP  13x All-Star  9th in points  1st in off. rebounds  3rd in total rebounds,195,1730,291179,292909,image,FALSE
CompanyJ_159,"Zeke led the NFL in rushing yards this season (1,434), but will it be enough to get past the Rams?",98,357,26986,27343,video,FALSE
CompanyJ_160,"FSU coach Leonard Hamilton on Zion: The most phenomenal talent in the ACC since Michael Jordan."" (via @warchantofficial)",120,3726,461806,465532,image,FALSE
CompanyJ_161,Bill Belichick wins when it matters most.,41,457,61529,61986,video,FALSE
CompanyJ_162,Cam knows from experience.,26,8216,379092,387308,image,FALSE
CompanyJ_163,"KAT added a little extra, Dirk wasnt having it",46,3618,350092,353710,video,FALSE
CompanyJ_164,"TJ pulling Jimmy away after the elbow, Butler wasnt having it",61,2439,309444,311883,video,FALSE
CompanyJ_165,Ref made it look like he meant to fall,38,1292,210617,211909,video,FALSE
CompanyJ_166,Rose told Doncic to SIT DOWN.,29,5248,394346,399594,video,FALSE
CompanyJ_167,Luka is not a normal rookie. Wow.,33,5157,417930,423087,video,FALSE
CompanyJ_168,Might as well give the 19-year-old ROY now ,43,2927,421347,424274,image,FALSE
CompanyJ_169,Steph joins the top-3 already and he's only 30 ,47,2847,343985,346832,image,FALSE
CompanyJ_170,Spida vs. JaVale ,17,2256,255797,258053,video,FALSE
CompanyJ_171,What is going on in Indianapolis? (via @thecheckdown),53,7945,405419,413364,video,FALSE
CompanyJ_172,Scotty Pippen Jr is going to be a problem at Vanderbilt @br_hoops,65,1285,143926,145211,video,FALSE
CompanyJ_173,63 Spida climbed over 70 JaVale,31,1375,290009,291384,image,FALSE
CompanyJ_174,Is ketchup the secret fuel to Mahomes MVP-caliber season?,57,1020,108438,109458,video,FALSE
CompanyJ_175,"Mac McClung AT THE BUZZER in regulation, James Akinjo with 3 seconds left in OT ",80,1554,297143,298697,video,FALSE
CompanyJ_176,Curry and KD recruiting Lopez after this,40,2005,367961,369966,video,FALSE
CompanyJ_177,Was he even going for the ball? ,32,5543,385865,391408,image,FALSE
CompanyJ_178,Mahomes sidearm is unstoppable  (via @nfl),42,641,116563,117204,video,FALSE
CompanyJ_179,Devin Booker is pledging $2.5M over the next five years to Arizona kids and families in need ,93,2092,377380,379472,image,FALSE
CompanyJ_180,Mahomes and the Chiefs move on to the AFC Championship ,55,1906,201737,203643,video,FALSE
CompanyJ_181,Uncle Drew brought out the playground package against the Magic ,64,903,210648,211551,video,FALSE
CompanyJ_182,Tough day for Adam Vinatieri ,29,1924,225230,227154,video,FALSE
CompanyJ_183,Kyrie was frustrated with Gordon Hayward and Celtics' last shot ,64,5657,388305,393962,video,FALSE
CompanyJ_184,Russ had Belinelli on skates ,29,3341,340261,343602,video,FALSE
CompanyJ_185,This has been a WILD year for C.J. Anderson  Cut by Broncos  Benched and waived by Panthers  Waived by Raiders without one snap  Signed by Rams as Gurley insurance  Averaged 149.5 yards for L.A.  Playoff hero,208,2440,421306,423746,image,FALSE
CompanyJ_186,Rams advance to the NFC Championship.,37,1264,239704,240968,image,FALSE
CompanyJ_187,Bron in the Rams locker room after the W  (via @obeezy45),57,7922,576690,584612,video,FALSE
CompanyJ_188,T.O. has seen enough.,21,2340,216920,219260,image,FALSE
CompanyJ_189,#NAME?,46,4341,524542,528883,video,FALSE
CompanyJ_190,Kyrie speaks from experience,28,6112,394529,400641,image,FALSE
CompanyJ_191,Snoop Dogg commentating NHL is the best thing you'll hear today  (via @lakings),79,10413,565880,576293,video,FALSE
CompanyJ_192,DWade and Gabrielle Union were out their seats for @zmane2s finish @br_hoops,76,626,168800,169426,video,FALSE
CompanyJ_193,Rivers has been no match for Brady.,35,890,74910,75800,video,FALSE
CompanyJ_194,History  Sarah Thomas becomes the first woman to officiate an NFL playoff game in Chargers/Patriots.,100,7112,502151,509263,image,FALSE
CompanyJ_195,Klay been practicing to be a Warrior all his life (via @nbcsauthentic),70,784,271530,272314,video,FALSE
CompanyJ_196,Brady moves to 8-0 against Rivers as the Pats advance to the AFC Championship!,78,3305,391687,394992,image,FALSE
CompanyJ_197,The breakout superstar. The 41-year-old icon. A shot at the Super Bowl.,71,1552,187150,188702,image,FALSE
CompanyJ_198,"Kyler Murray wants a $15M contract from As to stick with baseball, otherwise hell enter NFL Draft tomorrow, per @mikelesliewfaa",127,9899,519070,528969,image,FALSE
CompanyJ_199,Greek Freak x Half-Man Half-Amazing jersey swap ,48,487,183984,184471,video,FALSE
CompanyJ_200,Saints advance to the NFC Championship!,39,2380,161169,163549,video,FALSE
CompanyJ_201,Brutal drop for Alshon. Incredible game clincher for Lattimore. (via @nfl),74,2247,172542,174789,video,FALSE
CompanyJ_202,Giants fans ecstatic ,21,3356,193473,196829,video,FALSE
CompanyJ_203,"Thats why they call him @cantguardmike  12 catches, 171 yards, 1 TD ",68,4597,469632,474229,image,FALSE
CompanyJ_204,Rematch in NOLA. Who ya got?,28,2452,189531,191983,image,FALSE
CompanyJ_205,"That was dirty, Luka.",21,1287,198064,199351,video,FALSE
CompanyJ_206,Curry. Clutch. Steph dropped 48 points and 11 threes against the Mavs ,70,3222,357814,361036,video,FALSE
CompanyJ_207,This is  (via @vol_hoops),25,3004,466589,469593,video,FALSE
CompanyJ_208,"With their loss to the Cavs at home tonight, the Lakers are now 3-7 without LeBron...",85,4696,417897,422593,image,FALSE
CompanyJ_209,Lakers GM Rob Pelinka pacing outside the arena after the Lakers loss to the Cavs... (via @lojomedia),100,7453,408553,416006,video,FALSE
CompanyJ_210,Brady is different in the postseason ,37,1173,103190,104363,video,FALSE
CompanyJ_211,AB to the Niners ,17,7573,377994,385567,image,FALSE
CompanyJ_212,The Cavs 3-1 comeback will live forever in history.,51,4791,377973,382764,image,FALSE
CompanyJ_213,Kyler Murray chose the gridiron over the baseball diamond...but did he make the right choice? Only time will tell.,114,772,82980,83752,video,FALSE
CompanyJ_214,Spurs fans gave Tony Parker a ton of love during his tribute video ,67,1224,259448,260672,carousel,FALSE
CompanyJ_215,"DOWN GOES DUKE  Syracuse upsets No. 1 Duke, 95-91",49,3798,331372,335170,image,FALSE
CompanyJ_216," ""Kyrie's leaving""  Celtics are getting blown out by the Nets and Brooklyn fans aren't holding back ",100,3941,344448,348389,video,FALSE
CompanyJ_217,The Beard continued his historic scoring tear with 57 points tonight. MVP? ,75,3493,278818,282311,image,FALSE
CompanyJ_218,57 PTS for The Beard. This man is unstoppable.,46,4232,238809,243041,video,FALSE
CompanyJ_219,57 points. It all makes sense. ,31,3119,453164,456283,image,FALSE
CompanyJ_220,Tony Parker and Pop share a moment after the game ,50,510,164735,165245,video,FALSE
CompanyJ_221,Joe Ingles blows a kiss to Pistons fans after sealing the win ,62,3579,393030,396609,video,FALSE
CompanyJ_222,Boban is the best  (via @nbatv),31,1651,217431,219082,video,FALSE
CompanyJ_223,"2009 (9.9 PPG, 3.2 RPG, 1.8 APG) vs 2019 (34.8 PPG, 6.3 RPG, 8.6 APG) ",70,3982,450446,454428,image,FALSE
CompanyJ_224,"6'1"" Fran Belibi threw down the first alley-oop in girls HS history. Now she wants to inspire other female hoopers  @br_hoops",125,1893,120357,122250,video,FALSE
CompanyJ_225,"She had him wobbly  (via @arianadossantos10, @brfootball)",57,1032,76809,77841,video,FALSE
CompanyJ_226,Kyrie clears the air.,21,2909,342445,345354,image,FALSE
CompanyJ_227,"In 2006, Drew Brees suffered a devastating shoulder injury and wasnt sure if hed ever play again  Today, he turns 40 with the most passing yards in NFL history.",160,1923,309058,310981,image,FALSE
CompanyJ_228,Clemson was treated to a McDonalds fast food cheat day at the White House ,74,5549,217794,223343,video,FALSE
CompanyJ_229,Chef Huncho ,12,5834,421771,427605,image,FALSE
CompanyJ_230,Nick Foles loses his powers at the #GridironHeights Elimination Club,68,1163,109141,110304,video,TRUE
CompanyJ_231,Pacers fans chanted John Wall hates you at Oubre and he missed both free throws ,80,3100,281805,284905,video,FALSE
CompanyJ_232,"Oct. 28, 2008 - Derrick Rose scores 11 points in his first NBA game  Jan. 15, 2019 - Derrick Rose scores his 10,000th point ",124,1332,313187,314519,image,FALSE
CompanyJ_233,The Sixers beat the Wolves by 42 points and Jimmy Butler looks very pleased ,76,1460,296677,298137,video,FALSE
CompanyJ_234,"Come on, Joel ",14,1460,331186,332646,image,FALSE
CompanyJ_235,#NAME?,51,1162,107657,108819,video,FALSE
CompanyJ_236,Stephs range is disrespectful.,30,2436,239310,241746,video,FALSE
CompanyJ_237,Ohio State backup QB Tate Martell announces transfer to University of Miami,75,4127,276823,280950,image,FALSE
CompanyJ_238,Klay had a dunkfest last night,30,445,82901,83346,video,FALSE
CompanyJ_239,"26 years ago today, Shaq and Jordan gave us an instant classic  Diesel: 29 PTS, 24 REB 5 BLK; Jordan: 64 PTS, 6 REB, 5 STL; Magic 128, Bulls 124",144,2548,280196,282744,image,FALSE
CompanyJ_240,One for the history books ,26,805,128622,129427,image,FALSE
CompanyJ_241,Jalen Hurts announces transfer to the University of Oklahoma,60,5809,399628,405437,image,FALSE
CompanyJ_242,Jalen Hurts next in line for the Heisman Trophy? ,49,1930,246633,248563,image,FALSE
CompanyJ_243,The most Belichick response ever (via @thecheckdown),52,1288,125013,126301,video,FALSE
CompanyJ_244,"Steven Jackson got a glimpse of life as a Patriot before an AFC Championship Game, and Bill Belichick had a surprise for him.",125,192,31150,31342,video,FALSE
CompanyJ_245,Hardens 50th point put him on SKATES,36,7287,254040,261327,video,FALSE
CompanyJ_246,"TALK TO EM, KYRIE.",18,5368,378859,384227,video,FALSE
CompanyJ_247,Harden is the new King of 50-point games ,41,3857,284074,287931,image,FALSE
CompanyJ_248,Turns out it was more difficult than Kyrie envisioned...,56,6820,634364,641184,image,FALSE
CompanyJ_249,Kyrie made the right decision ,30,708,115872,116580,video,FALSE
CompanyJ_250,Unconcious Curry hit 7 threes in a quarter,42,1141,113999,115140,video,FALSE
CompanyJ_251,Steph making sure he gets every three-point record ,51,1471,193018,194489,image,FALSE
CompanyJ_252,"Straight embarrassed his opponent with Mbappe  (via @lokelaniofficial, @brfootball)",83,8556,229032,237588,video,FALSE
CompanyJ_253,"In an era of GOAT debates, Muhammad Ali's status is unquestionable.  The People's Champion was born on this day in 1942.",120,1472,229362,230834,image,FALSE
CompanyJ_254, Franchise leader in points/assists/steals  12x All-Star  3x Champ  2006 Finals MVP  Happy 37th Birthday to @dwyanewade ,120,524,94756,95280,video,FALSE
CompanyJ_255,"Tatum and Doncic debuted the Nike Adapt BB, the first ever self-lacing basketball shoe, last night. @BRKicks",108,1404,227357,228761,carousel,FALSE
CompanyJ_256,These six players have been with their respective franchises for at least a decade #tenyearchallenge,100,3598,439358,442956,image,FALSE
CompanyJ_257,"D-Wade after going down 0-2 in the 2006 Finals: 42 PTS, W. 36 PTS, W. 43 PTS, W. 36 PTS, W. Flash turns 37 today ",113,2580,327503,330083,image,FALSE
CompanyJ_258,A class of 2nd graders wrote letters of encouragement to Alshon Jeffery after the Eagles' playoff loss  Today he surprised them with a visit  (via @jamieapody),159,1362,154659,156021,video,FALSE
CompanyJ_259,Knicks finding creative ways to lose,36,4395,270528,274923,video,FALSE
CompanyJ_260,"Please dont go, Pop ",20,2303,249513,251816,image,FALSE
CompanyJ_261,#NAME?,80,5467,551878,557345,video,FALSE
CompanyJ_262,He offered Giles a beer ,24,1284,159088,160372,video,FALSE
CompanyJ_263,Spicy P FOR THE WIN  @pskills43,31,1809,159575,161384,video,FALSE
CompanyJ_264,Michael Beasley was tryna get a fit off ,40,1446,116894,118340,video,FALSE
CompanyJ_265,Ja Morant is handing out POSTERS (via @racerathletics),54,595,89908,90503,video,FALSE
CompanyJ_266,#NAME?,40,3973,375070,379043,video,FALSE
CompanyJ_267,Todays the day: Boogies back ,29,11347,655587,666934,image,FALSE
CompanyJ_268,Cowboys fans when they hear theyre getting a new offensive coordinator next year:,81,3214,168297,171511,video,FALSE
CompanyJ_269,Patrick Mahomes has been unstoppable. A Super Bowl appearance would cap off a historic season.,94,247,32614,32861,video,FALSE
CompanyJ_270,Syracuse-bound Joe Girard III is averaging 46 PPG and decimating scoring records. (@slam_hs),92,1104,93036,94140,video,FALSE
CompanyJ_271,"John Calipari says Jimmy Butler bullied KAT in Minnesota.  Jimmys response: When you have as much talent as [Karl]...guys dont keep it real with him. I do, per Jackie MacMullan",176,2804,310147,312951,image,FALSE
CompanyJ_272,Luka Doncic: Early favorite for Rookie of the Year? @logic,58,2715,227115,229830,video,FALSE
CompanyJ_273,Mike Tyson says he tried acid at 11 and grew up being hypnotized that he was a ferocious animal in wild interview with @joerogan (LINK IN BIO),142,4761,471683,476444,image,FALSE
CompanyJ_274,Blake outside the perimeter is a regular now,44,4992,378879,383871,video,FALSE
CompanyJ_275,DLO WITH ICE IN HIS VEINS ,26,2823,225295,228118,video,FALSE
CompanyJ_276,Kyrie went full Uncle Drew mode in the 4Q ,42,931,176103,177034,video,FALSE
CompanyJ_277,BOOGIE IS BACK.,15,2747,373829,376576,image,FALSE
CompanyJ_278,Boogie came back with authority ,32,1047,125565,126612,video,FALSE
CompanyJ_279,Boogie looks ready to be the 4th Splash Bro ,44,1652,156542,158194,video,FALSE
CompanyJ_280,"Thor is really bad at soccer  (via @chrishemsworth, @brfootball)",64,913,99773,100686,video,FALSE
CompanyJ_281,"Todd Gurley is a touchdown machine, and C.J. Andersons emergence has made the Rams even more dangerous.",103,183,25477,25660,video,FALSE
CompanyJ_282,PAUL GEORGE. TOO CLUTCH.,24,5486,347115,352601,video,FALSE
CompanyJ_283,Raymond Felton thought PG had a headache.  PG was really just trying to make sure his line was straight ,104,1701,258384,260085,video,FALSE
CompanyJ_284,Philly is 0-19 against OKC since that date.,43,2288,317426,319714,image,FALSE
CompanyJ_285,Zion and Duke hand Virginia its first loss of the season ,57,1285,268721,270006,image,FALSE
CompanyJ_286,"PG and Terrance Ferguson hit the ""Blueface dance"" after the win (via @nba)",74,1112,113703,114815,video,FALSE
CompanyJ_287,This D-Wade Chicago Bulls tribute vid  @chancetherapper,55,591,118135,118726,video,FALSE
CompanyJ_288,Marcus Smart got ejected for charging at DeAndre' Bembry ,57,4808,304193,309001,video,FALSE
CompanyJ_289,"Two years ago today, Russell Westbrook got called for the most blatant walk of all time ",88,4030,364251,368281,video,FALSE
CompanyJ_290,Buddy Hield ran out of the gym after his game-winner ,53,3393,359543,362936,video,FALSE
CompanyJ_291,Kyries balance on this sequence was ridiculous.,47,1234,196425,197659,video,FALSE
CompanyJ_292,This guy @champagnepapi is making jokes out of the Drake curse ,63,6327,467633,473960,image,FALSE
CompanyJ_293,James Harden dropped 48. Eric Gordon forced OT. Big time Rockets win ,69,837,88641,89478,video,FALSE
CompanyJ_294,Josh Hart tried to guard Harden with his hands behind his back ,63,2390,109873,112263,video,FALSE
CompanyJ_295,Zylan Cheatham went Dwight Howard on this poster ,49,1955,210281,212236,video,FALSE
CompanyJ_296,Harden had himself a week ,26,1951,171996,173947,image,FALSE
CompanyJ_297,Jokic was trying to cop digits from the bench ,46,1739,246860,248599,video,FALSE
CompanyJ_298,"Brady is 24-4 in temperatures below 30 degrees: My mind doesnt slow down in the cold, but their bodies do, per @jayfeely",120,2255,285918,288173,image,FALSE
CompanyJ_299,"Be respectful out here, motherfker, KD wasnt playing when this fan took his hat *NSFW* (via @armando.chavez_)",109,5601,299291,304892,video,FALSE
CompanyJ_300,Nike and Kobe are up to something. @BRKicks,43,1324,194628,195952,image,FALSE
CompanyJ_301,Mahomes getting ready for the AFC Championship Game,51,3666,486076,489742,image,FALSE
CompanyJ_302,Antonio Brown getting in reps with Kyler Murray and Hollywood Brown  (via @ab),78,1219,163395,164614,video,FALSE
CompanyJ_303,Gumbos served.  Rams are going to the Super Bowl!,49,10096,385787,395883,image,FALSE
CompanyJ_304,Pick  Choppa. BIG TIME. (via @nfl),34,2274,128252,130526,video,FALSE
CompanyJ_305,LEGATRON.  57 yards in OT against the Saints. Greg Zuerlein is going down in the books (via @nfl),97,1568,106252,107820,video,FALSE
CompanyJ_306,Mood in NOLA right now ,23,3109,292469,295578,image,FALSE
CompanyJ_307,Rams went ALL IN to get to the Super Bowl.  Talib: Trade Peters: Trade Fowler: Trade Suh: $14M Shields: Hadnt played since 2016 Cooks: $50.5M guaranteed Gurley: Highest-paid RB ever Donald: Biggest defensive deal ever,217,3748,301005,304753,image,FALSE
CompanyJ_308,57-yard game winning FG for Greg the Leg ,41,2987,326446,329433,image,FALSE
CompanyJ_309,No one is happier for the Rams right now than @YG *NSFW* (via @defjam),70,3833,268381,272214,video,FALSE
CompanyJ_310,D-Rose. FOR THE WIN ,20,6356,480136,486492,video,FALSE
CompanyJ_311,The baddest motherfker on the planet. Tom Brady leads the Pats to another Super Bowl.,85,15524,567569,583093,image,FALSE
CompanyJ_312,Brady silences the haters again ,32,6885,265852,272737,video,FALSE
CompanyJ_313,"Patrick Mahomes magical first season as a starter: 50 TD (No. 1) 82 QBR (No. 1) 5,097 yards (No. 2) Chiefs 35.3 PPG (No. 1) MVP front-runner",140,5010,441686,446696,image,FALSE
CompanyJ_314,"Yeah, hes thinking hes back.",28,670,87291,87961,image,FALSE
CompanyJ_315,"Good luck, @rams @patriots ",27,1587,231196,232783,image,FALSE
CompanyJ_316,The real winner of tonights game.,33,6967,428793,435760,image,FALSE
CompanyJ_317,Brady and Belichick have done it again with their ninth AFC title. 3rd in a row 4th in five years 5th in eight years  Unprecedented. (via @nfl),143,1031,115933,116964,video,FALSE
CompanyJ_318,Still cant believe this... (via @rscheuermann),46,16294,454007,470301,video,FALSE
CompanyJ_319,"Thank you, MLK.",15,1141,145343,146484,video,FALSE
CompanyJ_320,The Franchise.,14,4299,288817,293116,image,FALSE
CompanyJ_321,s still going,13,9549,452737,462286,image,FALSE
CompanyJ_322,Russ let Frank know how good the pump fake was ,47,3900,316124,320024,video,FALSE
CompanyJ_323,Super Smash Bros. came out 20 years ago today   Favorite character? @brgaming,77,5088,181226,186314,image,FALSE
CompanyJ_324,Hes trying to hurt my rookie! Luka got pushed into a camerawoman and this Mavs fan was FURIOUS.,95,1213,270545,271758,video,FALSE
CompanyJ_325,"Breaking: The Rockets have agreed to trade Carmelo Anthony and cash to Chicago Bulls, per @wojespn",98,6556,339651,346207,image,FALSE
CompanyJ_326,30+ point games for DAngelo Russell  First three years: 7 This season: 8,72,3926,396364,400290,image,FALSE
CompanyJ_327,Which Melo was better? ,23,6842,361949,368791,image,FALSE
CompanyJ_328,Roy Williams really brought out the Off-White UNC Jordan 1s  @brkicks (Via @unc_basketball),91,3890,427092,430982,carousel,FALSE
CompanyJ_329,Kyrie always pulling out the playground moves.,46,1023,185799,186822,video,FALSE
CompanyJ_330,Refs really gave Faried a tech on his first bucket as a Rocket ,63,1717,184544,186261,video,FALSE
CompanyJ_331,James Harden tells TJ McConnell he's too small to be guarding him but he's not backing down.,92,4343,364888,369231,video,FALSE
CompanyJ_332,Corey Brewer doing the most to annoy Harden tonight ,52,6202,490056,496258,video,FALSE
CompanyJ_333,Embiid made sure to get a good look at Harden after he swatted his shot ,72,971,117140,118111,video,FALSE
CompanyJ_334,Klay is 10-10 from 3 and he's feelin' it.  Just flashed the money sign at Floyd Mayweather ,91,2082,213021,215103,video,FALSE
CompanyJ_335,STEPH NOOOOOOO,14,14568,533402,547970,video,FALSE
CompanyJ_336,Klay was unconscious in LA ,27,1610,278603,280213,image,FALSE
CompanyJ_337,Steph's spill was other-worldly ,32,3148,198915,202063,video,FALSE
CompanyJ_338,"13 years later, @kobebryants 81-point game is still mind-blowing ",65,1306,120594,121900,video,FALSE
CompanyJ_339,That handshake  (via @mannypacquiao),36,2643,298924,301567,video,FALSE
CompanyJ_340,USMNT legend Tim Howard announces his upcoming season will be his last (@brfootball),84,1154,153786,154940,image,FALSE
CompanyJ_341,"Saints vs. Rams was recreated in Madden...and the refs called pass interference  (via @realroflo, @cfloz09)",107,5580,269527,275107,video,FALSE
CompanyJ_342,The return GOAT Devin Hester runs one back in SBXLI (via @nflthrowback),71,1852,179119,180971,video,FALSE
CompanyJ_343,Saints fans during the game vs. after  (via damediddyrusell/Twitter),68,7246,261248,268494,video,FALSE
CompanyJ_344,@swipathefox thought he was just trying out Resident Evil 2.  Then we sent real zombies in to scare him ,104,459,56410,56869,video,FALSE
CompanyJ_345,"On the anniversary of Kobe's 81-point game, remember: Trailed by 18 in the 3rd Dropped 55 in the 2nd half Outscored teammates by 40 PTS 28-46 FG | 7-13 3PT | 18-20 FT",166,1809,237624,239433,image,FALSE
CompanyJ_346,Mariano Rivera becomes the first player in MLB history to get unanimously voted into the HOF ,93,2418,262568,264986,image,FALSE
CompanyJ_347,"""Clear eyes, full hearts, PRO BOWL!"" #GridironHeights",53,506,56255,56761,video,TRUE
CompanyJ_348,Russ had Dame stumblin ,23,2556,212933,215489,video,FALSE
CompanyJ_349,D-Rose on his 2011 MVP season: To be honest I think Im a better player now. My IQ is higher and I think I got the complete package now.,135,3103,461518,464621,image,FALSE
CompanyJ_350,Luka rips his jersey in half after missing the buzzer beater.,61,5937,352282,358219,video,FALSE
CompanyJ_351,Cooked em ,10,1454,201658,203112,video,FALSE
CompanyJ_352,Booker and Dieng got into it and he told him to meet him in the tunnel ,71,3181,243140,246321,video,FALSE
CompanyJ_353,Russ took off: 29/10/14 ,24,901,199643,200544,image,FALSE
CompanyJ_354,You can hear Russ and Nurkic fake laughing at each other ,57,1488,198180,199668,video,FALSE
CompanyJ_355,"4 years ago today: @klaythompson, one quarter, 37 PTS ",54,1365,157885,159250,video,FALSE
CompanyJ_356,KD has opened 'The Durant Center in Maryland to help low-income students get into college and graduate ,103,6655,449905,456560,image,FALSE
CompanyJ_357,DeAndre Jordan has a new routine at the free throw line,55,2348,338570,340918,video,FALSE
CompanyJ_358,"Thon Maker's cousin, Makur, is a 7-footer with guard skills  @br_hoops",70,2121,171610,173731,video,FALSE
CompanyJ_359,#NAME?,81,833,144902,145735,video,FALSE
CompanyJ_360,Players around the league send their best wishes to Victor Oladipo ,67,1046,164543,165589,video,FALSE
CompanyJ_361,Melo holds the record for scoring at MSG with 62. Harden has 36 at the HALF ,76,3570,219665,223235,video,FALSE
CompanyJ_362,SHEESH.,7,1488,181205,182693,video,FALSE
CompanyJ_363,Harden cooked up 61 at MSG ,27,5898,421973,427871,image,FALSE
CompanyJ_364,Reggie picked the worst possible time to video-bomb ,52,3454,339851,343305,video,FALSE
CompanyJ_365,He got caught ,14,7849,393918,401767,video,FALSE
CompanyJ_366,Classic Pop ,12,2838,450043,452881,image,FALSE
CompanyJ_367,"5 years ago today, Melo dropped 62 at The Garden.  Career High  Knicks franchise record. (via @nbatv)",101,3418,205923,209341,video,FALSE
CompanyJ_368,What @therealpjtucker17 saw last night ,39,1281,114108,115389,video,FALSE
CompanyJ_369,"Victor Oladipo is out for the season, suffered a ruptured quad tendon in his right knee last night",98,5274,309425,314699,image,FALSE
CompanyJ_370,I mean...,9,2737,304618,307355,image,FALSE
CompanyJ_371,"Rams HC Sean McVay turns 33 today  Graduated from college in 2008, became Bucs assistant WR coach  Became Redskins assistant TE coach in 2010, TE coach in 2011, OC in 2014.  Became youngest head coach ever in 2017, won Coach of the Year  Next week: Super Bowl LIII",264,1610,218602,220212,image,FALSE
CompanyJ_372,Stephen A. Smith is the favorite  @br_betting,45,2705,248357,251062,image,FALSE
CompanyJ_373,Former No. 1 Pick Anthony Bennett is putting up numbers in the G-League,71,1564,112130,113694,video,FALSE
CompanyJ_374,The Western Conference All-Star starters have been announced ,61,4230,174960,179190,video,FALSE
CompanyJ_375,Your Eastern Conference All-Star starters ,42,1633,104773,106406,video,FALSE
CompanyJ_376,The West All-Stars now belong to LeBron.,40,3184,191414,194598,video,FALSE
CompanyJ_377,Its kind of surreal. @_kw15 reacts to being named an #NBAAllStar starter which will be held in Charlotte. (via @nbaontnt),121,204,21758,21962,video,FALSE
CompanyJ_378,Steven Adams tried a euro and failed miserably ,47,4021,261831,265852,video,FALSE
CompanyJ_379,Warriors' visit to DC included paying a visit to President Barack Obama (via @loganmmurdock),92,8091,413723,421814,image,FALSE
CompanyJ_380,Wiggins almost ended McGee ,27,2020,197595,199615,video,FALSE
CompanyJ_381,#NAME?,80,354,39310,39664,video,FALSE
CompanyJ_382,Marcus Smarts impression of Jayson Tatum is on the money  (via @taycsnow),73,2359,296588,298947,video,FALSE
CompanyJ_383,"In 2012, Patriots LB Brandon Spikes was in tears after not making the Pro Bowl.  Tom Bradys response: You think I play this s--t to go to Pro Bowls?  Were trying to win rings, per Robert Klemko",193,4322,375097,379419,image,FALSE
CompanyJ_384,MVP Talk  @jharden13 X @future,30,1506,113136,114642,video,FALSE
CompanyJ_385,"D-Lo bench antics, one got him Td up ",37,746,153730,154476,video,FALSE
CompanyJ_386,Giannis got too cocky and missed a wide open dunk...,52,2533,192012,194545,video,FALSE
CompanyJ_387,The announcer lost his voice over this Miles Bridges putback ,61,1310,184655,185965,video,FALSE
CompanyJ_388,"Luka gets snuffed, hits clutch bucket to ice the game",53,3051,377617,380668,video,FALSE
CompanyJ_389,"James Harden closing out games on defense, shuts down Kawhi.",60,3612,191310,194922,video,FALSE
CompanyJ_390,#NAME?,44,435,107009,107444,video,FALSE
CompanyJ_391,"Dirk, Steph, Dame, Seth. Whos winning the 3-point contest in Charlotte?",71,8817,390727,399544,carousel,FALSE
CompanyJ_392,Coach K flexed a W in Off-White Air Force 1s. @BRKicks,54,3443,424560,428003,image,FALSE
CompanyJ_393,"First dunk in 6th grade Most iconic dunk contest (2000)Jumped over 7'2"" defenderGOAT in-game dunkerStill throwing down at 42  Vince Carter has been defying gravity all his life.",177,1666,375529,377195,image,FALSE
CompanyJ_394,Steph from the logo. Childs play. (via @nba),44,1265,142775,144040,video,FALSE
CompanyJ_395,#NAME?,62,1037,163899,164936,video,FALSE
CompanyJ_396,Corey Brewer accidentally kicked Torrey Craig in the head after hanging on the rim...,85,4573,279847,284420,video,FALSE
CompanyJ_397,Steph hit the shimmy before the 3-pointer went in ,50,1779,187707,189486,video,FALSE
CompanyJ_398,KD really waited until the buzzer to attempt a shot here to save his FG%...,75,3765,251084,254849,video,FALSE
CompanyJ_399,Kerr is now 300-77 in the regular season ,41,5646,397725,403371,image,FALSE
CompanyJ_400,Kyrie is RIDICULOUS.,20,1416,161556,162972,video,FALSE
CompanyJ_401,There was nobody like Sean Taylor.  This hit at the 2006 Pro Bowl is still wild  (via @nflthrowback),100,3811,233725,237536,video,FALSE
CompanyJ_402,Brady isnt finished yet.,24,2975,285127,288102,image,FALSE
CompanyJ_403,The Pro Bowl just turned into old school backyard football (via @thecheckdown),78,1574,131955,133529,video,FALSE
CompanyJ_404,Bobans hands make a softball look like a tennis ball. Wild.,59,1011,170143,171154,video,FALSE
CompanyJ_405,The Pro Bowl trophy literally broke ,36,2684,384881,387565,image,FALSE
CompanyJ_406,"This is home. After getting a standing O from Knicks fans, Melo talks returning to MSG and watching D-Wade finish out his career ",129,1239,231058,232297,video,FALSE
CompanyJ_407,PG ON GIANNIS. WOW.,19,3134,257178,260312,video,FALSE
CompanyJ_408,NY state of mind ,17,2254,379533,381787,image,FALSE
CompanyJ_409,RATED R ,8,2069,376822,378891,image,FALSE
CompanyJ_410,A couple days ago @stevenadams tried a euro and it didnt go over too well...tonight he nailed it ,97,892,182086,182978,video,FALSE
CompanyJ_411,Lukas making history already ,29,1778,325190,326968,image,FALSE
CompanyJ_412,JR at MSG tonight as well... That hat ,38,3271,247724,250995,video,FALSE
CompanyJ_413,Lance doing the absolute most ,30,3957,299703,303660,video,FALSE
CompanyJ_414,LANCE ,6,2341,279815,282156,video,FALSE
CompanyJ_415,"Anthony Davis has requested a trade and told the Pelicans he has no intention of signing an extension if offered, per @wojespn",126,37127,728302,765429,image,FALSE
CompanyJ_416,"First the blown PI call, now AD requests a trade. Tough week for New Orleans sports fans...",91,3297,369758,373055,image,FALSE
CompanyJ_417,Nickell Robey-Coleman isn't holding back ,41,5417,209979,215396,image,FALSE
CompanyJ_418,MVP watch for Paul George  Career highs in PPG and REB  1st in total steals  3rd in 3PM OKC is 3rd in the West  DPOY candidate,126,3473,358632,362105,image,FALSE
CompanyJ_419,"Did him real dirty while he was down  (via @adam_ch09, @brfootball)",67,525,78431,78956,video,FALSE
CompanyJ_420," I'M JUST HERE SO I WON'T GET FINED (Marshawn Lynch, Media Day 2015)",68,503,139197,139700,image,FALSE
CompanyJ_421,"KD is giving back to his hometown with the Durant Center: ""It's one of the greatest accomplishments so far in my career"" ",121,825,88671,89496,video,FALSE
CompanyJ_422,Watching PG-13 dunk on Giannis from here  (via @thunderbeast405),64,601,160962,161563,video,FALSE
CompanyJ_423,"In 1996, Spurs GM Gregg Popovich fired Bob Hill and made himself head coach.  Today he turns 70 with: - 5 titles - 3rd-most wins - 3rd-most playoff wins - 21 straight postseason appearances",189,2314,362942,365256,image,FALSE
CompanyJ_424,Boogie gave the Warriors a scare after taking a hard foul  He's okay though ,76,5186,345680,350866,video,FALSE
CompanyJ_425,Jim Brown. Barry Sanders.  Champ Bailey is in awe to be among the greats,72,69,21754,21823,video,FALSE
CompanyJ_426,Steph just side-stepped a 35-footer at the buzzer. Insane.,58,2726,285491,288217,video,FALSE
CompanyJ_427,Tom Brady isn't giving Jared Goff any advice  (via @nfl),56,2040,262836,264876,video,FALSE
CompanyJ_428,"If Lakers/Pelicans trade talks pick up, Lonzo's camp prefers him to be moved to a third team that doesn't have an established PG, per @shamsnba",143,8237,476068,484305,image,FALSE
CompanyJ_429,McVay is ready to go to battle with Goff,40,485,60525,61010,video,FALSE
CompanyJ_430,The Grizzlies blew a 25-point lead... Then this sequence cost them the game. Cold.,82,7470,364083,371553,video,FALSE
CompanyJ_431,"Klays attention could turn to the Lakers if they land AD and the Warriors dont offer a max extension, per @wojespn",114,9316,457792,467108,image,FALSE
CompanyJ_432,Pro football HOF finalist Champ Baileys favorite play of his career? When I picked off Brady and went 100 yards  (via @simmsandlefkoe),134,152,27919,28071,video,FALSE
CompanyJ_433,"Tom Brady teaches a young reporter how to deal with ""the haters"" (via @nfl)",75,1191,109853,111044,video,FALSE
CompanyJ_434,"The Patriots are paying for Josh Gordons drug treatment and a return to the team in the future is possible, per @dougkyed",121,3533,337300,340833,image,FALSE
CompanyJ_435,"Brandin Cooks is paying for a Rams janitor and his son to attend the Super Bowl: I just felt like it would be special for him to see that he is a part of this success, per ByMikeJones/Twitter ",192,4641,513188,517829,image,FALSE
CompanyJ_436,"Source close to Celtics says Kyrie is genuinely interested in reuniting with LeBron  ""That is for real,"" per RicBucher/Twitter",126,17356,580534,597890,image,FALSE
CompanyJ_437,NFL HOF Finalist Ed Reed says he only stayed at Miami for his senior season because he knew the Canes would be unbeatable.,122,196,27867,28063,video,FALSE
CompanyJ_438,Russ had the whole team recreating his euro ,44,2177,284223,286400,video,FALSE
CompanyJ_439,Delly micd up is comedy ,24,1804,311684,313488,video,FALSE
CompanyJ_440,Jah is really ballin out again.,31,3046,228006,231052,video,FALSE
CompanyJ_441,#NAME?,100,4462,492165,496627,image,FALSE
CompanyJ_442,Rudy Gay called game ,21,2539,253867,256406,video,FALSE
CompanyJ_443,Ingram stood over Corey Brewer and laughed after posterizing him ,65,6000,437571,443571,video,FALSE
CompanyJ_444,Ingram really did that  (via @ashleysung),41,2859,224998,227857,video,FALSE
CompanyJ_445,Ed Reed is staying humble with his Pro Football HOF nomination: Just being in that talk is enough for me ,105,191,32371,32562,video,FALSE
CompanyJ_446,Michael Vick remembers crying because he was so frustrated with Chip Kelly during the Eagles QB battle (via @SimmsAndLefkoe),124,886,75948,76834,video,FALSE
CompanyJ_447,Talk your talk then @joelembiid,31,2198,324312,326510,image,FALSE
CompanyJ_448,Shaq finds it disrespectful LeBron has jumped Kobe in the GOAT convo,68,11665,484167,495832,image,FALSE
CompanyJ_449,Jimmy Butler names his soccer GOAT  (via @brfootball),53,4154,204455,208609,image,FALSE
CompanyJ_450,Brandin Cooks gifting the team custodian with a pair of tickets to the Super Bowl is what its all about ,104,562,105322,105884,video,FALSE
CompanyJ_451,Gronk hinting at retirement?,28,2563,247234,249797,image,FALSE
CompanyJ_452,The Pelicans already took AD out of their intro vid. Petty ,59,3524,211465,214989,video,FALSE
CompanyJ_453,Kevin Garnett is STILL making money from his Celtics contract: $5M a year until 2024 ,85,1233,165986,167219,video,FALSE
CompanyJ_454,"Pelicans have no interest in trading AD to the Lakers right now, per @wojespn",77,7796,389087,396883,image,FALSE
CompanyJ_455,KAT. BALLGAME.,14,1987,220350,222337,video,FALSE
CompanyJ_456,Reunited ,9,3427,603472,606899,image,FALSE
CompanyJ_457,Vince was tight about the hook until he realized he taught Giles the move,73,724,333200,333924,video,FALSE
CompanyJ_458,McVay and the Rams are riding high on their way to the Super Bowl ,66,490,56380,56870,video,FALSE
CompanyJ_459,The legendary No.42 Jackie Robinson would have been 100 today  Broke the MLB color barrier in 1947  1947 ROY and 1949 NL MVP  6X All-Star  1955 World Series Champion,165,1317,254944,256261,image,FALSE
CompanyJ_460,We sat down with Jimmy Butler and asked him about free agency and his future in Philadelphia ,93,1105,176233,177338,image,FALSE
CompanyJ_461,"The Knicks are finalizing a deal to send Kristaps Porzingis to the Mavs, per @shamsnba",86,10961,474023,484984,image,FALSE
CompanyJ_462,The last time Luka and Porzingis were on the same court...,58,1375,266861,268236,image,FALSE
CompanyJ_463,Knicks fans right now...,24,3573,209550,213123,video,FALSE
CompanyJ_464, KP x LUKA,10,4720,358418,363138,video,FALSE
CompanyJ_465,New duo in Dallas ,18,11678,780457,792135,image,FALSE
CompanyJ_466,J. Cole approves of the trade,29,2537,369203,371740,image,FALSE
CompanyJ_467,3x Super Bowl Champ and 5x Pro Bowler Ty Law says the Pats built their dynasty on defense before Brady became the GOAT,118,123,21296,21419,video,FALSE
CompanyJ_468,Old school  New school  Kristaps has new threads and a new mentor (from B/R and @americanexpress),97,511,87907,88418,video,FALSE
CompanyJ_469,Your 2019 #NBAAllStar reserves ,31,6082,214275,220357,carousel,TRUE
CompanyJ_470,Who got robbed?,15,19957,364214,384171,image,FALSE
CompanyJ_471,"Chuck was heated over the AD trade request: ""We cannot have players and agents colluding to stack super teams."" (via @NBAonTNT)",127,5917,208506,214423,video,FALSE
CompanyJ_472,"Tom Brady is Thanos, and he just found the final Infinity Stone  #GridironHeights x Super Bowl special",102,6808,346435,353243,carousel,TRUE
CompanyJ_473,LeBron is back.,15,6186,279799,285985,video,FALSE
CompanyJ_474,Is this the moment Luka found out he didn't make the #NBAAllstar team?,70,1710,188280,189990,video,FALSE
CompanyJ_475,DSJ and DeAndre get a new look for their next game in MSG (from B/R and @americanexpress),89,703,111686,112389,video,FALSE
CompanyJ_476,Checking in on Blake and Reggie in Detroit...,45,6632,324824,331456,video,FALSE
CompanyJ_477,Tyson drew a chalk line around Rondo like it was a crime scene ,63,697,200416,201113,video,FALSE
CompanyJ_478,Bron just pulled off the Harden step-back.,42,11479,459527,471006,video,FALSE
CompanyJ_479,Lance always living his best life.,34,3736,304012,307748,video,FALSE
CompanyJ_480,When your team keeps losing and your best player wants out  (via @brfootball),77,1525,200063,201588,image,FALSE
CompanyJ_481,The Patriots are coming ,24,535,59661,60196,video,FALSE
CompanyJ_482,The NFL is the only major league that crowns a champion at a neutral site. Should that change?,94,1179,42957,44136,video,FALSE
CompanyJ_483,Oh.,3,17657,568423,586080,image,FALSE
CompanyJ_484,Ty Law is knocking on the Hall of Fame's door...partly because he spent his life learning from a Hall of Famer ,111,88,18518,18606,video,FALSE
CompanyJ_485,The NBA is adding Dirk Nowitzki and Dwyane Wade as special roster additions to play in the All-Star Game.,105,8781,555961,564742,image,FALSE
CompanyJ_486,Blake went full Jackie Moon  (via @shaqtinafool),48,3701,271620,275321,video,FALSE
CompanyJ_487,Bragging rights are on the line for former Bulldogs Todd Gurley and Sony Michel,79,310,74409,74719,video,FALSE
CompanyJ_488,DAngelo Russell has been selected to replace Victor Oladipo as a reserve in the All-Star game,93,8791,522295,531086,image,FALSE
CompanyJ_489,AD speaks.,10,5649,413049,418698,image,FALSE
CompanyJ_490,#NAME?,74,166,34409,34575,video,FALSE
CompanyJ_491,The NBA has taken over Super Bowl week.  ADs public trade request  Porzingis to Dallas  Kyrie/Bron reunion rumors  Kyrie/KD Knicks buzz  Brons return from injury  Warriors and Gobert fighting  ADs dad doesnt like Boston fit,223,3264,405646,408910,image,FALSE
CompanyJ_492,MSG let it be known for Kyrie.,30,673,107100,107773,video,FALSE
CompanyJ_493,Kyrie calls out to his dad to get jersey after game at MSG,58,1739,371062,372801,video,FALSE
CompanyJ_494,This PG x D-Wade jersey exchange ,33,730,190059,190789,video,FALSE
CompanyJ_495,"What you gonna do, @kingjames? ",31,1526,340982,342508,image,FALSE
CompanyJ_496,"James Harden kept his 30+ PTS streak alive with this last second 3, making it 25 games straight.",96,3856,221322,225178,video,FALSE
CompanyJ_497,"Lakers first offer to Pelicans for AD, per @wojespn: Lonzo Ball Kyle Kuzma Rajon Rondo Michael Beasley 1st round pick",117,15258,431948,447206,image,FALSE
CompanyJ_498,#NAME?,84,2254,313782,316036,video,FALSE
CompanyJ_499,There are exactly four things that make Belichick smile (via @thecheckdown),75,526,121402,121928,video,FALSE
CompanyJ_500,Zion lives in the air (via @_christineford + @jsneed87),55,489,105173,105662,video,FALSE
CompanyJ_501,Vince Carter had some wise words for Rudy  Gobert (via @utahjazz),65,814,178838,179652,video,FALSE
CompanyJ_502,Saquon takes home Offensive Rookie of the Year ,47,4967,424122,429089,image,FALSE
CompanyJ_503,"JuJu, Travis Kelce, Emmitt Smith and others test their Rams and Patriots knowledge in ""Back-Up or Made-Up?"" ahead of Super Bowl LIII",132,118,41182,41300,video,FALSE
CompanyJ_504,Ed Reed and Tony Gonzalez headline the 2019 Pro Football Hall of Fame Class ,76,994,247716,248710,image,FALSE
CompanyJ_505,Patrick Mahomes is the 2018 Most Valuable Player ,49,2890,425496,428386,image,FALSE
CompanyJ_506,"10 years ago today, Kobe dropped 61 at The Garden.  At the time, he was clashing with Spike Lee over control of a documentary.  After setting the MSG record, Mamba said he wanted to stop Spike from talking.",206,1478,294059,295537,image,FALSE
CompanyJ_507,Luka is now doing the Harden step-back.,39,6108,405843,411951,video,FALSE
CompanyJ_508,Views from Mount Zion.,22,1227,309362,310589,image,FALSE
CompanyJ_509,From the bottom to the top ,27,1111,272059,273170,image,FALSE
CompanyJ_510,The Rams had a top-three rushing offense and didnt miss a beat without Gurley.  They are the Offensive Line of the Year.,120,199,19742,19941,video,FALSE
CompanyJ_511,Kuz will never forget this Boogie poster.,41,4697,283481,288178,video,FALSE
CompanyJ_512,Were gonna keep your legacy alive forever   Watching these legends get the news about the @profootballhof is amazing  From B/R x @Ford,134,193,41124,41317,video,FALSE
CompanyJ_513,LIII.,5,484,69431,69915,video,FALSE
CompanyJ_514,"Ed Reed credits his incredible family and friends for his road to the @profootballhof: This is not my moment, its their moment  From B/R x @ford",144,164,33062,33226,video,FALSE
CompanyJ_515,McVay turned one the day before Belichicks first Super Bowl appearance ,71,261,57156,57417,video,FALSE
CompanyJ_516,Luka wasnt feeling it  (via @90svon),36,3672,736254,739926,video,FALSE
CompanyJ_517,"11 years ago today, David Tyree made one of the most iconic plays in NFL history to help the Giants dethrone the undefeated Patriots ",133,1861,190966,192827,image,FALSE
CompanyJ_518,DSJ first bucket as a Knick ,28,763,198527,199290,video,FALSE
CompanyJ_519,"Still asking teammates who they got   New team, same routine for DeAndre",72,2247,438991,441238,video,FALSE
CompanyJ_520,"George Kittle, Von Miller and other NFL stars give their over/unders on the best Super Bowl prop bets  ",103,162,35661,35823,video,FALSE
CompanyJ_521,Playground moves from Kyrie. Completely froze Steven Adams.,59,1722,193728,195450,video,FALSE
CompanyJ_522,Beast Modes outfit. Too real. (via @thecheckdown),49,3200,329746,332946,video,FALSE
CompanyJ_523,3-0 in the 1st half...,22,1808,180431,182239,image,FALSE
CompanyJ_524,IT ACTUALLY HAPPENED. (Via @thecheckdown),41,3671,275100,278771,video,FALSE
CompanyJ_525,Patriots win Super Bowl LIII!,29,2389,184840,187229,video,FALSE
CompanyJ_526,GOAT TALK ,10,9798,787292,797090,image,FALSE
CompanyJ_527,New England adds another Lombardi to the family.,48,676,87796,88472,video,FALSE
CompanyJ_528,Julian Edelman is SUPER BOWL MVP. His career could be a movie. No scholarships out of HS Kent State QB 1 college catch for 11 yards No combine invite 7th-round pick Bradys security blanket Clutch part of Pats dynasty 3x champ,225,4146,539458,543604,image,FALSE
CompanyJ_529,Brady adds No. 6 ,17,560,81268,81828,video,FALSE
CompanyJ_530,A win is a win.,15,642,106801,107443,video,FALSE
CompanyJ_531,Current dynasties  (via @brfootball),36,1996,206073,208069,image,FALSE
CompanyJ_532,"Bradys throw, Gronks catch  (via @twistedwan)",45,1322,129234,130556,video,FALSE
CompanyJ_533,"Seven years ago today, Jeremy Lin checked in for the Knicks, unsure if he had an NBA future.  He finished with 25 points and Linsanity was born.",144,3845,389333,393178,video,FALSE
CompanyJ_534,Franchise cornerstones.,23,2263,441017,443280,image,FALSE
CompanyJ_535,"Lakers latest offer to the Pelicans for AD, per @latimes: Lonzo, Kuz, Ingram, Rondo, Lance, Beasley, two 1st round picks",120,33060,506190,539250,image,FALSE
CompanyJ_536,Heat will retire Chris Boshs jersey on March 26,47,2439,346783,349222,image,FALSE
CompanyJ_537,Hes back ,9,5519,340846,346365,image,FALSE
CompanyJ_538,Melos son is out here hooping  @br_hoops (via @carmeloanthony),62,1095,87056,88151,video,FALSE
CompanyJ_539,First look at Porzingis in a Mavs uni  @brkicks,47,3870,439955,443825,image,FALSE
CompanyJ_540,Agree with the Mamba?,21,11398,474922,486320,image,FALSE
CompanyJ_541,Adam Sandlers handles are out of control. (via @spidadmitchell),63,4207,294034,298241,video,FALSE
CompanyJ_542,DID BAGLEY REALLY JUST DO THAT,30,3915,427001,430916,video,FALSE
CompanyJ_543,"Mahomes pulled up to a Lifetime and cooked everybody  (via @faizjiwani, @kheuzil)",81,8848,614802,623650,video,FALSE
CompanyJ_544,"On this day in 1999, they were kids making their pro debuts in a lockout-shortened season.  Two decades later, theyre NBA legends.",130,2652,429425,432077,image,FALSE
CompanyJ_545,"@cristiano is 34 years old today and still going strong  For club and country: 675 goals, 246 assists, 29 trophies, 5 Ballons dor (via @brfootball)",147,684,100848,101532,image,FALSE
CompanyJ_546,How itd look if Shaq played in the league today  (via @shady00018_ ). @brgaming,79,4566,308275,312841,video,FALSE
CompanyJ_547,Lakers wont have a team left ,29,8755,412965,421720,video,FALSE
CompanyJ_548,John Wall suffered a ruptured Achilles after slipping and falling in his house. Hell be out 12 months.,102,17862,494299,512161,image,FALSE
CompanyJ_549,"Lakers pull out of AD talks because of Pelicans' ""outrageous"" requests including 6-8 draft picks, per @latimes",110,16551,480126,496677,image,FALSE
CompanyJ_550,Maya Moore announces she won't play pro basketball in 2019,58,6925,208692,215617,image,FALSE
CompanyJ_551,"@dwyanewade's rocking a ""world tour"" shirt with his best career moments on it  What was your favorite?",102,5011,504605,509616,carousel,FALSE
CompanyJ_552,"20 years ago today, the NBA was introduced to White Chocolate Jason Williams following the 1999 lockout.",104,2610,274749,277359,video,FALSE
CompanyJ_553,":""Bron's gonna trade you""  Pacers fans being ruthless to BI",59,3940,219177,223117,video,FALSE
CompanyJ_554,Patrick Mahomes is lost without football for the next 6 months  #GridironHeights,80,887,114449,115336,video,TRUE
CompanyJ_555,Bron with the angry dunk ,25,1555,190676,192231,video,FALSE
CompanyJ_556,Lakers just got blown out by 42 by the Pacers. Thats the biggest loss of Brons career... ,89,7975,482148,490123,image,FALSE
CompanyJ_557,"Clippers are sending Tobias Harris to the 76ers, per @shamsnba",62,8735,360346,369081,image,FALSE
CompanyJ_558,Favorites in the East?,22,14480,560021,574501,image,FALSE
CompanyJ_559,Ja Morant (@igotgame12_ ): True high-flyer (via @teamflightbrothers),68,954,177374,178328,video,FALSE
CompanyJ_560,"Were here to talk #BHM  B/R x BLK HSTRY: Are You Listening? @bradbeal3, @Andre @SterlingBrown23 and @3jmccollum @thenbpa",120,568,45662,46230,video,FALSE
CompanyJ_561,Trail Blazers. Record Setters. GOATs.  Happy National Girls and Women in Sports Day ,84,1989,198973,200962,image,FALSE
CompanyJ_562,"Wizards are sending Otto Porter to the Bulls for Bobby Portis and Jabari Parker, per @shamsnba",94,2680,200015,202695,carousel,FALSE
CompanyJ_563,Brooklyn might have the best bench reactions in the league,58,1358,188281,189639,video,FALSE
CompanyJ_564,Kerr couldnt help himself ,26,2102,230072,232174,image,FALSE
CompanyJ_565,Harrison Barnes was playing in a game tonight when Mavs traded him to the Kings ,80,3984,284609,288593,image,FALSE
CompanyJ_566,Mavs fans welcome The Unicorn to Dallas,39,1326,210330,211656,video,FALSE
CompanyJ_567,The Bucks dropped 148 points and Giannis scored 43 on 81% shooting ,67,5966,327972,333938,video,FALSE
CompanyJ_568,Bron weighs in on the Harrison Barnes mid-game trade...,55,5200,334667,339867,image,FALSE
CompanyJ_569,So thats why Klay doesnt dribble ,33,2427,209098,211525,video,FALSE
CompanyJ_570,Young Lakers after seeing LeBrons IG post about the Harrison Barnes trade,73,3010,284588,287598,image,FALSE
CompanyJ_571,Who knew DLo could speak Chinese (via @brooklynnets),52,4044,411541,415585,video,FALSE
CompanyJ_572,KD didnt hold back last night.,30,4319,232760,237079,image,FALSE
CompanyJ_573,"25 years ago today, MJ signed a MiLB contract with the White Sox. He would get 51 RBIs in 127 games... and 114 strikeouts",121,1826,250268,252094,image,FALSE
CompanyJ_574,LeBron is relaxed on deadline day.,34,5765,285204,290969,image,FALSE
CompanyJ_575,"Breaking: The Raptors are ""finalizing a deal"" to land Marc Gasol, per @wojespn",78,2621,245883,248504,image,FALSE
CompanyJ_576,"Markelle Fultz has been traded to Orlando, per @wojespn",55,6832,415493,422325,image,FALSE
CompanyJ_577,Gasol joins the North,21,2597,331510,334107,image,FALSE
CompanyJ_578,New beginning for Markelle.,27,2228,244455,246683,image,FALSE
CompanyJ_579,Pelicans-Lakers trade talks ,28,1100,80482,81582,video,FALSE
CompanyJ_580,Magic and LeBrons private post-deadline meeting:,48,1354,96449,97803,video,FALSE
CompanyJ_581,Bron and Kyrie face off in Boston tonight.  Could there be a reunion in L.A. down the road?,91,461,97247,97708,video,FALSE
CompanyJ_582,The Russ and Noah pregame routine is back  (via @okcthunder),60,3390,367584,370974,video,FALSE
CompanyJ_583,Team Bron or Team Giannis?,26,19253,621192,640445,image,FALSE
CompanyJ_584,Giannis accused Bron of tampering when he drafted AD  (via @nbaontnt),69,1607,282609,284216,video,FALSE
CompanyJ_585,All-Star teammates once again.  Bron picks D-Wade ,50,641,298822,299463,image,FALSE
CompanyJ_586,"Giannis may be an All-Star captain, but @shaq still can't pronounce his name  (via @nbaontnt)",93,736,162094,162830,video,FALSE
CompanyJ_587,Bron and Rondo were coaching up the Lakers bench during a timeout,65,1923,275051,276974,video,FALSE
CompanyJ_588,Scary Terry had to reward Tatum for his hustle ,47,892,203131,204023,video,FALSE
CompanyJ_589,Is it too late to throw Terrance Ferguson in the dunk contest?,62,1347,221772,223119,video,FALSE
CompanyJ_590,RONDO FOR THE WIN IN BOSTON.,28,12852,754857,767709,video,FALSE
CompanyJ_591,"""They better not try to trade us again"" ",40,1671,365673,367344,image,FALSE
CompanyJ_592,Winning solves everything.,26,1002,278718,279720,carousel,FALSE
CompanyJ_593,Rondo gets his revenge in Boston ,33,1503,291829,293332,image,FALSE
CompanyJ_594,What we all want to see ,24,2121,492167,494288,image,FALSE
CompanyJ_595,Slow-Mo Rondo. ,15,1692,197410,199102,video,FALSE
CompanyJ_596,Team LeBron and Team Giannis are set. Who ya got? ( @metrobytmobile),68,463,80100,80563,video,FALSE
CompanyJ_597,The goalie was devastated (via @saccwolves / @brfootball),57,1422,138852,140274,video,FALSE
CompanyJ_598,The post-LeBron effect.,23,12572,491473,504045,image,FALSE
CompanyJ_599,Synchronized shooting  (via @umichwbball),41,2689,240938,243627,video,FALSE
CompanyJ_600,Standing ovation for Caris LeVert who is back for the Nets ,59,1487,254464,255951,video,FALSE
CompanyJ_601,DSJ getting ready for the AT&T Slam Dunk Contest with a 360 off the break ,74,621,175479,176100,video,FALSE
CompanyJ_602,DSJ just trucked Blake...,25,1474,214397,215871,video,FALSE
CompanyJ_603,Philly gave Boban a standing ovation for his 1st game ,54,831,216209,217040,video,FALSE
CompanyJ_604,D-Wade caught  after returning from scary fall,46,1075,221158,222233,video,FALSE
CompanyJ_605,AD checked out with 3:14 left in the 3Q.  He didnt play in the 4Q,65,2298,215506,217804,video,FALSE
CompanyJ_606,"Luke Brown is lighting up HS hoops, bringing the community together to watch him break Indianas all-time scoring record",119,1321,136927,138248,video,FALSE
CompanyJ_607,"John Wall will finish college while recovering from his ruptured Achilles, per @fredkatznba",91,4329,477663,481992,image,FALSE
CompanyJ_608,Markus Howard is a walking bucket.,34,704,121021,121725,video,FALSE
CompanyJ_609,"16 years ago today, MJ reminded Kobe how many rings he had during his final All-Star Game ",90,4406,565235,569641,carousel,FALSE
CompanyJ_610,Cant wait ,10,2459,341144,343603,image,FALSE
CompanyJ_611,Russ pulled up with the construction vest on  (via @nba),56,5362,221807,227169,video,FALSE
CompanyJ_612,Celtics got booed off the court at TD Garden after blowing 28-point lead vs. Clippers.,86,5708,347251,352959,video,FALSE
CompanyJ_613,PG drops 45 in the win over the Rockets!,40,5211,572794,578005,image,FALSE
CompanyJ_614,Russ ties Wilt ,15,2294,303572,305866,image,FALSE
CompanyJ_615,"Paul George has been in a ZONE. His last 11 games:  31 PTS, W 31 PTS, W 36 PTS, W 23 PTS, W 36 PTS, W 37 PTS, W 43 PTS, W 37 PTS, L 39 PTS, W 27 PTS, W 45 PTS, W",161,4473,394074,398547,image,FALSE
CompanyJ_616,"38 points. Outscored Kobe. First national TV game.  Seven years ago, Linsanity became real",90,1725,239019,240744,video,FALSE
CompanyJ_617,He took back his comments to Austin Rivers real quick (via @_justinbolton),74,3247,264025,267272,video,FALSE
CompanyJ_618,"Ben Simmons wants to work with Magic Johnson this offseason, talk big guard secrets, per @marcsteinnba",102,2139,286942,289081,carousel,FALSE
CompanyJ_619,Luka TOOK OVER the 4th quarter ,31,952,174790,175742,video,FALSE
CompanyJ_620,Magic had seen enough and decided to dip early ,47,1906,240026,241932,video,FALSE
CompanyJ_621,"Embiid on his reaction to Simmons attempting a three: ""...I was like 'oh s--t.' It caught me off guard.""  (via @NBASarah)",121,677,153681,154358,video,FALSE
CompanyJ_622,Klay scored on an assist off Boogies head ,42,1348,190384,191732,video,FALSE
CompanyJ_623,D-Wade x Steph jersey swap ,27,1065,371339,372404,image,FALSE
CompanyJ_624,"Anthony Edwards, the potential No. 1 pick in the 2020 Draft, commits to Georgia (@br_hoops)",91,941,84862,85803,video,FALSE
CompanyJ_625,TOMORROW. The Champions League returns  (@brfootball),53,793,134643,135436,image,FALSE
CompanyJ_626,All-Star Game is this week   One of the most iconic ASG moments: Shaq and MJ one-on-one,87,1852,207734,209586,video,FALSE
CompanyJ_627,Breaking: Heisman winner Kyler Murray announces he is fully committing to football instead of playing in MLB with As,116,4708,345950,350658,image,FALSE
CompanyJ_628,Browns have signed Kareem Hunt to a contract. Browns GM says we believe he deserves a second chance.,100,11987,452303,464290,image,FALSE
CompanyJ_629,@dloading (22 years old) is the youngest player in NBA history to hit 500 three-pointers  (h/t @poochnets),106,8783,653764,662547,image,FALSE
CompanyJ_630,Harden is locked in ,20,6633,316819,323452,image,FALSE
CompanyJ_631,Raptors forgot to fill Marc Gasol in on the pregame ritual  (via @tsn_official),79,1244,206650,207894,video,FALSE
CompanyJ_632,PG. SHEESH. ,12,2662,295364,298026,video,FALSE
CompanyJ_633,Luka hit Harden with a step-back and played with the Rockets defense ,69,1809,208789,210598,video,FALSE
CompanyJ_634,D-Rose went coast-to-coast in 4.4 seconds... and he wasnt going full speed,74,2088,294383,296471,video,FALSE
CompanyJ_635,KAWHI OFF GLASS FOR THE WIN.,28,802,124977,125779,video,FALSE
CompanyJ_636,"Russ makes history. 10 straight games with a triple-double, the longest streak ever.",84,4697,457391,462088,image,FALSE
CompanyJ_637,All Harden could do was smile after barely keeping his 30+ points streak alive.,79,2353,207471,209824,video,FALSE
CompanyJ_638,Harden points to his mom after keeping historic 30+ PTS streak alive ,69,1689,308306,309995,image,FALSE
CompanyJ_639,The Champions League is back. GAME ON  (@brfootball),52,584,80109,80693,image,FALSE
CompanyJ_640,PG making a real MVP push. Russ breaking records. Won 11 of last 12.  Dont sleep on OKC out West ,97,3165,360875,364040,image,FALSE
CompanyJ_641,"14 years ago today, Allen Iverson dropped a career-high 60. Unstoppable.",72,631,86622,87253,video,FALSE
CompanyJ_642,Chris Bosh plans to officially retire during his Heat ceremony in March (via @ringer)  2x champion  11x All-Star  19.2 PPG | 8.5 REB,132,2001,349037,351038,image,FALSE
CompanyJ_643,A new move from Bradley Beal? ,30,1259,103823,105082,video,FALSE
CompanyJ_644,Today marks 19 years since Vince Carter shut down the 2000 Dunk Contest  (via @nbatv),85,1232,184941,186173,video,FALSE
CompanyJ_645,MVPG? ,6,5160,450318,455478,image,FALSE
CompanyJ_646,"AB has requested a trade from the Steelers, per @adamschefter",61,9971,371338,381309,image,FALSE
CompanyJ_647,The NFL season may be over...but @theaaf is making sure football isn't.,71,604,83190,83794,video,FALSE
CompanyJ_648,"On this day in 2000, Jason Williams introduced the NBA to the elbow pass.",73,2280,198612,200892,video,FALSE
CompanyJ_649,Mbappe too fast  (@brfootball),30,588,54763,55351,video,FALSE
CompanyJ_650,Al Horford and the Cs take on the 76ers in a potential ECF preview ,67,1022,73542,74564,video,FALSE
CompanyJ_651,"When you watch the NBA today, you see the AND1 Mixtape Tour.",60,1967,251027,252994,image,FALSE
CompanyJ_652,"Feb. 12, 2014: @kingjames buries the Warriors and breaks out The Silencer celebration.",86,9793,565168,574961,video,FALSE
CompanyJ_653,Simmons threw it down and Tatum responded with a yam ,53,4891,515639,520530,video,FALSE
CompanyJ_654,WHAT A COMEBACK.  Down 23 in the second half... still got the W. Duke completes the largest second-half comeback of Coach Ks career vs. Louisville.,147,1324,305374,306698,image,FALSE
CompanyJ_655,Young stars will be making headlines for years to come  (via @brfootball),73,1035,278215,279250,image,FALSE
CompanyJ_656,Its been 10 years? @champagnepapis So Far Gone album is still making its presence felt a decade later,101,614,74131,74745,video,FALSE
CompanyJ_657,"Ravens have agreed in principle to trade Joe Flacco to the Broncos, cant go through until March 13th, per @AdamSchefter",119,1444,143378,144822,image,FALSE
CompanyJ_658,"Isaiah Thomas will make his debut for the Nuggets tonight vs. Sacramento, 11 months after undergoing hip surgery, per @wojespn.",127,4746,434620,439366,image,FALSE
CompanyJ_659,The challenge for the Champions League throne is coming  (@brfootball),70,265,36771,37036,video,FALSE
CompanyJ_660,Turnaround ,11,4356,352748,357104,image,FALSE
CompanyJ_661,"15 years ago today, LeBron, Wade and Carmelo Anthony took over the rookie challenge ",84,601,96237,96838,video,FALSE
CompanyJ_662,Son with the nod to Ronaldo on his celebration?  (via @brfootball),66,507,55533,56040,video,FALSE
CompanyJ_663,Russ is a man of many talents ,30,2816,316964,319780,image,FALSE
CompanyJ_664,Old teammates Boban and DeAndre reunite...Jimmy wasn't having it ,65,1882,362541,364423,video,FALSE
CompanyJ_665,KEVIN KNOX BAPTIZED BEN SIMMONS ,32,2692,161786,164478,video,FALSE
CompanyJ_666,OH MY.,6,3301,303263,306564,video,FALSE
CompanyJ_667,The rook Okogie really locked down The Beards step-back ,56,10075,501125,511200,video,FALSE
CompanyJ_668,IT coming up CLUTCH in his return.,34,2022,256383,258405,video,FALSE
CompanyJ_669,Legends.,8,1596,439789,441385,image,FALSE
CompanyJ_670,Steve Kerr: Big mad ,20,9835,514365,524200,video,FALSE
CompanyJ_671,"29 years ago today, Michael Jordan played in a nameless No. 12 jersey because his No. 23 was stolen from the locker pregame",123,693,97541,98234,video,FALSE
CompanyJ_672,70 EMBIID INCOMING (via @rkd215),32,1785,213954,215739,video,FALSE
CompanyJ_673,"The B/R Are You Listening? content series is about amplifying the voice of the modern black athlete, embracing their humanity and choosing to practice empathy.  With that purpose in mind, weve disabled comments in hopes that users respectfully LISTEN to, not debate, the experiences of these athletes.  Are You Listening? (@thenbpa @3jmcollum @bradbeal3)",354,0,39042,39042,video,FALSE
CompanyJ_674,D-Wade and his daughter are ready for his last All-Star Weekend  (via @lisjoseph),81,462,92826,93288,video,FALSE
CompanyJ_675,Happy Valentines Day ,21,2834,158273,161107,video,FALSE
CompanyJ_676,LeBron: NBA team owner soon?,28,2515,303683,306198,image,FALSE
CompanyJ_677,#NAME?,62,3397,313671,317068,image,FALSE
CompanyJ_678,Sunday's All-Star Game will feature a lot of star power and a lot of ... $253M to be exact ,91,378,70977,71355,video,FALSE
CompanyJ_679,"Russ is now the Thunder/Sonics all-time points leader (18,208+)",63,2358,309841,312199,image,FALSE
CompanyJ_680,Terrence Ross went vintage Kobe on this reverse dunk ,53,1795,223716,225511,video,FALSE
CompanyJ_681,"Magic when asked about Kemba: You know I cant answer any questions about no players because every time I do it, I get fined. (via KeepBlitzin/TW)",145,961,146231,147192,video,FALSE
CompanyJ_682,Adam Silver debuts a new type of jersey that can change number and player  (via @NBA),85,4627,341739,346366,video,FALSE
CompanyJ_683,"The Pelicans have fired GM Dell Demps, per @wojespn",51,6378,236988,243366,image,FALSE
CompanyJ_684,#NAME?,27,522,75035,75557,video,FALSE
CompanyJ_685,The energy was unreal when Dion Waiters and Tim Hardaway Jr. turned the 2014 Rising Stars game into a one-on-one battle ,120,2078,366262,368340,video,FALSE
CompanyJ_686,"Colin Kaepernick and Eric Reids collusion case against the NFL is over. Theyve settled for an undisclosed amount, per lawyer Mark Geragos",137,6947,291958,298905,image,FALSE
CompanyJ_687,"15 years ago today, Eddie Guerrero upset Brock Lesnar for the title  R.I.P. to a legend (via @wwe)",98,6256,290760,297016,video,FALSE
CompanyJ_688,Anyone shaking ankles like Kyrie tonight?,41,1067,185367,186434,video,FALSE
CompanyJ_689,The NBAs rising stars take center stage to kick off All-Star Weekend,68,1138,293483,294621,image,FALSE
CompanyJ_690,Someone give Jesus Shuttlesworth a 10-day.,42,3761,391619,395380,video,FALSE
CompanyJ_691,Collins off the backboard to HIMSELF ,37,412,106563,106975,video,FALSE
CompanyJ_692,Collins 360 off Trae Young lob. Wow.,36,537,137310,137847,video,FALSE
CompanyJ_693,35 Points. Kyle Kuzma wins the 2019 Rising Stars MVP ,53,2403,416447,418850,image,FALSE
CompanyJ_694,Team World couldnt keep up with Trae Youngs nutmegs ,52,1445,298492,299937,video,FALSE
CompanyJ_695,Stephs bet against Seth in the 3-Point Contest: Loser has to buy all the family tickets for the rest of our careers. ,117,1547,203573,205120,video,FALSE
CompanyJ_696,"Before the 1988 3-Point Contest, Larry Bird asked everyone competing: Whos coming in second? He won in his warm-up jacket and celebrated before the last ball went in ",166,2616,349438,352054,image,FALSE
CompanyJ_697,This years All-Stars turn back the clock with old school jerseys (),67,2213,480196,482409,carousel,FALSE
CompanyJ_698,From one phenom to another,26,973,295394,296367,image,FALSE
CompanyJ_699,"11 years ago today, Gerald Green blew out a candle on the rim. So underrated  (via @nbatv)",90,2180,302667,304847,video,FALSE
CompanyJ_700,Zaire throwing lobs to Wade and Bron  (via @nbaontnt),53,533,183250,183783,video,FALSE
CompanyJ_701,Kobe won the 1997 Dunk Contest as an 18-year-old rookie. Youngest champ ever ,77,1561,325370,326931,image,FALSE
CompanyJ_702,Whos taking home this years 3-Point crown?,42,797,63703,64500,video,FALSE
CompanyJ_703,Whose creativity is gonna take it to another level tonight?,59,239,52680,52919,video,FALSE
CompanyJ_704,This Kansas drummer was BRINGING IT,35,3952,241327,245279,video,FALSE
CompanyJ_705,LeBron backs Colin Kaepernick.,30,7621,378226,385847,image,FALSE
CompanyJ_706,Tonight needs one more contestant ,34,2787,252954,255741,video,FALSE
CompanyJ_707,The Curry family comes full circle at this year's All-Star Weekend.,67,360,129060,129420,video,FALSE
CompanyJ_708,Trae beats Luka in the battle of the rooks ,43,1777,237403,239180,video,FALSE
CompanyJ_709,TATUM WON THE SKILLS CHALLENGE ON A HALF-COURT HEAVE ,53,1909,345065,346974,video,FALSE
CompanyJ_710,Legends were...a little rusty ,30,809,150250,151059,video,FALSE
CompanyJ_711,STEPH WITH 27 ,14,1026,142288,143314,video,FALSE
CompanyJ_712,"""Shoots like Steph, big like Klay""  Buddy went off for 26",57,366,97407,97773,video,FALSE
CompanyJ_713,A true underdog story. Nets sleeper Joe Harris beats out Steph to win the 3PT contest ,86,1384,181354,182738,video,FALSE
CompanyJ_714,"Shoot your shot, Tatum ",23,551,265089,265640,image,FALSE
CompanyJ_715,Dennis Smith Jr. grabbed J.Cole for the 50,42,1414,428564,429978,image,FALSE
CompanyJ_716,DIALLO REALLY DID THE VINCE HONEY DIP OVER SHAQ #ATTSlamDunk,60,4893,580917,585810,video,FALSE
CompanyJ_717,Diallo brought out Russ for his 1st dunk ,41,629,167992,168621,video,FALSE
CompanyJ_718,Legendary.  Hamidou Diallo is your 2019 #ATTSlamDunk Champ ,59,1917,374153,376070,image,FALSE
CompanyJ_719,Diallo's creativity got him the Slam Dunk crown ,48,783,104776,105559,video,FALSE
CompanyJ_720,#NAME?,12,715,298343,299058,image,FALSE
CompanyJ_721,What a night.,13,385,68130,68515,video,FALSE
CompanyJ_722, 6x champion  6x Finals MVP  5x MVP  14x All-Star  10x scoring champion  Happy 56th to MJ.,90,1262,136629,137891,video,FALSE
CompanyJ_723,NBA All-Stars pay homage to MJs fashion sense on his birthday ,62,3509,440101,443610,carousel,FALSE
CompanyJ_724,Happy birthday to the sneaker @brkicks,38,1624,343506,345130,image,FALSE
CompanyJ_725,"25 years ago today, David Robinson racked up a quadruple-double. Nobodys done it since.  34 points 10 boards 10 assists 10 blocks",129,4287,444114,448401,image,FALSE
CompanyJ_726,"After D-Wade apologized for breaking Kobes nose in the 2012 All-Star Game, Kobe said I love it  (via @nbaontnt)",111,4023,448317,452340,video,FALSE
CompanyJ_727,1998 All-Star Game Kobes first  Wasnt a starter during the season  Youngest All-Star in history (19)  Scored a team-high 18 PTS,127,1050,255707,256757,image,FALSE
CompanyJ_728,"Conquered basketball, making waves in soccer with PSG  (via @brfootball)",72,864,236376,237240,image,FALSE
CompanyJ_729,There will never be a better All-Star entrance than @shaq and the @jabbawockeez in 2009,87,2384,298775,301159,video,FALSE
CompanyJ_730,Back handspring into a dunk  @jclarkthejumper  #BRxNC,53,794,135743,136537,video,FALSE
CompanyJ_731,#NAME?,52,657,105001,105658,video,FALSE
CompanyJ_732,One year later and this still goes ,35,5956,500222,506178,video,FALSE
CompanyJ_733,One last All-Star matchup for Dirk and D-Wade.,46,237,77771,78008,video,FALSE
CompanyJ_734,@2Chainz shut it down at #BRxNC,31,160,84705,84865,carousel,TRUE
CompanyJ_735,D-Wade is going out on his own terms.,37,3031,512471,515502,image,FALSE
CompanyJ_736,One Last All-Star Intro ,24,1414,316510,317924,video,FALSE
CompanyJ_737,GIANNIS GOT UP.,15,2531,438631,441162,video,FALSE
CompanyJ_738,PG went 360 ,12,693,152656,153349,video,FALSE
CompanyJ_739,J. Cole brought out the old school Hornets jacket for his performance. Cold.,76,2144,506605,508749,image,FALSE
CompanyJ_740,Wade to Bron. Just like old times ,34,1803,357971,359774,video,FALSE
CompanyJ_741,This might be the last time we see a Bron-Wade alley-oop  (@metrobytmobile),75,524,173922,174446,video,FALSE
CompanyJ_742,DAME TIME FROM THE LOGO. TWICE.,31,1300,260315,261615,video,FALSE
CompanyJ_743,Dunks. Games. PB&Js.  The #BRxNC event had a little bit of everything ,70,98,38530,38628,video,FALSE
CompanyJ_744,Kyrie to Bron. Chemistry still there ,37,879,178353,179232,video,FALSE
CompanyJ_745,Game recognize game.,20,1451,352171,353622,image,FALSE
CompanyJ_746,The Steph to Giannis alley-oop was otherworldly ,48,1424,248889,250313,video,FALSE
CompanyJ_747,Captain to captain ,19,1387,392734,394121,image,FALSE
CompanyJ_748,PG remixed Hardens move.,24,2060,420131,422191,image,FALSE
CompanyJ_749,That was fun ,13,915,509387,510302,image,FALSE
CompanyJ_750,KD brings home another All-Star MVP ( @metrobytmobile),54,748,112823,113571,video,FALSE
CompanyJ_751,"On this day in 2002, a 17-year-old high school junior was crowned The Chosen One.  Even got the words tattooed on his back.  He lived up to the hype. (via @sportsillustrated)",174,3038,425246,428284,carousel,FALSE
CompanyJ_752,"D-Generation X will be inducted into the WWE Hall of Fame Class of 2019, per tim00/Twitter",90,4895,265781,270676,image,FALSE
CompanyJ_753,This fan wanted a little more than Steph's autograph... (via @hoopmag),70,2700,331872,334572,video,FALSE
CompanyJ_754,"One year ago, Kobe and Shaq sat down to hash things out.  Greatest duo ever? (via @NBAonTNT)",92,1866,314799,316665,carousel,FALSE
CompanyJ_755,"Russ on KD and Harden: We made it to the Finals when we were 23... If we stayed together, we couldve been a problem, per @lolnetwork",132,7890,636675,644565,image,FALSE
CompanyJ_756,"15 years ago today, the Pistons traded for Rasheed Wallace. He took Detroit over the top and helped upset the Kobe/Shaq Lakers in the 2004 Finals.",146,2294,261916,264210,image,FALSE
CompanyJ_757,"Nailing the Messi challenge...in a Ronaldo kit (via @dylanpimentel10, @brfootball)",82,902,119751,120653,video,FALSE
CompanyJ_758,"Manny Machado has agreed to a 10-year, $300M deal with the Padres ",66,6877,310892,317769,image,FALSE
CompanyJ_759,Just too easy for Melo Ball  @br_hoops,38,3146,229751,232897,video,FALSE
CompanyJ_760,Ter Stegens save was too good  (via @brfootball),48,718,80432,81150,video,FALSE
CompanyJ_761,Dame is committed to what he's built with the Blazers.,54,5426,341267,346693,image,FALSE
CompanyJ_762,WHAT A SAVE to keep Barcelona out ,34,428,59559,59987,video,FALSE
CompanyJ_763,Every sound youre about to hear was recorded at All-Star 2019. ,63,438,119104,119542,video,FALSE
CompanyJ_764,Star-studded  #NBAAllStar,25,597,262485,263082,carousel,FALSE
CompanyJ_765,Harden has put the team on his back.,36,2036,228601,230637,image,FALSE
CompanyJ_766,What if coaches wore sneakers on the sidelines? Who would have the most heat?  @BRKicks,87,2265,190110,192375,carousel,FALSE
CompanyJ_767,Is the Beard doing too much?,28,788,54900,55688,video,FALSE
CompanyJ_768,Ronaldo trolls hard  (via @brfootball),38,1353,94462,95815,video,FALSE
CompanyJ_769,LaMelo Ball says on Facebook's 'Ball In The Family' that he plans on playing college basketball and has talked to USC & Kansas  @br_hoops,137,5299,349829,355128,carousel,FALSE
CompanyJ_770,"2 years ago today, Boogie swapped his No. 15 Kings jersey to play alongside The Brow in New Orleans as No. 0",108,519,100179,100698,video,FALSE
CompanyJ_771,"LeBron says he has activated his playoff intensity earlier than usual with Lakers currently 10th in West, per @baxterholmes",123,10482,523485,533967,image,FALSE
CompanyJ_772,"The delivery man decided to take some shots at the house where he was dropping off a package  (via @owenmcallister2, @_lukemcallister)",134,11244,456942,468186,video,FALSE
CompanyJ_773,Zion left in the first minute of Duke-UNC with an injury after his foot blew through his shoe,93,9197,417066,426263,image,FALSE
CompanyJ_774,Obama is probably the real reason Duke-UNC tickets were selling for 2k,70,6756,595548,602304,image,FALSE
CompanyJ_775,What could he possibly be training for  (via @apiecebyguy),58,12185,252889,265074,video,FALSE
CompanyJ_776,IT speaking facts,17,3568,359165,362733,image,FALSE
CompanyJ_777,Anthony Davis and AB will be the next guests on #TheShopHBO ,60,1389,292658,294047,image,FALSE
CompanyJ_778,"The B/R Are You Listening? content series is about amplifying the voice of the modern black athlete, embracing their humanity and choosing to practice empathy.  With that purpose in mind, weve disabled comments in hopes that users respectfully LISTEN to, not debate, the experiences of these athletes.  Are You Listening? @thenbpa @bradbeal3",341,0,35741,35741,video,FALSE
CompanyJ_779,Marcus Smart is old-school.,27,2723,225085,227808,image,FALSE
CompanyJ_780,"How soccer fans in Russia greet their team bus  (via @zenit_spb, @brfootball)",77,2388,188296,190684,video,FALSE
CompanyJ_781,Boogie speaks on the Zion situation,35,2036,295268,297304,image,FALSE
CompanyJ_782,Who signs Zion?  @brkicks / @br_betting,39,10513,343900,354413,image,FALSE
CompanyJ_783,We linked up with NBA players in Charlotte for a game of Who Wore It: All Star Edition. Some of them were nicer than others   From @TISSOT.US x B/R  @bradbeal3 @traeyoung @therealmobamba @_kw15,193,129,46629,46758,video,FALSE
CompanyJ_784,"""Definitely one of the best two guards to ever play the game."" @theofficialai3 with a special tribute to D-Wade in Philly ",122,594,93898,94492,video,FALSE
CompanyJ_785,Kyries fadeaway game ,21,1368,216026,217394,video,FALSE
CompanyJ_786,"Space Jam 2 is coming July 16, 2021, per @springhillent",55,5737,516023,521760,image,FALSE
CompanyJ_787,D-Wade x Ben Simmons jersey exchange ,37,764,154848,155612,video,FALSE
CompanyJ_788,Look at the distance Giannis covered to chase down Tatum ,57,5715,383985,389700,video,FALSE
CompanyJ_789,Steph is a dunker now and he cant believe it ,45,3713,429460,433173,video,FALSE
CompanyJ_790,Kanter needed one win to be happy again ,40,1964,351580,353544,image,FALSE
CompanyJ_791,Don Nelson has been enjoying retirement ,40,2343,273960,276303,image,FALSE
CompanyJ_792,BRON STATUE OF LIBERTY.,23,2098,251341,253439,video,FALSE
CompanyJ_793,Lakers win as LeBron activates 'Playoff Mode' ,46,4080,446333,450413,image,FALSE
CompanyJ_794,DeMar makes his emotional return to the North tonight.,54,1877,240331,242208,video,FALSE
CompanyJ_795,"8 years ago today, Melo made the move back to his hometown of NYC.",66,1050,107598,108648,video,FALSE
CompanyJ_796,LeBron used his Secret Stuff to help the Lakers come back last night ,69,1442,197983,199425,video,FALSE
CompanyJ_797,"Patriots owner Robert Kraft has been charged with soliciting prostitution, per the Jupiter Police Department.",109,13717,358727,372444,image,FALSE
CompanyJ_798,PG-14? Paul George's jersey number switched to 14 ,50,4693,393377,398070,video,FALSE
CompanyJ_799,"Buddy Hield hit a deep clutch three, argued with his coach, then hesitated on the game-winner  Postgame: I should have pulled that b---h",136,6273,423358,429631,video,FALSE
CompanyJ_800,Playoff Bron had @badgalriri hyped at Staples Center last night ,64,1105,133982,135087,video,FALSE
CompanyJ_801,Yao Ming was a problem  #DripOrDrown2  @Yao x @Gunna,52,1564,209199,210763,video,FALSE
CompanyJ_802,Need a hype man like @zo (via @javalemcgee),43,4001,456350,460351,video,FALSE
CompanyJ_803,DeMar returns to Toronto tonight ,33,1552,426295,427847,image,FALSE
CompanyJ_804,OH MY DSJ.,10,4616,471055,475671,video,FALSE
CompanyJ_805,Trae Young literally spun his defender around ,46,12523,683672,696195,video,FALSE
CompanyJ_806,KAWHI STEALS THE BALL FROM DEMAR FOR THE WIN.,45,3466,293502,296968,video,FALSE
CompanyJ_807,DeMar and Kyle Lowry after the game...,38,641,113508,114149,video,FALSE
CompanyJ_808,DeMar appreciated the love in Toronto ,38,893,282661,283554,video,FALSE
CompanyJ_809,PG FLOATER FOR THE WIN IN 2OT.,30,8736,594098,602834,video,FALSE
CompanyJ_810,The Brodie & MVPG ,18,3749,497423,501172,image,FALSE
CompanyJ_811,Lift Off ,9,1022,316987,318009,image,FALSE
CompanyJ_812,41 PTS | 9 REB | 5 AST  LaMelo went off last night @br_hoops,60,2744,254481,257225,video,FALSE
CompanyJ_813,@leomessi hits 50 career hat-tricks  (via @brfootball),54,1205,155210,156415,image,FALSE
CompanyJ_814,A fan tweeted Ochocinco that they were about to get evicted. He immediately paid their rent. REAL ONE ,102,4301,510434,514735,carousel,FALSE
CompanyJ_815,Ben Simmons wasnt having it with Nurkic: You talk a lot of s--t for being ass  *NSFW*,85,7627,508255,515882,video,FALSE
CompanyJ_816,"DAngelo Russell took the leap at 22. - Career-high PPG, APG, FG% - Nets 6th in the East - Youngest to hit 500 3s - First All-Star berth  Today he turns 23. Whats next?",167,3746,430667,434413,image,FALSE
CompanyJ_817,It's Zion's world  (via @brkicks),33,1938,315633,317571,image,FALSE
CompanyJ_818,John Wall honors his mom with a new tattoo. He recently revealed she has cancer ,80,1566,260083,261649,image,FALSE
CompanyJ_819,Thomas Bryant almost punched the ref on this block celebration ,63,1428,200131,201559,video,FALSE
CompanyJ_820,Greatest shooter ever. (via @NBA),33,3370,258189,261559,video,FALSE
CompanyJ_821,Giannis got humbled by Tolliver ,32,2855,274935,277790,video,FALSE
CompanyJ_822,DLo dropped 40 PTS and took over in the 4Q on his birthday ,59,1847,223989,225836,video,FALSE
CompanyJ_823,It took Steve Kerr awhile to realize Draymond Green was hurt...,63,1740,214839,216579,video,FALSE
CompanyJ_824,"Giannis has been on another level  Last 10 games: 29.8 PPG, 12.3 REB, 6.8 APG, 1.6 BLK, 1.5 STL, 60.7 FG%, 10-0",111,4257,399031,403288,image,FALSE
CompanyJ_825,"Sarri tried to sub off Chelsea's goalkeeper, Kepa...but he refused to leave and Sarri flipped out  (via @skysports, @brfootball)",128,2853,172872,175725,video,FALSE
CompanyJ_826,"Kenneth Faried was benched, traded for cap space and waived in the past year.  Since joining the Rockets:  16 PPG, 9.9 REB (career-high paces)  Nine double-doubles in 14 games  More 3s than the rest of his career combined",221,4001,513955,517956,image,FALSE
CompanyJ_827,Tristan Thompson and Miles Bridges mimicked DAngelo Russells ice in my veins celebration vs Brooklyn.  D-Lo closed out both games  (H/T NetsDaily/Twitter),154,2921,375218,378139,video,FALSE
CompanyJ_828,The Knicks are scoring on their own basket now ,47,2690,237877,240567,video,FALSE
CompanyJ_829,Comeback season continues for Dipo  (Via @micah_lancaster),58,1866,291397,293263,video,FALSE
CompanyJ_830,DSJ led the Knicks to their first home win at The Garden since Dec 1st ,71,2033,310353,312386,image,FALSE
CompanyJ_831,What if?  @brkicks,18,5396,437151,442547,image,FALSE
CompanyJ_832,"Goalie cant stop scoring  (via @gkalshatti, @brfootball)",56,1551,121732,123283,video,FALSE
CompanyJ_833,"55 years ago today, Muhammad Alithen known as Cassius Clayshook up the world.",77,706,178449,179155,carousel,FALSE
CompanyJ_834,Tatums reserving his spot for next year.,40,393,50849,51242,video,FALSE
CompanyJ_835,"Michael Porter Jr. hasnt played all year (back), but now the rook is throwing down windmills with ease ",103,2829,205724,208553,video,FALSE
CompanyJ_836,Former No. 3 pick Trent Richardson is dominating in the @TheAAF: Most TDs  Sixth in yards Undefeated ,101,648,69035,69683,video,FALSE
CompanyJ_837,"Dennis Rodmans reaction to Joel Embiid saying MJ is not the GOAT  Youre doing a great job for your little island or country where youre from. Shut the f--k up, go do your goddamn job (via @tmz_tv)",196,10408,511405,521813,image,FALSE
CompanyJ_838,Stephs reaction to KDs filthy move on MKG ,42,3218,385780,388998,video,FALSE
CompanyJ_839,#NAME?,67,2218,329987,332205,video,FALSE
CompanyJ_840,New look for @dwyanewade ,25,1529,232965,234494,image,FALSE
CompanyJ_841,Noah out here hoopin' like it's 2014 ,37,3089,286309,289398,video,FALSE
CompanyJ_842,Avery Bradley dropped Ingram ,29,3333,247435,250768,video,FALSE
CompanyJ_843,History for The King ,21,2609,222151,224760,image,FALSE
CompanyJ_844,What a run for The Beard,24,2318,242582,244900,image,FALSE
CompanyJ_845,"Oh no, Lakers ",14,3114,211405,214519,video,FALSE
CompanyJ_846,Doc called a timeout to stop the game so Clippers players and fans could give Dirk a standing ovation ,102,5380,684788,690168,video,FALSE
CompanyJ_847,Lakers are 4-9 since Lonzo got hurt and have lost by an average of 16.8 PPG.,76,5497,401575,407072,image,FALSE
CompanyJ_848,Which way would you bet? @br_betting,36,4283,220661,224944,image,FALSE
CompanyJ_849,Josh Hart threw this fan some gum from the sideline  (via @claymassengille),75,788,216063,216851,video,FALSE
CompanyJ_850,@durkioworld and @bdotadot5 put on a show for the Iced Out Ballers in the #MtnDewxRufflesBallersBall (In Paid Partnership with @mountaindew),140,150,23357,23507,video,FALSE
CompanyJ_851,Tampering?  (Via @dloading),27,1680,254689,256369,image,FALSE
CompanyJ_852,"Leading the charge for the Ridge Riders, @Austinjmills and @famouslos32 balled out to get the dub in the #MtnDewxRufflesBallersBall (in paid partnership with @ruffles)",167,140,23949,24089,video,FALSE
CompanyJ_853,Kyrie is fed up ,16,6770,416376,423146,video,FALSE
CompanyJ_854,A young Nuggets fan pushed Russ so Westbrook had to have a chat with him real quick...,86,6378,482744,489122,video,FALSE
CompanyJ_855,Russ felt a boundary was crossed.,33,5671,184436,190107,video,FALSE
CompanyJ_856,PG dropped the hammer,21,720,119143,119863,video,FALSE
CompanyJ_857,"D.K. Metcalf is a 64, 230-lb WR who looks ready to destroy the NFL combine ",75,3449,227444,230893,video,FALSE
CompanyJ_858,"""BANG BANG""  Three years ago today, Steph Curry pulled up from 38 for the win",77,5198,297220,302418,video,FALSE
CompanyJ_859,Kemba hit Harden with his own step back. Thats cold.,52,6420,397922,404342,video,FALSE
CompanyJ_860,Wade nutmegged Draymond ,24,818,143942,144760,video,FALSE
CompanyJ_861,Vinsanity still living in the air at 42,39,1817,229677,231494,video,FALSE
CompanyJ_862,FATHER PRIME FOR THE WIN,24,31626,1344778,1376404,video,FALSE
CompanyJ_863,Mood.,5,2119,512485,514604,image,FALSE
CompanyJ_864,Tough times in Boston,21,2000,230139,232139,image,FALSE
CompanyJ_865,"""When Kobe hit that game winner on me in LA...off the glass from the top of the key I said how is that possible? Thank you for showing me the way. Mamba Mentality.""  @dwyanewade",177,2382,417421,419803,video,FALSE
CompanyJ_866,Aint that just like D-Wade?,27,887,311026,311913,image,FALSE
CompanyJ_867,Trae looks like The Answer in ATL,33,1767,255573,257340,image,FALSE
CompanyJ_868,King. Clutch.  ADs reaction ,28,7125,562470,569595,video,FALSE
CompanyJ_869,His house in 2009. His house in 2019. @dwyanewade,49,1998,389706,391704,video,FALSE
CompanyJ_870,D-Wade came through in the clutch.,34,880,395710,396590,image,FALSE
CompanyJ_871,And he just turned 20 today ,28,1608,311047,312655,image,FALSE
CompanyJ_872,"From game-worn shoes to a free concert for 900 fans, @stephencurry30 is the peoples champ ",90,740,121608,122348,video,FALSE
CompanyJ_873,Swoosh is King  @brkicks,24,5814,339386,345200,image,FALSE
CompanyJ_874,Jason Witten announces hes unretiring and returning to the Cowboys after year in MNF booth,90,1696,171952,173648,image,FALSE
CompanyJ_875,"NBA and WNBA stars are asked about the first time they were called the N-word.  The B/R Are You Listening? content series is about amplifying the voices of modern black athletes.  With that purpose in mind, weve disabled comments in hopes that users respectfully LISTEN to, not debate, the experiences of these athletes.  Are You Listening? @theNBPA @theWNBPA @3jmccollum @mac11 @fchwpo @aja22wilson  Watch the full video on IGTV",429,25,58593,58618,video,FALSE
CompanyJ_876,LeBron is ready for all challengers.,36,2827,272994,275821,image,FALSE
CompanyJ_877,#NAME?,64,1075,132372,133447,video,FALSE
CompanyJ_878,Toni Harris is breaking barriers in football.,45,5397,217518,222915,image,FALSE
CompanyJ_879,"Breaking: Bryce Harper is headed to the Phillies on a 13-year, $330M deal which breaks Giancarlo Stantons MLB record, per JeffPassan/Twitter",140,10559,421223,431782,image,FALSE
CompanyJ_880,@kingjames previewing a Kendrick verse off @2chainzs album Rap or Go to the League  *NSFW*,90,4074,210723,214797,video,FALSE
CompanyJ_881,Harden ISO-game has put him in the history books.,49,926,66418,67344,video,FALSE
CompanyJ_882,OH MY JORDAN POOLE.,19,793,107019,107812,video,FALSE
CompanyJ_883,"Larry Nance yelled ""ball don't lie"" twice after missed FT's on his flagrant foul ",81,3407,493980,497387,video,FALSE
CompanyJ_884,PJ Tucker was heated after getting called for an offensive foul and got ejected ,80,1876,218648,220524,video,FALSE
CompanyJ_885,D-Wade fakes never get old.,27,1641,208049,209690,video,FALSE
CompanyJ_886,"58 points, 10 assists, 7 rebounds, and a W for The Beard ",57,3509,339449,342958,image,FALSE
CompanyJ_887,D-Wade and CP3. Brothers for life.,34,533,163455,163988,video,FALSE
CompanyJ_888,James Harden now has six 50-PT games this season. No other player has more than one. ,85,4656,315372,320028,image,FALSE
CompanyJ_889,LeBron is the first athlete ever to A&R an album  #RapOrGoToTheLeague,69,3594,407241,410835,image,FALSE
CompanyJ_890,#GameOfZones is coming,22,1591,183146,184737,image,FALSE
CompanyJ_891,Coachs son got emotional when he realized the seniors wont be back next season  (via @levellemoton),99,3109,480770,483879,video,FALSE
CompanyJ_892,From the studio to the hardwood  @KingJames x @2Chainz #RapOrGoToTheLeague,74,823,89721,90544,video,FALSE
CompanyJ_893, THIS IS MARCH! @br_betting,27,1056,146269,147325,video,FALSE
CompanyJ_894,"If youre not here to compete or fight to the death, I dont want you on my team ",79,342,56121,56463,video,FALSE
CompanyJ_895,Trae Young has unlimited range ,31,2519,221002,223521,video,FALSE
CompanyJ_896,KAWHI FOR THE WIN.,18,1617,209497,211114,video,FALSE
CompanyJ_897,LaVine TOOK FLIGHT and put up a career-high 47 PTS in a 4OT win over the Hawks,78,1024,167338,168362,video,FALSE
CompanyJ_898,Trae Young has been BALLIN,26,4458,411800,416258,image,FALSE
CompanyJ_899,Bucks clinch a playoff spot with a win in L.A ,46,2623,434014,436637,image,FALSE
CompanyJ_900,"Wilt Chamberlain scored 100 points on March 2, 1962  57 years later, still a record",83,1996,250827,252823,image,FALSE
CompanyJ_901,The Ridge Riders. A 4-point shootout in the Around The Ridge Challenge. Chips for everyone.  @ruffles had everyone living like ballers at the #MtnDewxRufflesBasketballCourt,172,133,32276,32409,video,FALSE
CompanyJ_902,"Yo AB, tell that boy the route  still burned him  (via @ab)",59,1088,190912,192000,video,FALSE
CompanyJ_903,Trae Youngs playing like he heard the doubters.  His last five: 30 PTS | 10 AST 23 PTS | 8 AST 36 PTS | 8 AST 36 PTS | 10 AST 49 PTS | 16 AST,141,4313,401930,406243,image,FALSE
CompanyJ_904,Philly rides with No. 3,23,606,184835,185441,image,FALSE
CompanyJ_905,"D.K. Metcalf has taken over the NFL combine.  63"" 228lbs  27 reps  40.5"" vertical  4.33 40 time  1.6% body fat",110,8171,521457,529628,image,FALSE
CompanyJ_906,Barcelona against Real Madrid: 1-0 in March  3-0 in February  5-1 in October (via @brfootball),94,1232,130254,131486,image,FALSE
CompanyJ_907,Whoops ,7,2368,210259,212627,image,FALSE
CompanyJ_908,Oh? ,4,5596,306811,312407,image,FALSE
CompanyJ_909,DJJs hops are on another level ,31,1290,210715,212005,video,FALSE
CompanyJ_910,Favors BODIED Ilyasova ,23,876,137983,138859,video,FALSE
CompanyJ_911,Josh Jackson can fly ,21,745,138978,139723,video,FALSE
CompanyJ_912,D-Lo & Flash  #OneLastDance,27,955,351210,352165,image,FALSE
CompanyJ_913,Bron and the Lakers couldnt catch a break against the Suns,58,3322,202913,206235,video,FALSE
CompanyJ_914,Spida Mitchell comes up CLUTCH in win over Bucks and drops career-high 46 PTS ,78,1293,196370,197663,video,FALSE
CompanyJ_915,Lakers drop another game on the road with 19 games left Lost to last place Phoenix Suns 4.5 games back of 8th spot 3-7 in last 10 games,135,7347,345814,353161,image,FALSE
CompanyJ_916,Only Magic is ahead of Steph in @andres eyes,44,5713,337710,343423,image,FALSE
CompanyJ_917,"Today, 3/3, we pay tribute to Flash and all his greatness #DWadeDay",67,624,184248,184872,video,FALSE
CompanyJ_918,Steph stepped into the crowd to calm tensions between a Warriors fan and a security guard  (via @nce1913),105,2983,440466,443449,video,FALSE
CompanyJ_919,Montez Sweat ran a blazing 4.42. Record for a DL (since 2003). He's 260  (via @NFL),83,920,116543,117463,video,FALSE
CompanyJ_920,D-Wade State of Mind. #DWadeDay,31,407,94708,95115,video,FALSE
CompanyJ_921,Allen Iverson broke out one of his coldest crossovers ever on this day in 2006.  The Answer dropped Antonio Danielstwice,120,2097,229304,231401,video,FALSE
CompanyJ_922,The kid from Marquette became an NBA icon.  The one-man show became a selfless 3x champ.  #DWadeDay,99,1116,388268,389384,image,FALSE
CompanyJ_923,Wade County  #DWadeDay,22,687,249267,249954,image,FALSE
CompanyJ_924,Following in his dads footsteps. Hard work paid off for @zmane2 during his junior season. @br_hoops #DWadeDay,109,364,82227,82591,video,FALSE
CompanyJ_925,Kristine Anigwe put womens college hoops on notice with a 32 & 30 game ,71,1567,171183,172750,image,FALSE
CompanyJ_926,"Kareem Abdul-Jabbar sold his four championship rings, three MVP trophies and other memorbilia for nearly $3M and donated it to youth education ",143,8862,714560,723422,image,FALSE
CompanyJ_927,Zubac enjoying LAC,18,3424,343431,346855,image,FALSE
CompanyJ_928,This kid stared everybody down like he hit a game-winner in Game 7 of the Finals ,81,3911,419713,423624,video,FALSE
CompanyJ_929,From D-Wade to Z-Wade. The legacy continues. #DWadeDay,54,1220,396734,397954,image,TRUE
CompanyJ_930,Blake deserves the bucket for this ridiculous shot ,51,1839,277889,279728,video,FALSE
CompanyJ_931,"@snoopdogg is ready to sell his Lakers box seats for $5: ""They f--king suck."" *NSFW*",84,12013,366452,378465,video,FALSE
CompanyJ_932,#NAME?,85,1642,244138,245780,video,FALSE
CompanyJ_933,Mtn Dews Iced Out Ballers balled out in the #MtnDewxRufflesBallersBall Check out @MountainDews squad on the limited edition cans,128,106,23054,23160,video,FALSE
CompanyJ_934,Blake puts it all into perspective.,35,1297,239897,241194,image,FALSE
CompanyJ_935,PG-13 has made a legitimate MVP push in his second season with OKC. It always looks so easy for him.,100,3366,316092,319458,video,FALSE
CompanyJ_936,Something to look forward to ,29,2040,340711,342751,image,FALSE
CompanyJ_937,"The refs eyebrows and hair literally froze at the coldest game in MLS history  (via @coloradorapids, @btyphoto)",111,4157,429611,433768,image,FALSE
CompanyJ_938,The Brazilian Open used adoptable shelter puppies as 'ball dogs' for the fourth straight year. The pups stole the show ,119,438,44251,44689,video,FALSE
CompanyJ_939,#NAME?,19,1863,247436,249299,image,FALSE
CompanyJ_940,Loading ,8,5416,432158,437574,image,FALSE
CompanyJ_941,The Barclays crowd goes wild for Dirk after he hits his first shot of the night ,80,1140,216467,217607,video,FALSE
CompanyJ_942,D-Wade moves ahead of MJ ,25,1529,275910,277439,image,FALSE
CompanyJ_943,This is what its all about #OneLastDance,40,1546,443230,444776,image,FALSE
CompanyJ_944,Pat Bev already getting in LeBrons head ,40,5115,393473,398588,video,FALSE
CompanyJ_945,Checking in on the Lakers...,28,12705,562858,575563,video,FALSE
CompanyJ_946,Lakers took another L and Pat Bev was loving it ,48,5718,335912,341630,video,FALSE
CompanyJ_947,The Champions League second legs are here. #ForTheThrone (via @brfootball),74,262,38578,38840,video,FALSE
CompanyJ_948,Mike Tyson at 52  (via @BoxingLiife),36,15771,544656,560427,video,FALSE
CompanyJ_949,The only player who can save the Lakers,39,3990,173032,177022,video,FALSE
CompanyJ_950,Turn too smooth on the assist ,30,499,50863,51362,video,FALSE
CompanyJ_951,Three-peat champions Real Madrid are knocked out of the Champions League  (via @brfootball),91,2465,161940,164405,image,FALSE
CompanyJ_952,AJAX TOO SMOOTH  (via @brfootball),34,825,61801,62626,video,FALSE
CompanyJ_953,Trae Young is keeping the battle for ROY interesting ,53,1989,122711,124700,video,FALSE
CompanyJ_954,"That was tough, D-Rose ",23,2382,214466,216848,video,FALSE
CompanyJ_955,BIG NIGHT for RJ Barrett: Dropped 28 to help Duke hold off Wake Forest and set the Blue Devil freshman scoring record with 696 PTS.,131,3234,373498,376732,image,FALSE
CompanyJ_956,CLUTCH CONLEY.  40-piece and a 4-point play to seal the game ,61,2388,244551,246939,video,FALSE
CompanyJ_957, TATUM ,7,2699,199746,202445,video,FALSE
CompanyJ_958,Things got chippy between Boogie and the Celtics ,49,12242,463543,475785,video,FALSE
CompanyJ_959,Huge night for Gordon Hayward: 30 PTS | 7 REB | 4 AST | 128-95 W over the Warriors,82,3063,327316,330379,image,FALSE
CompanyJ_960,"19 years ago today, @shaq dropped 61 PTSon his birthday  (via @nbaontnt)",72,762,138076,138838,video,FALSE
CompanyJ_961,59 Chris Clemons is serving up 30.1 PPG as the nations leading scorer (@gocamels),81,944,105294,106238,video,FALSE
CompanyJ_962,Well then...,12,4671,262307,266978,image,FALSE
CompanyJ_963,"To be fair, the Wolves made it last year ",41,6515,415344,421859,image,FALSE
CompanyJ_964,Pepes F - - k you. Dzekos flop ,31,1965,99824,101789,video,FALSE
CompanyJ_965,MANCHESTER UNITEDS COMEBACK IS COMPLETE! (via @brfootball),58,753,109395,110148,image,FALSE
CompanyJ_966,Neymar couldn't believe it (via @brfootball),44,1665,173238,174903,video,FALSE
CompanyJ_967,FOR THE WIN AT THE DEATH. CLUTCH @marcusrashford  (@brfootball),63,485,56161,56646,video,FALSE
CompanyJ_968,D-Lo brought out the shammgod ,30,7200,511382,518582,video,FALSE
CompanyJ_969,TALK TO EM @ecambage,20,9046,275321,284367,image,FALSE
CompanyJ_970,39 and a game-winner against the Sixers for LaVine,50,1445,288406,289851,image,FALSE
CompanyJ_971,"LaVine goes off for 39 points, hits go-ahead bucket in crucial late season game for Philly.",91,1190,292336,293526,video,FALSE
CompanyJ_972,LeBron pushes past MJ on the all-time scoring list ,51,10761,530278,541039,image,FALSE
CompanyJ_973, HISTORY MADE  Bron gets emotional after passing MJ in all-time scoring.,72,5326,523132,528458,image,FALSE
CompanyJ_974,GORDON HAYWARD FTW,18,1149,149344,150493,video,FALSE
CompanyJ_975,Rondo sitting as far away from the Lakers bench as possible? ,61,6246,397572,403818,video,FALSE
CompanyJ_976,Magic and Pelinka look like they got a lot on their mind ,57,3708,274435,278143,video,FALSE
CompanyJ_977,Like Mike.,10,3269,385403,388672,image,FALSE
CompanyJ_978,Thank you MJ. @KingJames brought out the Jordan 3 inspired LeBron 16 last night. @BRKicks (via @NBA),100,925,149565,150490,carousel,FALSE
CompanyJ_979,The @mountaindew x @ruffles Ballers Ball had fans going crazy all day long at #BRxNC. #AllStarWeekend2019,105,137,23735,23872,video,TRUE
CompanyJ_980,A legendary night for No. 23 ,29,879,81519,82398,video,FALSE
CompanyJ_981,PJ Tucker is old school. @brkicks,33,1005,182638,183643,carousel,FALSE
CompanyJ_982,The renovations to this rec gym and @jeks_ncs mural left these kids speechless  (In Partnership with @NewYorkLife x B/R),120,191,32878,33069,video,FALSE
CompanyJ_983,Rondo clears the air,20,4681,498364,503045,image,FALSE
CompanyJ_984,"One more year please, Vince ",28,3170,357749,360919,image,FALSE
CompanyJ_985,Tacko Fall sees his mother for the first time after seven years. She traveled from Senegal to UCF to watch him play for the first time  (via @ucf.mbb),150,2060,361863,363923,video,FALSE
CompanyJ_986,Bucks @sterlingbrown23 named all 50 states in 30 seconds ,57,1149,108916,110065,video,FALSE
CompanyJ_987,Giannis just isnt fair...,25,1785,181970,183755,video,FALSE
CompanyJ_988,@david_irving95 explains why he's done with football while smoking weed *NSFW*,78,3296,130059,133355,video,FALSE
CompanyJ_989,Giannis dunked all over the Pacers ,35,1370,266005,267375,video,FALSE
CompanyJ_990,"Steelers are nearing a deal to send Antonio Brown to the Bills, per @rapsheet",77,10570,300502,311072,image,FALSE
CompanyJ_991,@ab isn't having it,19,4160,251903,256063,image,FALSE
CompanyJ_992,Russell Westbrook knocked down Jusuf Nurkic after getting tripped at the Moda Center. Westbrook got charged with a flagrant 1 foul and Nurkic got a technical.,158,6239,400030,406269,video,FALSE
CompanyJ_993,AB pleading his case to not get traded to Buffalo ,50,1647,107182,108829,video,FALSE
CompanyJ_994,"Late in the 4Q, Jusuf Nurkic and Paul George got into it and received double technicals. Nurkic was ejected with his 2nd technical of the game.",143,3178,320227,323405,video,FALSE
CompanyJ_995,Dame and Russ went at it ,25,3043,327034,330077,image,FALSE
CompanyJ_996,Strong. Confident. Bold. Phenomenal. #InternationalWomensDay,60,879,71666,72545,video,FALSE
CompanyJ_997,Zach LaVine has scored more points than anyone in the NBA outside of Westbrook since All-Star break,99,3327,406877,410204,image,FALSE
CompanyJ_998,Marvin Williams knows how important it is to give back to your community (In partnership with @newyorklife x B/R),113,110,30188,30298,video,FALSE
CompanyJ_999,Patrick Beverley and the Clippers arent backing down on this playoff push ,74,2129,126373,128502,video,FALSE
CompanyJ_1000,The Mamba gives his take on Ben Simmons,39,2592,314547,317139,image,FALSE
CompanyJ_1001,#InternationalWomensDay ,24,1732,197183,198915,carousel,FALSE
CompanyJ_1002,Bron's doppelgnger is already in the offseason  (via michellethi24/TW),70,6272,391333,397605,video,FALSE
CompanyJ_1003,Robin Lopez gave the work to Drummond ,38,4327,462784,467111,video,FALSE
CompanyJ_1004,Does Dirk have a point?,23,4387,398702,403089,image,FALSE
CompanyJ_1005,"Andre Drummond bricked a three, Dwayne Casey wasnt thrilled",59,2393,206492,208885,video,FALSE
CompanyJ_1006,Ready for Playoff Harden?,25,1428,152604,154032,image,FALSE
CompanyJ_1007,39 points in his return. Nobody could stop Klay tonight ,56,1135,298843,299978,image,FALSE
CompanyJ_1008,"Klay Thompson could not miss against the Denver Nuggets, going 9-for-11 on 3-pointers and finishing with 39 points in his return.",129,2425,335475,337900,video,FALSE
CompanyJ_1009,Julio Jones could play defense too  (via @thecheckdown),55,2299,192606,194905,video,FALSE
CompanyJ_1010,"Imagine trusting your friends this much  (via @NoahSchone, @Spencer_jwallace, @Bnielz12)",88,1903,104619,106522,video,FALSE
CompanyJ_1011,"THIS IS MY HOUSE  10 years ago today, Flash reminded everyone who runs Miami",76,746,150744,151490,video,FALSE
CompanyJ_1012, BLAKE IS WAY MORE THAN JUST A DUNKER,37,2946,287710,290656,video,FALSE
CompanyJ_1013,Brandon Ingram is expected to miss the remainder of the season with Deep Venous Thrombosis (DVT) in his arm.,108,6185,330010,336195,image,FALSE
CompanyJ_1014,Does Kyrie have a point?,24,4001,306586,310587,image,FALSE
CompanyJ_1015,Bronny James AAU team not playing around in 2019  @br_hoops,59,1465,208587,210052,video,FALSE
CompanyJ_1016,North Carolina beats Duke 79-70 ,32,336,10877,11213,video,FALSE
CompanyJ_1017,Pat Beverley is always ready.,29,2625,282248,284873,image,FALSE
CompanyJ_1018,Coach K expects Zion to return for the ACC tournament,53,1582,331809,333391,image,FALSE
CompanyJ_1019,That up-and-under never gets old ,33,1018,189016,190034,video,FALSE
CompanyJ_1020,D-Lo heard the Youre a snitch! chants and knocked down both free throws ,72,1830,224697,226527,video,FALSE
CompanyJ_1021,"BREAKING: Antonio Brown is being traded to the Raiders, per Pro Football Talk",77,9039,497183,506222,image,FALSE
CompanyJ_1022," BOOMIN   Raiders are making AB the highest-paid WR in the league. Hes going from $0 guaranteed in the next three years to $30.125M, per Pro Football Talk",154,3097,399128,402225,image,FALSE
CompanyJ_1023,Down 16 30 seconds left Watch the comeback *NSFW* (via Arhamur_/Twitter),72,10753,516784,527537,carousel,FALSE
CompanyJ_1024,"With @ab to the Raiders, his wild trade saga is finally over",60,692,112243,112935,video,FALSE
CompanyJ_1025,"15 years ago today, a second broken nose forced Rip Hamilton to don his trademark mask for the first time.  He wore it for the rest of his career.",146,1931,331439,333370,image,FALSE
CompanyJ_1026,@jharden13 could go scoreless the rest of the season and still average 28.6 PPG..which would lead the league  (h/t nba_reddit),126,5661,410930,416591,image,FALSE
CompanyJ_1027,Unforgettable moment for this young fan  @brkicks (via @nba),60,731,144550,145281,video,FALSE
CompanyJ_1028,Marcus Morris has Kyries back ,30,1013,273310,274323,image,FALSE
CompanyJ_1029,Greg Oden went back to Ohio State to get his degree. Today they honored him at senior day  (via @elevenwarriors),112,948,127514,128462,video,FALSE
CompanyJ_1030,INSANITY.,9,5890,413207,419097,video,FALSE
CompanyJ_1031,#NAME?,31,3549,252370,255919,video,FALSE
CompanyJ_1032,Coldest photo of the season?,28,3962,470424,474386,image,FALSE
CompanyJ_1033,Every little kid wants to be like their sports hero ,52,1254,277260,278514,video,FALSE
CompanyJ_1034,Booker scored 13-straight points in the 4th and finished with 37/8/11 in a win against the Warriors ,100,2672,354977,357649,video,FALSE
CompanyJ_1035,Derrick Jones Jr. climbed the ladder for this one ,50,670,108642,109312,video,FALSE
CompanyJ_1036,Will Simmons and Embiid bring a title to Philly?,48,4533,339854,344387,image,FALSE
CompanyJ_1037,BREAKING: Zidane is BACK at Real Madrid. He replaces Solari as manager on a deal until 2022 (via @brfootball),109,888,125287,126175,image,FALSE
CompanyJ_1038,"Andre Ingram has signed a 10-day contract with the Lakers, per @shamsnba",72,7937,501805,509742,image,FALSE
CompanyJ_1039,24.6 PPG 10.0 APG Electrifying dunks  Ja Morant (@igotgame12_) is about to take over March Madness ,99,544,87563,88107,video,FALSE
CompanyJ_1040,Kyrie is holding himself accountable.,37,1924,241527,243451,image,FALSE
CompanyJ_1041,"Former Giants safety Landon Collins is signing a six-year, $84M deal with the Redskins, per @rapsheet",101,2158,173507,175665,image,FALSE
CompanyJ_1042,DAD GAME STRONG (via @taylorscalera),36,2511,171854,174365,video,FALSE
CompanyJ_1043,LaMelo Ball and SPIRE closed out its season against Arizona's Bella Vista Prep at The Grind Session World Championship @br_hoops,128,793,206110,206903,video,FALSE
CompanyJ_1044,"Breaking: Nick Foles is signing with the Jaguars, per @rapsheet",63,3622,315151,318773,image,FALSE
CompanyJ_1045,"Breaking: Bucs are trading DeSean Jackson to the Eagles, per @caplannfl",71,4016,288842,292858,image,FALSE
CompanyJ_1046,The moment Andre Ingram found out he was heading back to the NBA  (via @southbaylakers),87,2850,355866,358716,video,FALSE
CompanyJ_1047,"Tyrann Matthieu aka Honey Badger is expected to sign a 3-year, $42M deal with the Chiefs, per @adamschefter",107,2583,227047,229630,image,FALSE
CompanyJ_1048,The Nets bench celebration is a classic ,40,2309,250348,252657,video,FALSE
CompanyJ_1049,Ibaka and Chriss out here throwing punches ,43,14131,544883,559014,video,FALSE
CompanyJ_1050,ANKLES,6,1891,170779,172670,video,FALSE
CompanyJ_1051,GOAT 6th Man? ,14,3589,356051,359640,image,FALSE
CompanyJ_1052,Russ explains what happened during the game vs. Utah,52,10335,481480,491815,image,FALSE
CompanyJ_1053,"22 years ago today, rookie Allen Iverson hit Michael Jordan with one of the most iconic crossovers ever.",104,4241,465589,469830,video,FALSE
CompanyJ_1054,Inspiration for the next generation  (In partnership with @newyorklife x B/R),77,82,26401,26483,video,FALSE
CompanyJ_1055,PJ can't keep up with CP3's collection. Full PJ Tucker interview at @BRKicks,76,1201,277712,278913,image,FALSE
CompanyJ_1056,Unreal footwork to get out of that tight spot  (via @uslchampionship) @brfootball,81,1252,125533,126785,video,FALSE
CompanyJ_1057,Raymond Felton has Russ back,28,3813,312315,316128,image,FALSE
CompanyJ_1058,Curry hit 34 threes in a row after hitting 41 consecutively. He doesnt miss. (via @ashleynevel),95,6207,318476,324683,video,FALSE
CompanyJ_1059,HUGE GOAL FROM @cristiano ,26,599,64101,64700,video,FALSE
CompanyJ_1060,"Elena Delle Donne stopped by St. Johns College High to surprise Azzi Fudd, the first sophomore to ever win the Gatorade National Girls Basketball POY award ",156,167,20612,20779,video,FALSE
CompanyJ_1061,Jazz have banned the fan who engaged in the inappropriate interaction with Russ; Westbrook has been fined $25K,110,6074,314755,320829,image,FALSE
CompanyJ_1062,#NAME?,101,839,143770,144609,image,FALSE
CompanyJ_1063,Ronaldo trolls Atletico with the celebration Diego Simeone did against Juventus in the first leg (via @brfootball),114,1217,93808,95025,video,FALSE
CompanyJ_1064,Ronaldo hat-trick FOR THE COMEBACK   (via @brfootball),54,382,49061,49443,video,FALSE
CompanyJ_1065,Lou Will. Professional Bucket-Getter.  Will he go back to back as 6th Man of the Year?,86,667,90650,91317,video,FALSE
CompanyJ_1066,"Breaking: Odell Beckham Jr has been traded to the Browns, per @mike_garafolo",76,29766,830426,860192,image,FALSE
CompanyJ_1067,New King of Cleveland  (via @obj),33,5746,503270,509016,video,FALSE
CompanyJ_1068,From LSU to Cleveland.  Jarvis Landry and Odell Beckham Jr are teammates again ,79,1246,279249,280495,image,FALSE
CompanyJ_1069,OBJ saying goodbye to Saquon... (via @theshiggyshow),52,171,6849,7020,video,FALSE
CompanyJ_1070,"First Porzings, now OBJ ",24,4363,261563,265926,video,FALSE
CompanyJ_1071,YEAR 16 ,8,1465,288704,290169,image,FALSE
CompanyJ_1072,The Lakers are having fun again,31,6286,425893,432179,video,FALSE
CompanyJ_1073,"LeVeon Bell will sign with the New York Jets, per @adamschefter",63,6953,408727,415680,image,FALSE
CompanyJ_1074,Get used to this on Sundays.,28,3525,410551,414076,image,FALSE
CompanyJ_1075,"After sitting out last year, @leveonbell is finally on the move ",64,646,94723,95369,video,FALSE
CompanyJ_1076,Snow really stopped them from scoring  (via @bundesliga_en),59,2393,218035,220428,video,FALSE
CompanyJ_1077,OBJ and Baker at their first Browns practice ,45,5772,387087,392859,video,FALSE
CompanyJ_1078,The Ravens making moves ,24,3823,313909,317732,image,FALSE
CompanyJ_1079,The Brodie brought out the shimmy ,34,2474,319962,322436,video,FALSE
CompanyJ_1080,OBJ has Cleveland buzzing ,26,498,121374,121872,video,FALSE
CompanyJ_1081,Light work for Pat Bev,22,3895,275757,279652,image,FALSE
CompanyJ_1082,ICE COLD from Messi  (via @brfootball),38,1459,137448,138907,video,FALSE
CompanyJ_1083,#NAME?,32,624,162952,163576,image,FALSE
CompanyJ_1084,"Zion Williamson will play tonight vs. Syracuse, first game since his knee injury against UNC",92,1498,319554,321052,image,FALSE
CompanyJ_1085,Penny Hardaway returned home to coach after a dying childhood friend reached out for help: He scribbled on the paper1Cent,121,224,76127,76351,video,FALSE
CompanyJ_1086,Ray Allen hasnt seen a more dominant tournament than Kembas 6-game run in 2011   From BR x @uninterrupted x Audi Q8,115,195,32260,32455,video,FALSE
CompanyJ_1087,"Nevada stars Cody and Caleb Martin regularly faced racism, including threats of violence, growing up in a small North Carolina town.  The twins mother: Youre thinking, Whats next? Are they going to set your house on fire?",221,890,99858,100748,video,FALSE
CompanyJ_1088,Brutal dummy from Suarez  (va @brfootball),42,1638,146907,148545,video,FALSE
CompanyJ_1089,ZION BACK.,10,3696,520599,524295,image,FALSE
CompanyJ_1090,Wes Matthews putback FOR THE WIN,32,809,95456,96265,video,FALSE
CompanyJ_1091,Bron with AUTHORITY ,20,1486,180033,181519,video,FALSE
CompanyJ_1092,Kevin Harlan really broke down someone spilling a drink courtside ,66,1820,299462,301282,video,FALSE
CompanyJ_1093,SPIDA WITH UNLIMITED BOUNCE ,28,500,119305,119805,video,FALSE
CompanyJ_1094,Zion puts on a show in his return  29 PTS 14 REB 5 STL 1 BLK 13-13 FG,69,3581,563518,567099,image,FALSE
CompanyJ_1095,JOKIC FOR THE WIN,17,1306,138967,140273,video,FALSE
CompanyJ_1096,The Joker gets his first career game-winning buzzer-beater in the Nuggets win over the Mavs ,92,863,239955,240818,image,FALSE
CompanyJ_1097,Jokic answered Lukas poster dunk with a game-winner ,52,1464,214623,216087,video,FALSE
CompanyJ_1098,The road to the Champions League final is set   (via @brfootball),65,1880,123567,125447,image,FALSE
CompanyJ_1099,Just in time for the playoffs  #GameOfZones,43,334,55016,55350,video,FALSE
CompanyJ_1100,Zion has no problem wearing Nike @brkicks,41,1491,285659,287150,image,FALSE
CompanyJ_1101,Paul George has been on one this year ,38,1068,124685,125753,video,FALSE
CompanyJ_1102,Blakes handles have been on another level this season ,54,3648,467299,470947,video,FALSE
CompanyJ_1103,Kembas moves are unfair ,24,1143,164231,165374,video,FALSE
CompanyJ_1104,Winslow GOT UP on D-Wades lob ,30,967,210352,211319,video,FALSE
CompanyJ_1105,What a no-look dime from Giannis ,33,400,97131,97531,video,FALSE
CompanyJ_1106,This Admiral Schofield poster had everybody out of their seat ,62,1387,197784,199171,video,FALSE
CompanyJ_1107,Down goes UNC. What a night for Zion.,37,3617,516975,520592,image,FALSE
CompanyJ_1108,Doc Rivers and Jim Boylen got ejected... at the same time,57,960,183525,184485,video,FALSE
CompanyJ_1109,"James Harden had another standout performance and filled up the stat sheet vs. the Phoenix Suns: 41 PTS, 11 AST, 9 REB.",119,2641,286032,288673,video,FALSE
CompanyJ_1110,Ben Simmons makes passing highlight worthy,42,1096,168203,169299,video,FALSE
CompanyJ_1111,March 16 should be Stone Cold day ,34,3007,313206,316213,image,FALSE
CompanyJ_1112,"On this day in 2007, Kobe began one of the most ridiculous scoring streaks of all time.  65 PTS, W 50 PTS, W 60 PTS, W 50 PTS, W",128,5118,441843,446961,image,FALSE
CompanyJ_1113,Brandon Ingram expected to make a full recovery for next season after successful surgery to treat blood clot in his right arm ,126,1845,311141,312986,image,FALSE
CompanyJ_1114,"CJ McCollum was always a problem   Seven years ago today, the junior dropped 30 PTS for No. 15-seeded Lehigh and upset No. 2-seeded Duke (via @marchmadness)",156,1440,192823,194263,video,FALSE
CompanyJ_1115,Dame pulling up as Stone Cold again tonight to celebrate 3:16? (via @trailblazers),82,3763,365241,369004,video,FALSE
CompanyJ_1116,"Johnny Manziel is back.  QB has signed with the @theaaf and will go through the waiver system, per @adamschefter.",113,1795,179750,181545,image,FALSE
CompanyJ_1117,"In a bizarre sequence of events, the New Orleans Pelicans forgot they ran out of timeouts and got hit with a last second technical foul and lost to the Phoenix Suns in OT.",171,2078,347837,349915,video,FALSE
CompanyJ_1118,Duke takes down FSU to win the ACC title ,41,2245,475336,477581,image,FALSE
CompanyJ_1119,Steph went off with these moves ,32,4007,202093,206100,video,FALSE
CompanyJ_1120,Paul Millsap FOR THE WIN,24,847,134415,135262,video,FALSE
CompanyJ_1121,West Hams Chicharito hit LeBrons Silencer celebration from his Miami days (via @brfootball),91,1404,274923,276327,image,FALSE
CompanyJ_1122,Clyde Frazier criticizes LeBron for not being part of the team and says he doesnt really care ,94,7561,340008,347569,video,FALSE
CompanyJ_1123,"18 years old, I was 135 soaking wet.   Jason Terry knows Zion is just built different.  From Bleacher Report x @uninterrupted x Audi Q8",135,328,63601,63929,video,FALSE
CompanyJ_1124,HEZONJA BLOCKS LEBRON TO WIN,28,14855,479327,494182,video,FALSE
CompanyJ_1125,Wonder if DeAndre wanted Dotson to shoot this (sound on) *NSFW*,63,1497,273808,275305,video,FALSE
CompanyJ_1126,Giannis dropped 52 in another MVP-worthy performance  ( @metrobytmobile),72,3370,203740,207110,video,FALSE
CompanyJ_1127,Your No. 1 seeds. Did they get it right?,40,1483,117475,118958,video,FALSE
CompanyJ_1128,When you cram for March Madness and still fail ,47,430,88619,89049,video,FALSE
CompanyJ_1129,Mike Scott needed a quick sip  (via @shaqtinafool),50,786,102767,103553,video,FALSE
CompanyJ_1130,Ja Morant vs. Markus Howard in the 1st round ,45,3884,362613,366497,image,FALSE
CompanyJ_1131,Giannis adding to his MVP case ,31,1764,260595,262359,image,FALSE
CompanyJ_1132,Embiid really crossed Giannis ,30,2383,257012,259395,video,FALSE
CompanyJ_1133,What a photo...,15,16286,731119,747405,image,FALSE
CompanyJ_1134,D-Lo too cold with it ,22,3145,348739,351884,video,FALSE
CompanyJ_1135,LOU WILL. GAME. WINNER.,23,5039,413172,418211,video,FALSE
CompanyJ_1136,Now and then... #MarchMadness,29,2473,574138,576611,carousel,FALSE
CompanyJ_1137,24 years ago...,15,2548,414959,417507,image,FALSE
CompanyJ_1138,"@leomessi is on a tear  His last three games: hat-trick, 2 goals/2 assists, goal/assist (via @brfootball)",105,1142,145655,146797,image,FALSE
CompanyJ_1139,Six years ago today. One of @kingjames meanest dunks. (via @nbatv),66,4101,291625,295726,video,FALSE
CompanyJ_1140,Theres a science to building a bust-proof bracket ,50,239,42277,42516,video,FALSE
CompanyJ_1141,Is Giannis the modern Shaq?  Freak this season (age 24) 27.5 PPG | 12.7 REB | 6.0 AST | 58 FG%  Diesel in 1996-97 (age 24) 26.2 PPG | 12.5 REB | 3.1 AST | 55.7 FG%,163,11819,557606,569425,image,FALSE
CompanyJ_1142,If this years tournament is anything like last year...buckle up.,64,549,98785,99334,video,FALSE
CompanyJ_1143,Past meets the present. #MarchMadness,37,3650,701373,705023,carousel,FALSE
CompanyJ_1144,Ingles had Beal stumbling ,26,2110,167516,169626,video,FALSE
CompanyJ_1145,What a moment. Celtics pay tribute to IT ,41,4499,514514,519013,video,FALSE
CompanyJ_1146,History for Dirk ,17,1688,309503,311191,image,FALSE
CompanyJ_1147,Best NBA coach of all time?,27,4507,423257,427764,image,FALSE
CompanyJ_1148,"BREAKING: Mike Trout finalizing a record-breaking 12-year contract worth more than $430 million with the Angels, per @jeffpassan",128,6642,355636,362278,image,FALSE
CompanyJ_1149,"Trolling fans everywhere he goes, Michigan freshman Ignas Brazdeikis is the villain of #MarchMadness ",101,1598,171722,173320,video,TRUE
CompanyJ_1150,"LSUs Wayde Sims was shot and killed in September, but his best friend Skylar Mays still feels his presence on the court: When shots go in ... Im like, Yeah that was Wayde.",171,488,104524,105012,video,FALSE
CompanyJ_1151,This trio is worth more than a billion ,39,2189,179767,181956,image,FALSE
CompanyJ_1152,Last year was filled with upsets. Which top seeds are going down this year?,75,592,66828,67420,video,FALSE
CompanyJ_1153,No. 1 recruit and Memphis commit James Wiseman wins @Gatorade National Player of the Year,89,246,37737,37983,video,FALSE
CompanyJ_1154,"6x Pro Bowler and SB Champ Clay Matthews is signing with the Rams, per @rapsheet",80,5973,350710,356683,image,FALSE
CompanyJ_1155,Kemba in March >>,17,1432,189319,190751,video,FALSE
CompanyJ_1156,Beard has now scored at least 30 against every team this season ,64,3105,343583,346688,video,FALSE
CompanyJ_1157,D-Lo dropped 27 (!) in the fourth and a career-high 44 PTS. Sheesh.,67,7178,500304,507482,video,FALSE
CompanyJ_1158,"""I'm built for this s--t."" Talk your talk, D-Lo",47,7422,525091,532513,video,FALSE
CompanyJ_1159,Silence the doubters. This man is another level this season ,60,4278,503475,507753,image,FALSE
CompanyJ_1160,Duke's @RJBarrett is leading the Canadian revolution of March Madness ,70,621,105124,105745,video,FALSE
CompanyJ_1161,Sansa Stark (@sophiet) with a top 10 celebrity Jumbotron appearance  (via eirumas/Twitter),90,2507,188268,190775,video,FALSE
CompanyJ_1162,#NAME?,75,842,134117,134959,video,FALSE
CompanyJ_1163,#NAME?,138,1679,239451,241130,image,FALSE
CompanyJ_1164,Steve Nash visits his godson RJ Barrett to go inside Dukes brotherhood with Zion  then Coach K reveals why RJ will be one of the best players in the NBA right away. Watch the full story on IGTV,193,803,163682,164485,video,FALSE
CompanyJ_1165,Tim Duncan's dreads are coming in  (via @jacobxdavilax),55,5176,433507,438683,image,FALSE
CompanyJ_1166,Wise words from The Mamba ,26,2263,385605,387868,image,FALSE
CompanyJ_1167,"Say it with your chest, Dame ",29,10130,526512,536642,image,FALSE
CompanyJ_1168,KD brought pizza to this fans hotel room after meeting their dad in the elevator (via TomMount223/Twitter),106,2474,281406,283880,video,FALSE
CompanyJ_1169,Kobe calls out three stars in the 2019 Mamba Mentality Challenge. Are they ready?,81,839,111759,112598,video,FALSE
CompanyJ_1170,"Coach Pop gifts D-Wade signed jerseys of Tim Duncan, Manu and Tony Parker in pregame ",85,2267,440756,443023,video,FALSE
CompanyJ_1171,Jimmy's face after hitting the dagger on the Celtics was priceless,66,7259,615458,622717,video,FALSE
CompanyJ_1172,Marcus Smart and Joel Embiid got into a shoving match that resulted in Smart getting ejected.,93,7338,449865,457203,video,FALSE
CompanyJ_1173,Joel Embiid making it known.,28,8219,276187,284406,image,FALSE
CompanyJ_1174,Madness is here.,16,1195,260592,261787,image,FALSE
CompanyJ_1175,The Tournament all comes down to one question: Can you get hot for 6 games?  From @bleacherreport x @uninterrupted x Audi Q8,124,122,26141,26263,video,FALSE
CompanyJ_1176,"Ichiro Suzuki officially announces his retirement after 19 seasons in MLB and 9 seasons in Japan.  3,000-hit club 4,367 combined hits 2001 MLB AL MVP & ROY 10x MLB All-Star 10x MLB Gold Glove  Legend ",200,1813,248639,250452,image,FALSE
CompanyJ_1177,All eyes on Duke as the tournament kicks off,44,3424,478098,481522,image,FALSE
CompanyJ_1178,"From Zion to Ja, each region has a star ready to own the whole bracket ",71,113,23372,23485,video,FALSE
CompanyJ_1179," Duke, Terps, Tar Heels, Spartans  NBA players share why their former squads are ready to dance this March",106,313,50575,50888,video,FALSE
CompanyJ_1180,Lets dance #MarchMadness,24,1313,188774,190087,video,FALSE
CompanyJ_1181,"Out of all the No. 1 seed coaches, who would you trust?",55,698,59529,60227,video,FALSE
CompanyJ_1182,LOST HIM WITH THE EURO #marchmadness,36,806,147546,148352,video,FALSE
CompanyJ_1183,Tremont BROKE his ankles  #MarchMadness ,40,846,152455,153301,video,FALSE
CompanyJ_1184,Kevin Durant's lifelong childhood friend Cliff Dixon was shot and killed while celebrating his birthday in Atlanta this morning  Prayers up for KD and his family ,162,18049,778480,796529,image,FALSE
CompanyJ_1185,Complete chaos at the end of New Mexico State-Auburn ,53,3198,284195,287393,video,FALSE
CompanyJ_1186,Gabe Kalscheur caught fire from behind the arc today  The Minnesota freshman could be the early breakout star of #marchmadness,126,227,66295,66522,video,FALSE
CompanyJ_1187,Ja Morant getting nice with it EARLY,36,274,82353,82627,video,FALSE
CompanyJ_1188,JA MORANT CAUGHT A BODY.,24,3737,343426,347163,video,FALSE
CompanyJ_1189,Ja Morant carries No. 12 Murray State to the 2nd round  17 PTS 16 AST 11 REB,76,3858,489640,493498,image,FALSE
CompanyJ_1190,Ja Morant doing it all ,23,1374,315701,317075,image,FALSE
CompanyJ_1191,Wait for it...,14,606,144866,145472,video,FALSE
CompanyJ_1192,History for the Wofford star  #MarchMadness ,44,1227,203020,204247,image,TRUE
CompanyJ_1193,FLETCHER MAGEE WAS IN THAT ZONE,31,1098,162083,163181,video,FALSE
CompanyJ_1194,They really had Ron Burgundy  in the @lakings booth last night  (via @nhl),74,2295,216114,218409,video,FALSE
CompanyJ_1195,No. 1 recruit. ACC scoring leader. Canadian Kobe.  @rjbarrett is ready for #MarchMadness,88,483,98235,98718,video,TRUE
CompanyJ_1196,This @kingjames tattoo  (via @lukalajoie),41,4007,260573,264580,image,FALSE
CompanyJ_1197,How Duke fans filled out their brackets ,40,5762,276817,282579,video,FALSE
CompanyJ_1198,76 Tacko Fall next to 52 reporter Tracy Wolfson  (via @cbssports),65,6058,475997,482055,image,FALSE
CompanyJ_1199,"Fletcher Magee was an unranked recruit. Yesterday, he broke the D-1 3PT record ",79,524,96244,96768,video,FALSE
CompanyJ_1200,DAngelo Russell faces the Lakers tonight with a chance to officially eliminate them from the playoffs ,102,11787,685807,697594,image,FALSE
CompanyJ_1201,Draymond Green gives perspective on Coach Izzo.,47,682,163127,163809,video,FALSE
CompanyJ_1202,3PT buzzer-beater AND the walkoff ,34,402,119704,120106,video,FALSE
CompanyJ_1203,No. 13 UC Irvine completed the upset and goes wild #Lifesrich,61,772,118645,119417,video,TRUE
CompanyJ_1204,Kenny Wooten was EATING on both ends of the floor  ( @nationalguard),68,503,124623,125126,video,FALSE
CompanyJ_1205,"Lonzo Ball has severed ties with BBB co-founder, Alan Foster, after reports that he has allegedly been unable to account for roughly $1.5M from Ball's business accounts, per @ramonashelburne & pinepaula and @malika_andrews",222,5656,414015,419671,image,FALSE
CompanyJ_1206,Zion made his presence known early ,35,660,154583,155243,video,FALSE
CompanyJ_1207,Zions custom Kyries for his NCAA Tournament debut.  @Brkicks,60,1577,340955,342532,carousel,FALSE
CompanyJ_1208,Zion put on an absolute show against NDSU,41,3222,444802,448024,video,FALSE
CompanyJ_1209,No. 12 Liberty gets their first ever tourny victory on a wild comeback against No. 5 Miss State,95,399,93635,94034,video,FALSE
CompanyJ_1210,Zion & RJ always on the same page #MarchMadness,47,2607,465723,468330,image,TRUE
CompanyJ_1211,Harden dropped 61 PTS on the Spurs and hit 3 straight 3-pointers in crunch time ,80,3013,230658,233671,video,FALSE
CompanyJ_1212,The Beard cant be stopped.,26,2385,221708,224093,image,FALSE
CompanyJ_1213,BRON CHASED DOWN D-LO ,22,2242,209765,212007,video,FALSE
CompanyJ_1214,Tacko Fall showed whats it like to OWN THE PAINT in the 1st round ,66,2657,260789,263446,video,FALSE
CompanyJ_1215,DLo & the Nets eliminate the Lakers from playoff contention!,60,3568,225886,229454,video,FALSE
CompanyJ_1216,LeBron misses the playoffs for the first time since 2005.,57,13977,750789,764766,image,FALSE
CompanyJ_1217,"Last time LeBron missed the playoffs was in 2005  That year  Netflix was delivering DVDs  Apple didnt have an iPhone  YouTube was founded  Aubrey Graham wasnt Drake yet, he was Jimmy Brooks on Degrassi",201,3912,415613,419525,image,FALSE
CompanyJ_1218,No rest for The Beard.,22,2337,317862,320199,image,FALSE
CompanyJ_1219,MARCH = MADNESS  LSU ADVANCES,29,1084,179865,180949,video,FALSE
CompanyJ_1220,"LSU players all looked up at the same time and saw the score was 44, number of their late teammate Wayde Sims, and knew they had to win: Hes always with us",155,502,223536,224038,video,FALSE
CompanyJ_1221,Steph and Ayesha are bae goals  (via @jgtradition),50,4719,279765,284484,video,FALSE
CompanyJ_1222,Russ was feeling it while stretching (via @ryebread.jpg),56,633,101262,101895,video,FALSE
CompanyJ_1223,Travis Scott brought out Future to perform March Madness  in ATL  (via @TheNikkoTan),84,1832,215511,217343,video,FALSE
CompanyJ_1224,ANKLES,6,486,80633,81119,video,FALSE
CompanyJ_1225,"In fourth grade, Kyrie Irving wrote that hed play in the NBA and kept the paper until HS.  Today he turns 27. - ROTY - 6x All-Star - NBA champion - One of the GOAT ball-handlers - One of the most clutch shots ever",213,2323,498353,500676,image,FALSE
CompanyJ_1226,LeBron sees a bright future for DLo,35,1914,451519,453433,image,FALSE
CompanyJ_1227,"Ja told em relax, I got this. ",30,1027,166019,167046,video,FALSE
CompanyJ_1228,You can hear this dunk ,23,659,155470,156129,video,FALSE
CompanyJ_1229,TWO-HANDED WINDMILL OFF THE BREAK,33,581,102250,102831,video,FALSE
CompanyJ_1230,"""Ja Morant has a brilliant career ahead of him."" Murray State star gets emotional after tournament run ends against FSU.  #MarchMadness ",136,2593,396869,399462,video,TRUE
CompanyJ_1231,Michigan went crazy in the locker room  #lifesrich,50,604,98446,99050,video,TRUE
CompanyJ_1232,Luka is FEELING IT. Three stepbacks in the first quarter ,57,806,145672,146478,video,FALSE
CompanyJ_1233,This Baylor defender basically got dunked on twice ,51,609,138600,139209,video,FALSE
CompanyJ_1234,COFFEY BODIED HIM,17,485,110753,111238,video,FALSE
CompanyJ_1235,Trae hit the game-winner and broke out The Silencer. COLD-BLOODED.,66,2098,193353,195451,video,FALSE
CompanyJ_1236,"Dont retire, D-Wade ",20,1479,427214,428693,image,FALSE
CompanyJ_1237,Special moment for Minnesota senior Jordan Murphy who checked in one last time after missing most of the game with a back injury ,129,560,192275,192835,video,FALSE
CompanyJ_1238,Ice Trae ,9,703,222911,223614,image,FALSE
CompanyJ_1239,No in-between for Zion.,23,1689,394058,395747,image,FALSE
CompanyJ_1240,Randy Johnson made a bird pop 18 years ago (via @mlbcut4),57,5834,423763,429597,video,FALSE
CompanyJ_1241,That time a 21-year-old Devin Booker lit the Celtics up for 70 points ,70,1698,177421,179119,video,FALSE
CompanyJ_1242,Faked em out HARD ,18,519,125720,126239,video,FALSE
CompanyJ_1243,Tacko is ready for Zion at the rim ,35,4010,451894,455904,image,FALSE
CompanyJ_1244,"This Lou Will story   In 2011, he convinced a gunman not to rob him in Philly, then took him to McDonalds and talked about life.",128,5372,746548,751920,video,FALSE
CompanyJ_1245,Big saves dont get better than this,35,584,138053,138637,video,FALSE
CompanyJ_1246,That's just cold.,17,1586,231041,232627,video,FALSE
CompanyJ_1247,Minor setback for a major comeback ,35,3458,331442,334900,image,FALSE
CompanyJ_1248,Chris Bosh turns 35 today with an underrated legacy.  2x champ  11x All-Star  Career 19.2 PPG | 8.5 REB  Ahead of his time as stretch big  Helped inspire player movement,169,1777,355157,356934,image,FALSE
CompanyJ_1249,"Jason Kidd will be a serious candidate for the Lakers job if Luke Walton is fired, per @wojespn",95,4420,422751,427171,image,FALSE
CompanyJ_1250,Tacko Fall is an ABSOLUTE UNIT.,31,1718,176743,178461,video,FALSE
CompanyJ_1251,Breaking: Gronk has announced his retirement,44,10576,572293,582869,image,FALSE
CompanyJ_1252,"Thank you for an amazing career, Gronk  3x Champion 4x All Pro (1st) 5x Pro Bowl 92 TDs 602 catches 9,024 yards",111,2041,402531,404572,image,FALSE
CompanyJ_1253,"There's only one Gronk. Enjoy retirement, No. 87.",49,276,66242,66518,video,FALSE
CompanyJ_1254,Best TE ever?,13,2822,247157,249979,image,FALSE
CompanyJ_1255,Zions passing ability ,22,921,147337,148258,video,FALSE
CompanyJ_1256,This photo is ridiculous ,25,3401,682639,686040,image,FALSE
CompanyJ_1257,Zion leads Duke to the Sweet 16!,32,4559,278624,283183,video,FALSE
CompanyJ_1258,RJ COMES UP CLUTCH ,19,1756,158797,160553,video,FALSE
CompanyJ_1259,Absolutely BRUTAL ending for UCF...,35,5925,462976,468901,video,FALSE
CompanyJ_1260,JEREMY LAMB HALF COURT BANK FOR THE WIN,39,2917,285825,288742,video,FALSE
CompanyJ_1261,Zion is built for this ,23,1371,371353,372724,image,FALSE
CompanyJ_1262,Duke fans watching that final play ,35,845,174425,175270,video,FALSE
CompanyJ_1263,Kemba definitely didn't think Jeremy Lamb's game-winner was going in  (via Marnsantana/Twitter),95,2527,388071,390598,video,FALSE
CompanyJ_1264,BODIED.,7,392,104656,105048,video,FALSE
CompanyJ_1265,Texas Tech was feelin' it after the win  #lifesrich,51,494,100932,101426,video,FALSE
CompanyJ_1266,Kenny Wooten hosted another BLOCK PARTY to lead Oregon to the Sweet 16 ,71,1004,173637,174641,video,FALSE
CompanyJ_1267,Pats fans waking up realizing Gronk really retired (h/t @babymasoncarter),73,1949,147792,149741,video,FALSE
CompanyJ_1268,"When LaMelo announced that he was returning to high school and suiting up for SPIRE, the prep world turned its eyes to the school in Ohio. Is it the most hyped season in HS?",173,1485,216934,218419,video,FALSE
CompanyJ_1269,Hero has many definitions  #womenshistorymonth,46,2489,180409,182898,image,FALSE
CompanyJ_1270,D-Wade is going out on his own terms.,37,2283,406023,408306,image,FALSE
CompanyJ_1271,LeBron has Zos back. @brkicks,29,1272,364045,365317,image,FALSE
CompanyJ_1272,Carsen Edwards came into the tournament slumping but torched Villanova for 42 PTS. Then he said he had to get back in the gym ,126,425,91042,91467,video,FALSE
CompanyJ_1273,18 of them to be exact ,23,6081,293531,299612,image,FALSE
CompanyJ_1274,USC football/basketball commit Drake London with the 540  @br_hoops,67,1432,206954,208386,video,FALSE
CompanyJ_1275,James Hardens PPG in three quarters (28.7) would rank second in the scoring race,80,3526,314350,317876,image,FALSE
CompanyJ_1276,Utah fans give Jimmer a standing ovation ,41,1243,96706,97949,video,FALSE
CompanyJ_1277,Fran Belibi brought the house down  (@br_hoops),47,4236,148852,153088,video,FALSE
CompanyJ_1278,The Jazz intentionally fouled so Devin Booker couldnt get 60 PTS ,65,5861,430286,436147,video,FALSE
CompanyJ_1279,Trail Blazers fans show Jusuf Nurkic support as he gets carted off after suffering gruesome left leg injury ,108,951,141532,142483,video,FALSE
CompanyJ_1280,Conor McGregor announces retirement from MMA,44,9665,405841,415506,image,FALSE
CompanyJ_1281,The entire NBAs thoughts were with @bosnianbeast27 last night after his horrific injury. Prayers up to the big man ,115,1212,186425,187637,video,FALSE
CompanyJ_1282,"Chris Bosh will be getting his jersey retired in Miami tonight. As great as he was on court, the two-time champ was just as prolific off court and was one of the NBA's great personalities.",188,1145,242435,243580,video,FALSE
CompanyJ_1283,Four decades since they changed the game ,41,503,154378,154881,carousel,FALSE
CompanyJ_1284,"Miami legend   Tonight, the Heat will retire @chrisbosh's jersey",64,607,92616,93223,video,FALSE
CompanyJ_1285,"Adam Morrison reflects on his CBB legacy, from the ""Dirk Diggler"" hotel alias to the Larry Bird mustache to infamously crying after Gonzaga's 2006 Sweet 16 loss.",161,1567,256564,258131,video,FALSE
CompanyJ_1286,Happy Air Max Day! @brkicks,27,1838,281078,282916,image,FALSE
CompanyJ_1287,The Beard and La Flame continue to cook during their career years . @travisscott x BR x @mitchellandness collab dropping 9pm ET in our story ,141,2644,340988,343632,video,FALSE
CompanyJ_1288,OBJ cleats for next year.  @BRKicks,35,2109,151096,153205,video,FALSE
CompanyJ_1289,Jumping out of a plane while unboxing sneakers is nuts  @brkicks @wbmeech,73,272,54121,54393,video,FALSE
CompanyJ_1290,Forever immortalized ,21,1944,462325,464269,image,FALSE
CompanyJ_1291,The Beard vs. Giannis tonight ,30,3669,203354,207023,image,FALSE
CompanyJ_1292,"I wish I could be there, man to see that number one go into the rafters. Bron shows love and congratulates @chrisbosh ahead of his jersey retirement  (via @NBA)",160,807,208433,209240,video,FALSE
CompanyJ_1293,Gordon Hayward throws down a dunk in the same spot where he suffered his season-ending injury back in 2017 ,107,1141,278841,279982,video,FALSE
CompanyJ_1294,Chris Bosh got out of his seat after this DJJ POSTER ,53,2329,345612,347941,video,FALSE
CompanyJ_1295,"Officially in the rafters. Congrats, Chris Bosh ",48,706,132589,133295,video,FALSE
CompanyJ_1296, Kicking off NBA Remix with a B/R x @travisscott x @mitchellandness redesigned Houston Rockets jersey. Shop NOW  (Link in bio),126,1261,173369,174630,carousel,FALSE
CompanyJ_1297,This CP3 cross. OH NO. ,23,5785,398031,403816,video,FALSE
CompanyJ_1298,One last Chris Bosh signature yell before signing off ,54,5088,691766,696854,video,FALSE
CompanyJ_1299,Capela went RIGHT AT Giannis ,29,800,85041,85841,video,FALSE
CompanyJ_1300,DROP EM LANCE ,14,26166,983174,1009340,video,FALSE
CompanyJ_1301,Lance hit his best dance move of the season and everyone lost it ,65,1781,330431,332212,image,FALSE
CompanyJ_1302,Last night  @chrisbosh,22,413,172333,172746,image,FALSE
CompanyJ_1303,Celebration inspiration  (via @brfootball),42,1560,321369,322929,image,FALSE
CompanyJ_1304,Giannis has his priorities straight.,36,2182,224588,226770,image,FALSE
CompanyJ_1305,Zo covered up his BBB tattoo  (via @rockrollg),46,4164,272894,277058,image,FALSE
CompanyJ_1306,"Kobe was forced to give his rankings, otherwise he had to eat cow tongue on @latelateshow ",90,14923,592394,607317,image,FALSE
CompanyJ_1307,Nico Mannion says he doesnt look like a good player in all honesty. But the Red Mamba is the nations No. 1 point guard prospect for a reason. @br_hoops,151,1774,283796,285570,video,FALSE
CompanyJ_1308,"""NOBODY HAD THEy PHOnES OUT""   J Cole was heated no one was recording his 45 PTS and game-winner  (via @kingofqueenz25)",119,1110,232288,233398,carousel,FALSE
CompanyJ_1309,"Saquon, Dame, Jimmy and more. Go behind the scenes with some of the best athletes in the world. Take It There with @TaylorRooks premieres April 3 ",146,217,30380,30597,video,FALSE
CompanyJ_1310,Dirk inspired D-Wade,20,417,121294,121711,image,FALSE
CompanyJ_1311,MLB players and their Pokemon-inspired haircuts ,48,613,78950,79563,video,FALSE
CompanyJ_1312,Eagles fans are ruthless ,25,9154,367765,376919,image,FALSE
CompanyJ_1313, Ja speaking facts @br_hoops,28,3595,257833,261428,video,FALSE
CompanyJ_1314,Ben is on pace to be in the top 5 in assists for the second time in only 2 seasons. He makes the art of passing highlight worthy.,129,1096,192803,193899,video,FALSE
CompanyJ_1315,Mike Conley has done it all for Memphis.,40,1310,153138,154448,image,FALSE
CompanyJ_1316,"In a crucial late season game against Pacers for playoff seeding, OKC went OFF!",79,1796,314111,315907,video,FALSE
CompanyJ_1317,EFFICIENT  MONEY  SNIPER,24,1165,138658,139823,video,FALSE
CompanyJ_1318,"Wizards bench is JOKES, perform CPR after Greens poster ",56,769,112688,113457,video,FALSE
CompanyJ_1319,Not all heroes wear capes (via @warriors),41,911,138708,139619,video,FALSE
CompanyJ_1320,Book is an automatic bucket ,28,1772,200051,201823,video,FALSE
CompanyJ_1321,29 years ago today: MJ dropped a career-high 69 points ,55,1453,102510,103963,video,FALSE
CompanyJ_1322,"16 years ago today, Kobe went off in his last game against MJ:  55 points  42 in the first half  9-of-13 from 3",111,3963,502912,506875,image,FALSE
CompanyJ_1323,Manu Ginobilis jersey will be retired in San Antonio tonight. Congrats to the Eurostep master.,94,889,134281,135170,video,FALSE
CompanyJ_1324,DBook is youngest in an elite group of players to drop 50 in consecutive games ,79,434,65706,66140,video,FALSE
CompanyJ_1325,Whos ready for more madness?,28,226,60026,60252,video,FALSE
CompanyJ_1326,"What would Grant Hill (@realgranthill) tell his younger self?  27 years after The Shot, he'd give the same advice: ""Throw it to Laettner."" ",139,1390,167935,169325,carousel,FALSE
CompanyJ_1327,Bron imitates a bottle of tequila  (via @KingJames),51,4209,313879,318088,video,FALSE
CompanyJ_1328,Jamal Murray got this to fall ,30,345,75542,75887,video,FALSE
CompanyJ_1329,SHEESH ,7,632,195058,195690,video,FALSE
CompanyJ_1330,Gonzaga is heading to the Elite 8 ,34,493,116133,116626,image,FALSE
CompanyJ_1331,PURDUE HANGS ON #MarchMadness,29,1430,191140,192570,image,FALSE
CompanyJ_1332,The end of regulation of Purdue-Tennessee is what March is all about,68,1212,287984,289196,video,FALSE
CompanyJ_1333,Greek Freak is looking ready to enter playoff mode  ( @metrobytmobile),70,755,123926,124681,video,FALSE
CompanyJ_1334,Carsen Edwards is leaving it all out there for the Boilermakers.,64,835,199031,199866,image,FALSE
CompanyJ_1335,TTU is ready for flight,23,520,144663,145183,video,FALSE
CompanyJ_1336,"Officially in the rafters. Congrats, Manu!",42,1064,209554,210618,video,FALSE
CompanyJ_1337,Better get familiar with Jarrett Culver ,40,543,159496,160039,image,FALSE
CompanyJ_1338,Flop of the tournament?  #MarchMadness,38,4044,283501,287545,video,FALSE
CompanyJ_1339,"Tony Parker, Gregg Popovich and Tim Duncan thank and celebrate Manu Ginobili for jersey retirement ",99,1088,375597,376685,carousel,FALSE
CompanyJ_1340,Ryan Cline went 7-for-10 from beyond the arc to help lead Purdue to the Elite 8,79,1706,245002,246708,video,FALSE
CompanyJ_1341,Pop knows.,10,531,152771,153302,image,FALSE
CompanyJ_1342,No nerves at all for Purdue last night ,39,706,154545,155251,video,FALSE
CompanyJ_1343,She worked on art projects for over a year and finally delivered them to her favorite player.  Giannis was touched. (via Pete Stauffer/YouTube),143,9967,693348,703315,video,FALSE
CompanyJ_1344,Is @kingryang the next boxing superstar?  17-0 14 KOs Model YouTube star Golden Boy promotions Main event Saturday night,120,1015,74003,75018,video,FALSE
CompanyJ_1345,"On this day in 1982, MJ hit a game-winner in the national championship as a freshman  That was the birth of Michael Jordan. Before that, I was Mike Jordan (via @marchmadness)",174,1851,443740,445591,carousel,FALSE
CompanyJ_1346,Coby White the next DLo? @jonnywass says the UNC guard reminds him of the first time All Star,93,562,52381,52943,video,FALSE
CompanyJ_1347,Time flies. (h/t @spurs),24,2297,559695,561992,image,FALSE
CompanyJ_1348,Kenny rocked his jersey for the UNC-Auburn game today. Chuck said his didn't fit   #lifesrich,93,505,196081,196586,video,TRUE
CompanyJ_1349,Shaun Livingston put Bayless on a poster. Steph literally collapsed. ,69,788,211953,212741,video,FALSE
CompanyJ_1350,UNCLE DREW FOR THE WIN,22,1081,119113,120194,video,FALSE
CompanyJ_1351,Barkleys Tigers upset Kennys Tar Heels 97-80 ,45,2364,394959,397323,image,FALSE
CompanyJ_1352,"Coach Pearl is for his players, just wants to hug Okeke talking about the injury",80,974,182044,183018,video,FALSE
CompanyJ_1353,"WATCH YA HEAD, ZION",19,398,95423,95821,video,FALSE
CompanyJ_1354,AIR WILLIAMSON,14,857,151218,152075,video,FALSE
CompanyJ_1355,Duke survives AGAIN... barely #MarchMadness,43,4028,258297,262325,video,FALSE
CompanyJ_1356,The Warriors and Timberwolves might have had the weirdest ending to a regular season game.,90,4207,402180,406387,video,FALSE
CompanyJ_1357,LeBron moves to 28-0 all-time vs Kemba ,39,2803,221079,223882,video,FALSE
CompanyJ_1358,"Zion Williamson put on another show and led Duke to the Elite 8 with 23 PTS, 5 REB and 3 BLK",92,388,71006,71394,video,FALSE
CompanyJ_1359,Welcome to Shaqs Fun House  (via @shaq),39,811,96405,97216,video,FALSE
CompanyJ_1360,Lakers announce LeBron will sit out the rest of the season,58,11082,443924,455006,image,FALSE
CompanyJ_1361,"Watch your step, big man  #MarchMadness",39,1182,188929,190111,video,FALSE
CompanyJ_1362,Davide Moretti tells his team why he plays as his family sits in the back to surprise him  The sophomore hasnt seen them in over a year #LifesRich,146,355,132811,133166,video,FALSE
CompanyJ_1363,D-Lo runs Brooklyn ,19,2527,314253,316780,video,FALSE
CompanyJ_1364,Texas Tech makes history ,25,858,191251,192109,image,FALSE
CompanyJ_1365,The Beard is a cheat code.,26,1846,182575,184421,image,FALSE
CompanyJ_1366,Texas Tech advanced to its first Final Four in program history with a 75-69 win over Gonzaga.,93,1030,285271,286301,video,FALSE
CompanyJ_1367,Jimmy Butler got booed in his first game back in Minneapolis.  Some of the 76ers players joined in as joke. (via @malika_andrews),129,996,220558,221554,video,FALSE
CompanyJ_1368,Texas Tech going wild to Old Town Road in the locker room after reaching the Final Four  (Via @texastechmbb),108,3470,326352,329822,video,FALSE
CompanyJ_1369,"Mudiay asked D-Wade for the jersey after the game. Wade said: ""I'm already giving it away""  You hate to see it",110,4848,487444,492292,video,FALSE
CompanyJ_1370,Wildest ending to regulation this tourney  #MarchMadness ,57,1763,308509,310272,video,FALSE
CompanyJ_1371,What a Tournament from Carsen Edwards ,38,1345,208133,209478,image,FALSE
CompanyJ_1372,Carsen Edwards finished with 42 PTS and went 10/19 from 3PT land.,65,1710,306592,308302,video,FALSE
CompanyJ_1373,This Dodgers fan really got $100 for throwing back his HR ball  (via @15sof),76,3173,358254,361427,video,FALSE
CompanyJ_1374,"Earlier this week, @michaelirvin88 underwent tests for possible throat cancer. Today it came back that hes cancer-free ",119,4054,415785,419839,image,FALSE
CompanyJ_1375,DLo has proved himself ,23,3392,314297,317689,image,FALSE
CompanyJ_1376,TRAE YOUNG COLD-BLOODED   Two go-ahead buckets in the last six seconds,70,2154,236853,239007,video,FALSE
CompanyJ_1377,Brown was dancing on the three-point line ,42,244,125703,125947,video,FALSE
CompanyJ_1378,A first for Auburn ,19,994,187071,188065,image,FALSE
CompanyJ_1379,Okeke (ACL) left hospital to support Auburn in the 2nd half. They outscored Kentucky 47-36 to lock ticket to Final Four in OT.,126,421,138192,138613,video,FALSE
CompanyJ_1380,Zion looked bouncy in warmups,29,1455,196837,198292,video,FALSE
CompanyJ_1381,McQuaid making up moves mid-air ,32,521,127631,128152,video,FALSE
CompanyJ_1382,Sparty knocks Zion and Duke out of the tourney ,47,4642,249797,254439,video,FALSE
CompanyJ_1383,MSU escapes Duke after RJ Barrett's missed FT.  Another wild ending.,68,2838,298335,301173,video,FALSE
CompanyJ_1384,The Final Four is set. Who you got?,35,4107,200440,204547,image,FALSE
CompanyJ_1385,Michigan State to everyone who had Duke winning it all:,55,2003,232449,234452,video,FALSE
CompanyJ_1386,Ice Trae called game ,21,381,83968,84349,video,FALSE
CompanyJ_1387,Unforgettable season for Zion and RJ as they led Duke to ACC championship and Elite 8,85,2910,357053,359963,image,FALSE
CompanyJ_1388,Athletes offer their support and condolences to Nipsey and his family ,70,1190,227164,228354,video,FALSE
CompanyJ_1389,Nipsey was in Anaheim yesterday cheering on Texas Tech in the Elite 8. Prayers to him and his family  (via @jazzamari),118,2896,505644,508540,video,FALSE
CompanyJ_1390,Oracle Arena played Nipsey and the Warriors showed love  (via @loganmmurdock),77,1216,239993,241209,video,FALSE
CompanyJ_1391,Sean Taylor was one of a kind. The famed No. 21 would have been 36 today (via @thecheckdown),92,1832,291075,292907,carousel,FALSE
CompanyJ_1392,Nobody is safe. Nothing is guaranteed  #GameOfZones premieres 4/11 on the B/R App ,82,1339,202276,203615,video,FALSE
CompanyJ_1393,Seeing Kap back on the field  Joined by Saquon and Offset #HunchoDay,68,2887,287617,290504,video,FALSE
CompanyJ_1394,Zion's shoe deal is expected to be at least $100M. @brkicks,59,1570,213228,214798,image,FALSE
CompanyJ_1395,#NAME?,22,969,195635,196604,image,FALSE
CompanyJ_1396,The Pope puts the Messi hype in perspective  (via @brfootball),62,1357,143336,144693,image,FALSE
CompanyJ_1397,Last seasons ROY gives his vote ,32,2282,211695,213977,image,FALSE
CompanyJ_1398,Still one of the best April Fools Day jokes.  They told Shaq we ranked him ninth on the all-time centers list and he almost tore the set up  (Via @nbaontnt),156,2429,433984,436413,video,FALSE
CompanyJ_1399,KentuckyFOR LIFE  John Calipari has agreed to a lifetime deal that ensures he finishes career with the Wildcats,111,1880,295651,297531,image,FALSE
CompanyJ_1400,Kyrie saved it. Tatum dished it. Hayward finished it.,53,4029,770320,774349,video,FALSE
CompanyJ_1401,@kingjames dedicating todays workout to Nipsey  *NSFW*,54,1534,197417,198951,video,FALSE
CompanyJ_1402,Painted @TheRock with a dumbbell and it turned out unbelievable (via @bou_bou_design_),86,3033,263549,266582,video,FALSE
CompanyJ_1403,Kemba went off for 38 points in the second half ,48,1699,285832,287531,video,FALSE
CompanyJ_1404,LeBron will have a full-length court built on the set of 'Space Jam 2 to train while filming.  MJ did the same thing as he prepared for his second three-peat. (via @theathletichq),179,4627,476084,480711,image,FALSE
CompanyJ_1405,"Kawhi, D-Wade and Montrezl honored Nipsey  @brkicks",51,481,128293,128774,carousel,FALSE
CompanyJ_1406,New faces. Same drama. The Champions season 2 is coming soon  (via @brfootball),79,289,31825,32114,image,FALSE
CompanyJ_1407,Zion and RJ are the first freshman teammates to make the AP All-American first team since Boogie and Wall,105,1747,427768,429515,carousel,FALSE
CompanyJ_1408,"Oh really, @shaq? ",18,1329,193710,195039,image,FALSE
CompanyJ_1409,Nuggets Melo >>>,16,1898,281161,283059,image,FALSE
CompanyJ_1410,"Zion, RJ, Ja, Grant and Cassius ",32,2470,275521,277991,image,FALSE
CompanyJ_1411,"Kap, Gucci and other stars showed out at Quavos #HUNCHODay ",59,630,104632,105262,video,FALSE
CompanyJ_1412,Russ holding it down for Nipsey tonight  (via @okcthunder),58,1829,420120,421949,video,FALSE
CompanyJ_1413,Kuz helping Bron put his chain on. Real friends ,48,3038,368111,371149,video,FALSE
CompanyJ_1414,Russ is the 1st player since Wilt with a 20/20/20 game ,55,2989,481400,484389,video,FALSE
CompanyJ_1415,The Marathon Continues ,23,2057,258433,260490,image,FALSE
CompanyJ_1416,Bryce Harper with the nasty bat flip in his return to Washington  (Via @mlb),76,1399,177754,179153,video,FALSE
CompanyJ_1417,Yall better ride for me - Nipsey,32,791,208120,208911,image,FALSE
CompanyJ_1418,"Diva? Bully? Toxic? Philadelphia 76ers star @JimmyButler sets the record straight on his past behavior and opens up on why he almost quit playing basketball in college while playing a game of spades on the premiere of ""Take It There with @TaylorRooks."" ",253,591,127688,128279,video,FALSE
CompanyJ_1419,I suck?  (via alex_burness/TW),30,5801,639298,645099,video,FALSE
CompanyJ_1420,"Projected No. 2 pick @igotgame12_ will declare for the 2019 NBA draft today, per @shamsnba",90,1531,294988,296519,image,FALSE
CompanyJ_1421,Cole Anthony and Vernon Carey Jr. are taking over NYC as the top-ranked H.S. basketball teams play for a National Title. @br_hoops,130,277,68643,68920,video,FALSE
CompanyJ_1422,Time for a  fam reunion? Isaiah Washington and Jahvon Quinerly have both entered the CBB transfer portal. @br_hoops,115,1473,183859,185332,image,FALSE
CompanyJ_1423,First 20/20/20 since Wilt.  Russ did it real big last night in honor of Nipsey Hussle ,86,546,109401,109947,video,FALSE
CompanyJ_1424,"Steph Curry broke out of a recent sub-37% 3PT shooting slump by putting on contact lenses to fix eye issues hes had his whole career, per @thompsonscribe",153,5457,395229,400686,image,FALSE
CompanyJ_1425,Being far from home for the first time almost made @JimmyButler quit basketball forever at Marquette,100,256,51077,51333,video,FALSE
CompanyJ_1426,Russ goes 20-20-20 for Nipsey  #RIP,35,2683,347162,349845,video,FALSE
CompanyJ_1427,Trae Young hooping in the Ice Trae Adidas N3XT L3V3L  @brkicks,62,3992,441725,445717,carousel,FALSE
CompanyJ_1428,Kawhi was fed up,16,3321,305690,309011,video,FALSE
CompanyJ_1429,Beal has a new pregame routine after last night  (via @washwizards),67,895,212083,212978,video,FALSE
CompanyJ_1430,Reggie Jacksons step-back was filthy,36,2115,159147,161262,video,FALSE
CompanyJ_1431,Pop was ejected a minute into the game...,41,2044,198577,200621,video,FALSE
CompanyJ_1432,Kemba Walker went off for 21 of his 32 PTS in the 4Q to beat the the New Orleans Pelicans and kept the Charlotte Hornets' playoff hopes alive.,142,1033,263843,264876,video,FALSE
CompanyJ_1433,Wade and Kyrie have some of the best footwork of all-time,57,839,194245,195084,video,FALSE
CompanyJ_1434,Trae making his case for ROY,28,4588,325043,329631,image,FALSE
CompanyJ_1435,Aaron Rodgers hated Mike McCarthy from the moment he got hired.  And it only got worse from there.,98,2426,215866,218292,image,FALSE
CompanyJ_1436,"From Boogie stare downs to Giannis sky alleys, these guys took flight this season",81,609,185460,186069,video,FALSE
CompanyJ_1437,Greg Oden is finding redemption as an OSU student-coach after an injury-ridden career made him an NBA draft bust,112,1098,141885,142983,video,FALSE
CompanyJ_1438,Bench celebrations have taken over the NBA this year,52,843,145981,146824,video,FALSE
CompanyJ_1439,Embiid and Bledsoe are bringing the playoff intensity ,54,2936,231965,234901,video,FALSE
CompanyJ_1440,Greek Freak showed up and dominated. 45 PTS | 13 REB | 6 AST | 5 BLK,68,2228,356560,358788,video,FALSE
CompanyJ_1441,Steph can see clearly NOW,25,2233,252642,254875,video,FALSE
CompanyJ_1442,Greek Freak blocked Joel Embiid FOUR times tonight,50,6950,423293,430243,video,FALSE
CompanyJ_1443,Caruso got BOUNCE,17,2278,159378,161656,video,FALSE
CompanyJ_1444,Will Giannis finish the season with an MVP like Kareem did? ,60,2272,297131,299403,image,FALSE
CompanyJ_1445,Just two of the NBAs best players chatting ,43,4293,407590,411883,image,FALSE
CompanyJ_1446,"Last year, Donte DiVincenzo boosted his draft stock with a historic 31 points in the national championship.  Who will be this years hero?",137,313,62061,62374,video,FALSE
CompanyJ_1447,Jimmys face. D-Wades prayer. Harden to beat GSW.  Best buzzer-beaters from this season,86,1081,249987,251068,video,FALSE
CompanyJ_1448,#NAME?,99,380,63633,64013,carousel,FALSE
CompanyJ_1449,"Bulls guard Walt Lemon Jr. wears No. 25 because he grew up in Chicago idolizing D-Rose: ""I want to be just like that guy""  You can see the influence on his game.",161,4148,409124,413272,video,FALSE
CompanyJ_1450,The detail on this Kobe tattoo  (via @stevebutchertattoos),58,2835,367399,370234,image,FALSE
CompanyJ_1451,Kobe keeping it real ,21,4299,376313,380612,image,FALSE
CompanyJ_1452,Giannis is unstoppable ,23,6126,458570,464696,image,FALSE
CompanyJ_1453,Russ averages a triple-double for the 3rd straight season. Never done before in NBA history. #WhyNot,100,3794,429197,432991,image,TRUE
CompanyJ_1454,Air Dirk in year 21 ,20,978,161517,162495,video,FALSE
CompanyJ_1455,"Dame is rocking Game of Zones-inspired 5s tonight called ""Dame of Zones"" vs. the Nuggets ",89,439,116757,117196,carousel,FALSE
CompanyJ_1456,JEREMY LAMB BEATS THE RAPTORS AGAIN,35,5277,483425,488702,video,FALSE
CompanyJ_1457,"Goodness, Russ ",15,5981,549553,555534,video,FALSE
CompanyJ_1458,Jake Bauers rode up to his at bat bumping that @lilnasx  (via @mlbcut4),71,1110,140869,141979,video,FALSE
CompanyJ_1459,D-Wade or Pierce?,17,14503,382249,396752,image,FALSE
CompanyJ_1460,DLo left a photo shoot to do this ,34,7962,807024,814986,video,FALSE
CompanyJ_1461,@russwest44 is writing history this season  First player ever to average 3 straight seasons with a triple-double  First 20/20/20 game since Wilt  Held longest-ever streak with a triple-double (11 games)  Why not?,212,2510,315423,317933,image,FALSE
CompanyJ_1462,"At its first Final Four in 35 years, Virginia is ready to rewrite its March Madness legacy",90,274,64592,64866,video,FALSE
CompanyJ_1463,Imagine going one-on-one against...an elephant  (via @rene_casselly),68,4279,296828,301107,video,FALSE
CompanyJ_1464,The Final Four is here!,23,281,53461,53742,video,FALSE
CompanyJ_1465,Zaire not tolerating any disrespect to his dads legacy.,55,10213,644350,654563,image,FALSE
CompanyJ_1466,GET THAT OUTTA HERE ,20,198,40576,40774,video,FALSE
CompanyJ_1467,Virginia is headed to the National Championship!,48,3437,223259,226696,image,FALSE
CompanyJ_1468,Did the ref miss a double-dribble call at the end of Virginia-Auburn? ,70,8632,343175,351807,video,FALSE
CompanyJ_1469,Paul Pierce looking at the TL debate between he and D-Wade..,60,3834,181192,185026,video,FALSE
CompanyJ_1470,March Madness comes at you fast...,34,4042,524604,528646,image,FALSE
CompanyJ_1471,OH MY.,6,477,146061,146538,video,FALSE
CompanyJ_1472,Texas Tech is headed to the National Championship!,50,1289,301721,303010,image,FALSE
CompanyJ_1473,CULVER. DAGGER.,15,570,113187,113757,video,FALSE
CompanyJ_1474,The National Championship is Set ,33,1921,247950,249871,image,FALSE
CompanyJ_1475,Texas Tech got hot and Pat Mahomes was hype ,44,296,109853,110149,video,FALSE
CompanyJ_1476,Sabrina has unfinished business ,32,2865,196801,199666,image,FALSE
CompanyJ_1477,Zion wins Naismith Player of the Year. KD and AD were the only other freshman to do it.,87,2145,496989,499134,image,FALSE
CompanyJ_1478,Ronda Rouseys been making history all her life   UFC barrier-breaker. All-time dominant athlete. First woman to headline WrestleMania.,134,393,28294,28687,video,FALSE
CompanyJ_1479,Legendary company. @brkicks,27,3090,420949,424039,image,FALSE
CompanyJ_1480,Kevin Love checked in wearing Channing Frye's college jersey  (via @nba),72,785,234159,234944,video,FALSE
CompanyJ_1481,AB and JuJu at odds ,20,6679,290043,296722,image,FALSE
CompanyJ_1482,Ryan Shazier continues to amaze  (via @shazier),47,952,111816,112768,video,FALSE
CompanyJ_1483,RJ not feeling what the Warriors did in 2016.,45,14643,512174,526817,image,FALSE
CompanyJ_1484,The Nets clinch their first playoff appearance since 2014-2015.,63,3887,493801,497688,image,FALSE
CompanyJ_1485,We Believe Warriors jerseys for the last regular season game at Oracle Arena ,77,1691,212406,214097,video,FALSE
CompanyJ_1486,From rookie season  last regular season game at Oracle Arena. We Believe forever.,81,1751,412542,414293,image,FALSE
CompanyJ_1487,Kofi Kingston FINALLY wins the belt! #wrestlemania,50,2416,259759,262175,image,FALSE
CompanyJ_1488,"Stephen Curry finished with 27 PTS, 6 REB and 4 AST in the Warriors' last regular season game at Oracle Arena",109,1411,366727,368138,video,FALSE
CompanyJ_1489,What a week ,12,3216,287420,290636,image,FALSE
CompanyJ_1490,Hezonja denies Bron and the Lakers at MSG. D-Rose humbles Luka. Okogie clamps Hardens step-back.  Best blocks from this season,126,548,105247,105795,video,FALSE
CompanyJ_1491,Antonio Brown just put up a 2015 DM from JuJu asking for advice while at USC,76,11754,330912,342666,image,FALSE
CompanyJ_1492,"On this day in 2003, a high school phenom shook hands with his idol after Cavs/Wizards.  He later described meeting him as like Black Jesus walking towards me.",159,1876,397151,399027,image,FALSE
CompanyJ_1493,Rakitics rocket. Ronaldos volley. Messis free-kick. The Champions League has had some unreal goals so far  (via @brfootball),124,277,40273,40550,video,FALSE
CompanyJ_1494,"Seven years ago today, Melo hit two of the most cold-blooded shots of his career (via @nbahistory)",98,9722,559467,569189,video,FALSE
CompanyJ_1495,Kyle Korver says we must strive for better ,43,3622,366600,370222,image,FALSE
CompanyJ_1496,What a tourney its been so far ,31,267,63109,63376,video,FALSE
CompanyJ_1497,Salute ,7,3104,528939,532043,image,FALSE
CompanyJ_1498,"D-Roses agent says hed be open to returning to the Bulls this summer: Theres no doubt that in his heart, Chicago will always be there (via @670thescore)",152,3472,458913,462385,image,FALSE
CompanyJ_1499,Virginia wins its first title in mens program history ,54,4202,370494,374696,image,FALSE
CompanyJ_1500,CELEBRATION TIME FOR UVA ,25,637,94646,95283,video,FALSE
CompanyJ_1501,Kyle Guy wins Most Outstanding Player of the Final Four,55,2711,332422,335133,image,FALSE
CompanyJ_1502,What a difference a year makes...,33,1162,297783,298945,image,FALSE
CompanyJ_1503,Its that time  One Shining Moment to close out #MarchMadness,60,635,152116,152751,carousel,FALSE
CompanyJ_1504,Virginia DENIED Texas Techs hopes for a title in OT ,52,399,80541,80940,video,FALSE
CompanyJ_1505,D-Wades last regular-season game in Miami tonight. #OneLastDance,64,4776,567264,572040,image,FALSE
CompanyJ_1506,Eight teams left. The Champions League is BACK  Follow @brfootball for the best from the quarterfinals & more,109,609,78405,79014,image,FALSE
CompanyJ_1507,Giannis doesnt need the bright lights.,38,6859,461454,468313,image,FALSE
CompanyJ_1508,D-Wade to Bron off glass. Trae turning defenders around.  Russ getting fancy on the break.  Best assists of the year.,117,352,78557,78909,video,FALSE
CompanyJ_1509,You can grab a limited edition @dwyanewade jersey or bomber and more NOW. link in bio. . @josh.sobel,100,712,116685,117397,carousel,FALSE
CompanyJ_1510,WHAT A WINNER FROM SON  (via @brfootball),41,626,54950,55576,video,FALSE
CompanyJ_1511,D-Wade arrives in an all-red suit for his last regular season game in Miami  (Via @nba),87,1051,166682,167733,video,FALSE
CompanyJ_1512,One Last Dance.  @Brkicks,25,1007,301524,302531,carousel,FALSE
CompanyJ_1513,Steph is one of a kind.,23,1853,318729,320582,image,FALSE
CompanyJ_1514,"We took over the student section for Texas Tech, but @Master_Tesfatsion's energy wasn't enough for the Red Raiders to topple Virginia",133,262,113062,113324,video,FALSE
CompanyJ_1515,Congrats on retirement @dwyanewade #OneLastDance,48,3198,811056,814254,image,FALSE
CompanyJ_1516,"What a moment. Zaire Wade recreates D-Wades famous From Robbins, Illinois commercial ",85,979,194882,195861,video,FALSE
CompanyJ_1517,Whos cutting onions? ,21,1455,289868,291323,image,FALSE
CompanyJ_1518,Dirk is EATING. He scored the first 10 points for the Mavs ,59,605,140613,141218,video,FALSE
CompanyJ_1519,Breaking: Magic Johnson has stepped down from President of Basketball Ops of the Lakers,87,16426,557600,574026,image,FALSE
CompanyJ_1520,Im the president now.,21,7747,613805,621552,image,FALSE
CompanyJ_1521,The Magic Era is over.,22,4397,356241,360638,image,FALSE
CompanyJ_1522,"Most disappointing Lakers season ever? - Magic quit - AD trade fiasco - LeBron got hurt - Lonzo got hurt - Missed playoffs - Clippers made playoffs - D-Lo, Randle, Brook balling - Two more wins than last year",208,8254,516354,524608,image,FALSE
CompanyJ_1523,Magic walking into Staples Center...,36,743,91121,91864,video,FALSE
CompanyJ_1524,"Heat fans really started a ""Paul Pierce sucks"" chant in Dwyane Wade's last home game",84,5246,526474,531720,video,FALSE
CompanyJ_1525,Oh no. D-Wade tripped trying to jump on the scorers table after the game ,73,4876,608681,613557,video,FALSE
CompanyJ_1526,D-Wade dropped 30 in his last regular season game in Miami. Legend.,67,2493,443085,445578,video,FALSE
CompanyJ_1527,Dirk with his first 30 point performance since 2016.  Legend.,61,1056,322204,323260,image,FALSE
CompanyJ_1528,Dirk announces he is officially retiring ,41,5189,659132,664321,image,FALSE
CompanyJ_1529,What a career for Dirk Nowitzki,31,2074,380034,382108,video,FALSE
CompanyJ_1530,Crawford almost stole the show in Dirks final home game,55,1724,384510,386234,image,FALSE
CompanyJ_1531,PG FOR THE WIN.,15,2972,267857,270829,video,FALSE
CompanyJ_1532,Dirk and D-Wade put on one last show for their home crowds,58,2716,550990,553706,image,FALSE
CompanyJ_1533,Harden became the 5th player in NBA history to average 35+ PPG in a season last night,85,2692,351813,354505,image,FALSE
CompanyJ_1534,"Last night  Magic steps down as Lakers president  D-Wade drops 30 in final home game  Dirk announces retirement, also drops 30  Jamal Crawford becomes oldest player to drop 50 points  Paul George game-winner  Lakers lose at the buzzer",234,1855,431562,433417,image,FALSE
CompanyJ_1535,Its fresh faces vs. past champions at this years Masters ,57,67,13357,13424,video,FALSE
CompanyJ_1536,Blazers superstar @damianlillard explains that he can live with no rings as long as he remains true to himself on the latest episode of Take It There with Taylor Rooks. The best rapper in the NBA also explains what makes a rapper corny and drops some new bars ,260,550,112451,113001,video,FALSE
CompanyJ_1537,One of the best parts of #OneLastDance? All the jersey swaps ,61,333,130372,130705,video,FALSE
CompanyJ_1538,The stats speak for themselves.  Dirk goes out as one of the best ever,70,1040,102377,103417,video,FALSE
CompanyJ_1539,JRs secret stuff   Space Jam 2 trailer gets the NBA2K remix (via @shady00018_),78,1306,144999,146305,video,FALSE
CompanyJ_1540,D-Wade knew ,12,315,97334,97649,video,FALSE
CompanyJ_1541,Ronaldo FLYING HEADER to give Juventus the lead  (via @brfootball),66,837,74069,74906,video,FALSE
CompanyJ_1542,Messi with a bloody nose and eye after a collision with Smalling (via @brfootball),82,1292,97549,98841,video,FALSE
CompanyJ_1543,3 #OneLastDance,15,669,323020,323689,image,FALSE
CompanyJ_1544,The Las Vegas Aces have selected Jackie Young with the No. 1 pick in the #WNBADraft  2018-2019:  14.3 PTS | 7.0 REB | 5.2 AST,125,2971,166878,169849,image,FALSE
CompanyJ_1545,Farewell Swish ,15,698,226551,227249,image,FALSE
CompanyJ_1546,The Banana Boat crew pulled up to support D-Wade in his last game  (via @nbatv),79,677,172360,173037,video,FALSE
CompanyJ_1547,D-Wade fans gotta be exhausted ,31,644,151034,151678,video,FALSE
CompanyJ_1548,No. 4 pick @katielou33s favorite player is Larry Bird. Bird surprised her with a special message right after she got drafted  (via @WNBA),137,455,61312,61767,video,FALSE
CompanyJ_1549,D-WADE WITH THE TRIPLE-DOUBLE IN HIS LAST GAME. The banana boat crew loves it ,78,3187,615242,618429,video,FALSE
CompanyJ_1550,"Fans are chanting ""Paul Pierce sucks"" during D-Wade's final game...this time in Brooklyn ",89,1769,185719,187488,video,FALSE
CompanyJ_1551,Bron had to video-bomb Wade one last time ,42,2953,554117,557070,video,FALSE
CompanyJ_1552,"Another historic season for Russ   Westbrook notched his 138th triple-double to end the regular season, tying Magic Johnson for second all-time",143,1683,334894,336577,image,FALSE
CompanyJ_1553,Cheers to 16 years  #OneLastDance,33,2171,629324,631495,image,FALSE
CompanyJ_1554,Your NBA stat leaders ,22,1544,220301,221845,image,FALSE
CompanyJ_1555,Luka becomes the 5th rookie ever to join the 20-5-5 club,56,2537,451171,453708,image,FALSE
CompanyJ_1556,Giannis keeps on building his MVP resume,40,3756,437434,441190,image,FALSE
CompanyJ_1557,This season   Jimmy vs. Wolves  Luka/Trae  KD/Dray fight  Rondo punched CP  D-Rose comeback  AD saga  KP trade  D-Lo breakout  BBB chaos  Bron/Kyrie made up  Russ triple-double  Harden highest PPG since MJ  Magic quit  Dirk/Wade retired  MVP race,246,2369,446836,449205,carousel,FALSE
CompanyJ_1558,These kids were so excited to be next to Ronaldo  (via @brfootball),67,2165,243609,245774,video,FALSE
CompanyJ_1559,"From Boogies tossed shoe to Pops ejection in 63 seconds, techs were truly wild this year ",89,514,121700,122214,video,FALSE
CompanyJ_1560,"GAME OF ZONES SEASON 6 PREMIERE  Watch exclusively in the B/R App. The Jimmy Butler, T-Wolves practice footage is finally revealed ",131,373,43692,44065,video,FALSE
CompanyJ_1561,Wade bringing in his retirement with his brother Melo ,54,3485,374193,377678,video,FALSE
CompanyJ_1562,The NBA might have a new block king and his name is Jarrett Allen ,66,1918,155297,157215,video,FALSE
CompanyJ_1563,Giannis is the basketball dream ,32,9672,898599,908271,carousel,FALSE
CompanyJ_1564,GAME OF ZONES SEASON 6 PREMIERE! Jimmy Butler turned the T-Wolves practice into a bloodbath #GameOfZones  (@StateFarm),118,1331,184726,186057,video,FALSE
CompanyJ_1565,"The inaugural class of students at LeBrons @ipromiseschool have posted extraordinary results so far  90 percent met or exceeded growth goals in reading and math, per @nytimes",174,2625,343602,346227,image,FALSE
CompanyJ_1566,"Six years ago today, Kobe tore his Achilles, then limped to the line and knocked down two free throws.  Mamba was different",123,7003,686798,693801,image,FALSE
CompanyJ_1567,"Kyrie, CP3, DeAndre and others around the league are shifting toward plant-based diets.  Its working ",101,2381,175837,178218,video,FALSE
CompanyJ_1568,Whole series of Russ vs. Dame should be fun ,44,10454,519264,529718,video,FALSE
CompanyJ_1569,"BREAKING: Lakers, Luke Walton mutually agree to part ways, per @shamsnba",72,5621,399450,405071,image,FALSE
CompanyJ_1570,"Ty Lue is a strong frontrunner for the Lakers job, per @wojespn",63,6290,431647,437937,image,FALSE
CompanyJ_1571,Chicago native @jabariparker and @shothechi star Jacob Latimore surprise deserving students with some heat on a new episode of Sneaker Shock . Their reactions were perfect (via @brkicks),186,85,21369,21454,video,FALSE
CompanyJ_1572,Anything is possible in LA  B/R x @beatsbydre,45,462,54520,54982,video,FALSE
CompanyJ_1573,The Ball brothers are feeling Billie Ray Cyrus on Lil Nas X Old Town Road,73,6663,337419,344082,video,FALSE
CompanyJ_1574,Zion Williamson and Sabrina Ionescu win the Wooden Award for most outstanding player in college hoops ,102,1797,382527,384324,image,FALSE
CompanyJ_1575, NBA PLAYOFFS ARE HERE ,23,4150,238216,242366,video,FALSE
CompanyJ_1576,The Endgame in the East begins today...,39,4026,472897,476923,image,FALSE
CompanyJ_1577,Three years ago today: Warriors 73rd win (most all-time) and Kobes epic 60-point finale. One of the wildest basketball days ever.,129,1984,360547,362531,image,FALSE
CompanyJ_1578,D-Lo and Nets have come a long way,34,1402,242908,244310,video,FALSE
CompanyJ_1579,Alvin Kamara is a machine (via @doctor_reef),44,3658,313226,316884,video,FALSE
CompanyJ_1580,KD believes it was all worth it ,32,7801,399299,407100,image,FALSE
CompanyJ_1581,"Luke Walton agrees to terms with Kings to become next head coach, per @sramick",78,4102,351965,356067,image,FALSE
CompanyJ_1582,D-Lo and the Nets steal Game 1 in Philly,40,5642,633616,639258,image,FALSE
CompanyJ_1583,Amir Johnson and Embiid pulled out a phone on the bench during the game,71,2357,156652,159009,video,FALSE
CompanyJ_1584,Sixers fans let Ben Simmons hear the boos at the free throw line.  He finished with just 9 PTS.,95,5554,318789,324343,video,FALSE
CompanyJ_1585,"Embiid says Amir Johnson was using his phone during the game to check on his daughter who is ""extremely sick.",109,4339,478214,482553,carousel,FALSE
CompanyJ_1586,Will anyone knock the Warriors off the Western throne?,54,3009,320703,323712,image,FALSE
CompanyJ_1587,Simmons has a message for Sixers fans,37,8736,401034,409770,image,FALSE
CompanyJ_1588,D.J. AUGUSTIN CALLED GAME  MAGIC LEAD RAPTORS 1-0,49,4123,294504,298627,video,FALSE
CompanyJ_1589,Lowry finished with 0 points on 0-7 shooting in 33 minutes ,59,5179,393914,399093,image,FALSE
CompanyJ_1590,Steph just passed Ray Allen for most made threes in playoff history with 386  A lot of splashes for Curry ,106,1901,325467,327368,image,FALSE
CompanyJ_1591,Steph was unguardable against the Clippers   38 PTS | 15 REB | 7 AST,68,1518,153948,155466,video,FALSE
CompanyJ_1592,Playoff intensity ,18,3250,476980,480230,image,FALSE
CompanyJ_1593,CAUGHT A BODY.,14,1125,140741,141866,video,FALSE
CompanyJ_1594,More history for Pop ,21,1457,357488,358945,image,FALSE
CompanyJ_1595,"Who ends up on the Iron Throne?   DeAndre Hopkins, Von Miller and other NFL stars predict the ending of #gameofthrones",118,413,52562,52975,video,FALSE
CompanyJ_1596,"Dame is ready for the Thunder: When Russ see me, and when I see him, its two dogs fighting, per @theathletichq",110,2500,379829,382329,image,FALSE
CompanyJ_1597,"In Boston, this is the moment where legacies are built  B/R x @beatsbydre",73,168,29306,29474,video,FALSE
CompanyJ_1598,Kyrie has the smoothest handles in the league,45,1488,221929,223417,video,FALSE
CompanyJ_1599,"Tiger wins the 2019 Masters, the 15th major championship of his career! ",72,7013,825288,832301,image,FALSE
CompanyJ_1600,Unreal.,7,1338,351327,352665,image,FALSE
CompanyJ_1601,"One of the greatest comebacks in sports history.  2008: Wins US Open on torn ACL 2010: Neck injury 2011: Sprained MCL, Achilles 2012: Achilles injury 2014: Back surgery 2015: Back surgery 2017: Back surgery 2019: Wins Masters (first major since 2008)",250,3880,664853,668733,carousel,FALSE
CompanyJ_1602,1997: First Masters  2019: Fifth Masters,40,946,327347,328293,image,FALSE
CompanyJ_1603,Bronny took over in the CLUTCH . @br_hoops @madehoops #TheWarmup,64,916,148782,149698,video,FALSE
CompanyJ_1604,"Baker Mayfield turns 24 today with an unbelievable story  No. 43-ranked HS QB  Offered by FAU, New Mex, Rice  Walk-on at Texas Tech  Took the starting job  Walk-on at Oklahoma Heisman winner  Drafted No. 1 by Browns  Rising NFL star",232,1024,289539,290563,image,FALSE
CompanyJ_1605,"When you play the Dame of Thrones, you win or you lose. There is no middle ground. Blazers take Game 1 against OKC.",115,1627,194976,196603,image,FALSE
CompanyJ_1606,This is the Blazers first playoff win since 2016.,49,1598,346253,347851,image,FALSE
CompanyJ_1607,Giannis is too much for the Pistons,35,1403,202075,203478,video,FALSE
CompanyJ_1608,"Tiger made a fan a MILLY  (via @br_betting)  Someone placed an $85k bet on Tiger to win the Masters and it paid out $1.19M, per @darrenrovell",141,3289,660501,663790,image,FALSE
CompanyJ_1609,Is this finally Houstons year?   B/R x @beatsbydre,50,1229,51637,52866,video,FALSE
CompanyJ_1610,Giannis out here taking off from near the free throw line ,58,2362,237540,239902,video,FALSE
CompanyJ_1611,Bron enjoying his early time off  (via @mrs_savannahrj),55,2269,142150,144419,video,FALSE
CompanyJ_1612,"Anthony Borges' dream was playing for Barcelona. But after the Parkland shooting, he didn't know if he would ever walk again.  This is how he made it to Camp Nou  (via @brfootball)",180,1494,208962,210456,video,FALSE
CompanyJ_1613,"72 years ago today, Jackie Robinson breaks the MLB color barrier when he steps on Ebbets Fields for the Brooklyn Dodgers ",121,970,230695,231665,image,FALSE
CompanyJ_1614,Rondo ,6,3649,459778,463427,image,FALSE
CompanyJ_1615,Spencer the Golden Retriever has been supporting Boston Marathon runners for years ,83,529,53566,54095,video,FALSE
CompanyJ_1616,Im f--king unstoppable  Giannis was letting everyone know,57,2766,276699,279465,video,FALSE
CompanyJ_1617,"LeBron during the playoffs #ZeroDadThirty (via @houseofhighlights, @dakidgowie)",79,4065,345213,349278,carousel,FALSE
CompanyJ_1618,The Champions Season 2 is coming 4/29  (@brfootball),52,196,40532,40728,video,FALSE
CompanyJ_1619,Painted @kingjames while dribbling  (via @bou_bou_design_),58,1744,186543,188287,video,FALSE
CompanyJ_1620,Zion Williamson has declared for the 2019 NBA draft.,52,5857,617784,623641,image,FALSE
CompanyJ_1621,KD & Pat Bev before tip-off..,29,1046,111151,112197,video,FALSE
CompanyJ_1622,There was a bridge?! @CP3 can make a bounce pass from anywhere ,63,194,37440,37634,video,FALSE
CompanyJ_1623,"Nine years ago today, KD became the youngest scoring champion ever at 21 years old (30.1 PPG)  Easy money.",106,3418,389759,393177,carousel,FALSE
CompanyJ_1624,AI and Mutombo know Boban is a cheat code ,42,665,169705,170370,video,FALSE
CompanyJ_1625,Allen took a NASTY elbow to the face from Embiid.,49,3794,194640,198434,video,FALSE
CompanyJ_1626,Ben Simmons triple-double helps the 76ers tie the series ,57,1901,246434,248335,image,FALSE
CompanyJ_1627,MMA future for @joelembiid?,27,909,108049,108958,video,FALSE
CompanyJ_1628,Boogie suffered a quad injury in tonights game vs. Clippers and will get an MRI tomorrow. Hope the big fella is okay ,117,4258,276494,280752,image,FALSE
CompanyJ_1629,Im a bad boy. Im a bad boy! -Steph is feelin it ,48,3256,226560,229816,video,FALSE
CompanyJ_1630,Familiar lead for the Warriors ,31,6346,548001,554347,image,FALSE
CompanyJ_1631,SHAMET. BIG TIME.,17,2053,244658,246711,video,FALSE
CompanyJ_1632,We really blew a 31-point lead...,33,3808,330623,334431,image,FALSE
CompanyJ_1633,"Russ got PAID  Seahawks QB becomes NFLs highest paid player with four-year, $140M extension + $65M signing bonus, per @adamschefter",131,1735,198614,200349,image,FALSE
CompanyJ_1634,Cold-blooded shot ends a Long Night for the Dubs ,49,798,123850,124648,video,FALSE
CompanyJ_1635,@cristiano loves the Champions League quarterfinals  (via @brfootball).  Most goals (24).  Scored in each of his last 6 appearances.  Has qualified for the semifinals every time (11/11).,186,622,121817,122439,image,FALSE
CompanyJ_1636,Pat Bev wont let up ,20,6163,480198,486361,image,FALSE
CompanyJ_1637,Nutmeg  goal. Messi is ridiculous  (via @brfootball),52,963,90300,91263,video,FALSE
CompanyJ_1638,"This squad made the biggest playoff comeback ever  - Gallo: Career was in doubt - Shamet: Tobias trade piece - Green: Undrafted, overseas - Lou Will: Traded 2x in two years - Trezl: G-League 5x, trade throw-in - Pat Bev: Grinded overseas before NBA chance  LACs got heart.",272,3070,431146,434216,image,FALSE
CompanyJ_1639,"Happy birthday to a legend, @kareemabduljabbar_33. All-time points leader (38,387) Record 6x MVP Record 19x All-Star 6x NBA Champion 2x Finals MVP",146,1013,219378,220391,image,FALSE
CompanyJ_1640,It takes more than one. (via @brfootball),41,5283,460596,465879,image,FALSE
CompanyJ_1641,ter Stegen with an INCREDIBLE save  (via @brfootball),53,252,36346,36598,video,FALSE
CompanyJ_1642,"After Game 1, Blazers and McCollum dont have to prove anything to Jennifer ",75,197,60450,60647,video,FALSE
CompanyJ_1643,@dwyanewade gives one final thank you to #WadeCounty,52,415,105000,105415,video,TRUE
CompanyJ_1644,Bron let his teammates know the King had arrived  (Via @houseofhighlights),74,3655,512640,516295,image,FALSE
CompanyJ_1645,CJ dances by Paul George ,25,599,101571,102170,video,FALSE
CompanyJ_1646,"PUT THE TEAM ON YOUR BACK, JAMAL.  21 in the fourth for Murray, Nuggets even the series",87,1679,248461,250140,video,FALSE
CompanyJ_1647,Things are getting physical between Dame and Russ ,50,3491,218873,222364,video,FALSE
CompanyJ_1648,Dame was in a ZONE tonight ,27,1415,185564,186979,video,FALSE
CompanyJ_1649,Leonard and Lowry combine for 59 points to tie up series against the Magic,74,783,231326,232109,video,FALSE
CompanyJ_1650,Ajaxs passing is mesmerizing  (via @brfootball),47,919,74935,75854,video,FALSE
CompanyJ_1651,Retirement @dwyanewade chugging wine on the golf course ,56,3002,316552,319554,video,FALSE
CompanyJ_1652,Don't sleep on Toronto   B/R x @beatsbydre,42,294,34235,34529,video,FALSE
CompanyJ_1653,"Giants superstar RB Saquon Barkley is usually humble, but even he had to agree he could be the best running back to ever play. Barkley discusses that, the Eli situation in NY and how he was almost named Tupac after the legendary L.A. rapper on a new Take It There with Taylor Rooks.",282,924,131837,132761,video,FALSE
CompanyJ_1654,Magic had no answer for Kawhi Jamal Murray was money down the stretch Dame Time has been 24/7  Catch up on last nights action #ControlTheGame,141,197,61070,61267,video,FALSE
CompanyJ_1655,Best NBA Dance Cam Moments 2019,31,884,148935,149819,video,FALSE
CompanyJ_1656,5 GOALS IN 21 MINUTES BETWEEN MAN CITY AND TOTTENHAM ,53,341,49009,49350,video,FALSE
CompanyJ_1657,Russ and Dames beef goes way beyond this years playoffs,55,1430,130952,132382,video,FALSE
CompanyJ_1658,The Champions League final four  (via @brfootball),50,1646,187735,189381,image,FALSE
CompanyJ_1659,WHAT AN ENDING. Video review rules out Sterlings goal for offside at the death ,79,1123,83548,84671,video,FALSE
CompanyJ_1660,Kyrie went full Uncle Drew mode in the 4Q,41,1099,188385,189484,video,FALSE
CompanyJ_1661,Harden is unreal. Hakeem approves.,34,2819,380218,383037,video,FALSE
CompanyJ_1662,Giannis owned the Pistons in Game 2,35,2254,237606,239860,video,FALSE
CompanyJ_1663,Harden cooks up a triple-double and powers the Rockets to a 2-0 lead!,69,1237,139573,140810,video,FALSE
CompanyJ_1664,"Zion doing gender reveals, this baby gonna be a starter for Duke in 2037 (via @dukembb)",87,1583,191597,193180,video,FALSE
CompanyJ_1665,Tiger gets the MJ co-sign.,26,4178,510074,514252,image,FALSE
CompanyJ_1666,"Game Of Zones Season 6, Episode 2: Journeymen.  The Suns trade for the wrong ""Brooks""  CJ writes a letter to Jennifer Dame drops some bars on GSW",145,1270,195125,196395,video,FALSE
CompanyJ_1667,The disrespect has reached a new level... (via @apoochh),56,10135,653665,663800,image,FALSE
CompanyJ_1668,The attitude of the Bay is second to none   B/R x @beatsbydre,61,353,43302,43655,video,FALSE
CompanyJ_1669,"Talented enough to take a 31-point lead, careless enough to blow it  @howardabeck breaks down the Warriors rollercoaster start to the playoffs ahead of Game 3",158,270,54413,54683,video,FALSE
CompanyJ_1670,Do the Giants need to draft a QB?,33,8538,208675,217213,image,FALSE
CompanyJ_1671,That Philly energy   B/R x @beatsbydre,38,431,55250,55681,video,FALSE
CompanyJ_1672,SIMMONS MEAN MUG,16,2110,235884,237994,video,FALSE
CompanyJ_1673,Simmons reaction after Dudleys airball ,39,1797,150138,151935,video,FALSE
CompanyJ_1674,Who let it rip?,15,1771,150430,152201,video,FALSE
CompanyJ_1675,A playoff career high for Ben Simmons. He heard the chatter.,60,4035,415403,419438,image,FALSE
CompanyJ_1676,"Derrick White (36 PTS, 5 REB, 5 AST) stole the show in Game 3 and led the Spurs to a 118-108 win over the Nuggets",113,1580,268810,270390,video,FALSE
CompanyJ_1677,KD took over in the 2Q and Pat Bev looked defeated...,53,1803,196315,198118,video,FALSE
CompanyJ_1678,KD silenced Pat Bev ,20,2068,333205,335273,image,FALSE
CompanyJ_1679,KD struggled in Game 2 in large part because of Patrick Beverley's great defense. KD bounced back in a big way in Game 3 and led the Warriors with a game-high 38 PTS.,166,2641,327784,330425,video,FALSE
CompanyJ_1680,Gilbert Arenas says he is the GOAT because he made $62M while only playing 17 games: I wasnt gonna complain  (via @fairgameonfs1),129,4402,456037,460439,image,FALSE
CompanyJ_1681,"On this day in 2010, @kingjames HAMMERED one of his meanest dunks ever over James Johnson",89,2705,260222,262927,video,FALSE
CompanyJ_1682,"KD vs. Pat-Bev, Russ vs. Dame and critical Game 3s and 4s.  Ready for more NBA playoffs this weekend?",101,289,67389,67678,video,FALSE
CompanyJ_1683,Pascal Siakam stole the show in Game 3 and led the Toronto Raptors to a 2-1 series lead over the Orlando Magic,110,1312,237949,239261,video,FALSE
CompanyJ_1684,Kyrie owned the 4Q in Game 3 ,29,1350,163323,164673,video,FALSE
CompanyJ_1685,Brodie took it to Dame in Game 3 ,33,2697,187524,190221,video,FALSE
CompanyJ_1686,PG threw down a reverse double pump dunk with time expiring ,60,2691,262867,265558,video,FALSE
CompanyJ_1687,Schroder hit Lillard with his own Dame Time celebration ,56,1405,111013,112418,video,FALSE
CompanyJ_1688,"33 years ago today, Jordan set the playoff scoring record at 23. He had 63 points without shooting a three.",107,3972,393428,397400,image,FALSE
CompanyJ_1689,Tobi and Bobis bromance could bring any team chemistry to the next level ,73,1112,232060,233172,video,FALSE
CompanyJ_1690,We need mics on Russ and Dame for this battle,45,6253,464841,471094,video,FALSE
CompanyJ_1691,How does Giannis taking off from the FT line fire up the Bucks? Brook Splash Mountain Lopez gives an inside look at his team in his first Playoff Diary  From B/R x Wells Fargo,175,245,64603,64848,video,FALSE
CompanyJ_1692,"Take a behind the scenes look at D'Angelo Russells first playoff home game, with a surprise visit from his buddy Karl-Anthony Towns. He finished with 26 points in 30 minutes of action.",184,713,237260,237973,video,FALSE
CompanyJ_1693,"LeVert on Embiid, Dudley steal off Simmons  Nets coming in HOT ",63,867,174395,175262,video,FALSE
CompanyJ_1694,BEN VS. DUDLEY IS GETTING GOOD ,31,3612,341306,344918,video,FALSE
CompanyJ_1695,Jared Dudley vs. EVERYBODY,26,9468,564206,573674,video,FALSE
CompanyJ_1696,The Process delivered in Game 4:  31 PTS | 16 REB | 7 AST | 6 BLK  Sixers take a 3-1 lead on Brooklyn,101,1572,241897,243469,image,FALSE
CompanyJ_1697,Embiid going off during and after the game.,43,2122,262886,265008,image,FALSE
CompanyJ_1698,Game 4 brought the playoff intensity,36,2761,372500,375261,image,FALSE
CompanyJ_1699,Embiid and the Sixers want all the smoke ,41,1353,244526,245879,image,FALSE
CompanyJ_1700,DeMar CHUCKED the ball at the ref and got ejected after getting called for a charge,83,1272,152969,154241,video,FALSE
CompanyJ_1701,When you go 3-20 but still get the W,36,1784,147651,149435,video,FALSE
CompanyJ_1702,Rockets prevailed despite Hardens historically poor shooting night.,67,5153,307477,312630,image,FALSE
CompanyJ_1703,"Jimmy Butler tells the 76ers equipment manager to GTFO his seat before every game  *NSFW* (via jimmybutler/YouTube, thebobbyshaw33/Reddit)",138,2177,327786,329963,video,FALSE
CompanyJ_1704,Dirk took out a full-page ad thanking fans in Dallas  (via @sportsdaydfw),73,2579,485467,488046,image,FALSE
CompanyJ_1705,Dame vs. Russ. It's supposed to be SPICY ,41,1077,133457,134534,video,FALSE
CompanyJ_1706,"Longest my hairs been in a long time. Might keep it, though  Brons feeling good on Easter morning",97,4966,295753,300719,video,FALSE
CompanyJ_1707,Kyrie has the highest playoff winning percentage in NBA history  76.4%  Min. 50 games  (H/T NBA Countdown),106,6238,538190,544428,image,FALSE
CompanyJ_1708,Myles Turner destroyed Hayward,30,2586,245171,247757,video,FALSE
CompanyJ_1709,Ankles are not safe around Kyrie,32,671,117247,117918,video,FALSE
CompanyJ_1710,Klay Thompson dropped 32 PTS and went 6/9 from 3PT land in Game 4 to lead the Warriors to a 3-1 series lead.,108,891,244948,245839,video,FALSE
CompanyJ_1711,Dame vs. Russ: Part 4 ,22,2039,370349,372388,carousel,FALSE
CompanyJ_1712,Russ stares down the Portland bench after pulling up in front of Dame ,70,2686,204464,207150,video,FALSE
CompanyJ_1713,Damian Lillard dropped 15 PTS in the 3Q to help lead the Portland Trail Blazers to a 3-1 series lead.,101,3033,382878,385911,video,FALSE
CompanyJ_1714,"15 years ago today, Pat Tillman was killed on patrol in Afghanistan",67,2209,326071,328280,carousel,FALSE
CompanyJ_1715,- Celtics SWEEP the Pacers back to Indy - Klay & KD put on a show in LA for GSW - The Klaw dominated in Orlando - Dame and the Blazers hold OKC under 100 PTS AGAIN  Catch up on yesterdays action #ControlTheGame ,211,294,78941,79235,video,FALSE
CompanyJ_1716,Cassius Stanley is officially a Duke Blue Devil  @br_hoops,58,4467,464268,468735,carousel,FALSE
CompanyJ_1717,Mbappe hit one of the fastest sprints EVER RECORDED in soccer this weekend  (via @brfootball),93,3551,365524,369075,image,FALSE
CompanyJ_1718,"New Champions season, same dysfunctional house. Season 2 drops April 29th  (@brfootball)",88,272,29905,30177,video,FALSE
CompanyJ_1719,Dukes 2019 class is looking stacked @br_hoops  No. 4 recruit Vernon Carey Jr. No. 8 recruit Matthew Hurt No. 23 recruit Wendell Moore No. 29 recruit Cassius Stanley No. 32 recruit Boogie Ellis,192,6807,466282,473089,image,FALSE
CompanyJ_1720,#NAME?,50,264,40608,40872,video,FALSE
CompanyJ_1721,BLAKE ,6,801,142557,143358,video,FALSE
CompanyJ_1722,"Former SportsNet LA host Kelli Tennant files lawsuit saying Luke Walton sexually assaulted her while he was an assistant with Golden State, per @tmz_tv",151,12041,300659,312700,image,FALSE
CompanyJ_1723,Giannis on Thon Maker. SHEESH. ( @metrobytmobile),49,1306,175053,176359,video,FALSE
CompanyJ_1724,Giannis went MJ on the double pump and Drummond was baffled ,60,5097,607665,612762,video,FALSE
CompanyJ_1725,"Blake joined in with the crowd on ""refs, you suck"" chant ",57,2416,417579,419995,video,FALSE
CompanyJ_1726,Giannis drops 41 & leads the Bucks to their first playoff series win since 2001 ,80,2730,449037,451767,image,FALSE
CompanyJ_1727,The Pistons playoff woes continue.,34,963,119368,120331,video,FALSE
CompanyJ_1728,Giannis finished mid-air like MJ ,33,1635,261321,262956,image,FALSE
CompanyJ_1729,Into the Spida-Verse . Donovan Mitchell drops 31 to keep Utahs season alive!,76,2009,310467,312476,image,FALSE
CompanyJ_1730,SPIDA GOT UP ,13,684,153677,154361,video,FALSE
CompanyJ_1731,The Rockets couldn't figure out how to sweep in Utah,52,3595,366698,370293,video,FALSE
CompanyJ_1732,Things are getting wild on the TNT set  (via @nbaontnt),55,3065,281399,284464,video,FALSE
CompanyJ_1733,"Donovan Mitchell dropped 31 PTS, 7 REB and 4 AST in Game 4 to help the Utah Jazz avoid a series sweep.",102,679,214308,214987,video,FALSE
CompanyJ_1734,"Cole Anthony, the no. 1 PG in the class of 2019, is a North Carolina commit @br_hoops",85,5723,506228,511951,image,FALSE
CompanyJ_1735,This skill is FILTHY  (via @tntsportsla),40,7360,411230,418590,video,FALSE
CompanyJ_1736,Cole Anthony was a walking triple-double at Oak Hill. Will he be doing more of the same at UNC? @br_hoops,105,617,120442,121059,video,FALSE
CompanyJ_1737,"26 years ago today, @shaq tore down the entire backboard as a rookie. MONSTER.",78,1605,256018,257623,video,FALSE
CompanyJ_1738,Celtics getting hot at the right time. Giannis dominating like an MVP.  This series is gonna be good.,101,12798,589679,602477,image,FALSE
CompanyJ_1739,"David Sills committed to USC at 13 years old, the youngest QB recruit in history.  Now, he's projected to be a middle-round pick at the NFL Draft  as a WR.",155,983,148313,149296,video,FALSE
CompanyJ_1740,"#GridironHeights NFL Draft Special  Kyler, Bosa and D.K. are looking for jobs on career day",91,847,104371,105218,video,FALSE
CompanyJ_1741,French had Ye moving  *NSFW* (via @frenchmontana),49,1917,163461,165378,video,FALSE
CompanyJ_1742,76ers are up by 20 on the Nets and Embiid is talking that talk ,63,1068,182820,183888,video,FALSE
CompanyJ_1743,Embiid & Simmons get the last laugh ,36,3292,307240,310532,video,FALSE
CompanyJ_1744,Dame has 32 points in the first 20 minutes. SHEESH ,51,3595,372329,375924,video,FALSE
CompanyJ_1745,Its Lillards Time! Dame drops 50 as Portland ends OKCs season!,62,7502,577121,584623,image,FALSE
CompanyJ_1746,DAME FOR THE WIN.,17,32135,1173193,1205328,video,FALSE
CompanyJ_1747,Different series. Same Dame. You already know what time it is ,62,5496,483767,489263,video,FALSE
CompanyJ_1748,Dame Winner.,12,1849,408165,410014,image,FALSE
CompanyJ_1749,Mic drop ,9,7677,675508,683185,video,FALSE
CompanyJ_1750,Dame over.,10,3302,486833,490135,image,FALSE
CompanyJ_1751,"Utah Jazz star Rudy Gobert still carries a chip on his shoulder from when he was passed over by 26 teams in the 2013 NBA draft. In fact, he can name almost every single player drafted ahead of him . Watch his full interview on the latest episode of Take It There with Taylor Rooks.",281,417,100451,100868,video,FALSE
CompanyJ_1752,3-star QB  2nd round pick as a RB?  David Montgomery is looking to become the 1st Iowa St. player drafted in five years,119,351,51195,51546,video,FALSE
CompanyJ_1753,They dont call him Logo Lillard for nothing.,44,3919,288108,292027,video,FALSE
CompanyJ_1754,#NAME?,123,381,36728,37109,video,FALSE
CompanyJ_1755,LeBron loves being a part of the Lake Show (via @kingjames),59,4146,338656,342802,video,FALSE
CompanyJ_1756,Whats the Rockets mindset heading into Game 5? How has Donovan Mitchell impressed? Kenneth Faried dishes in his first playoff diary  From B/R x @wellsfargo,155,188,38002,38190,video,FALSE
CompanyJ_1757,CP3 doesnt like getting sond ,29,3714,455907,459621,video,FALSE
CompanyJ_1758,Scary Hours? ,13,3550,319934,323484,image,FALSE
CompanyJ_1759,SIXTH MAN LIKE  Lou Will drops 33 and 10 to keep the Clippers alive. Wow.,73,3157,340561,343718,video,FALSE
CompanyJ_1760,Expos catcher Tom Brady? Rockies OF Michael Vick? Kyler Murray isnt the first QB prospect to turn down MLB for the NFL,118,2002,254566,256568,carousel,FALSE
CompanyJ_1761,"Tim Duncan turns 43 today with one of games most untouchable resumes.  2x MVP 5x champion 3x Finals MVP 15x All-NBA 15x All-Defense Titles in three decades 1,158 total career wins 50+ wins in 18 seasons",202,3247,388030,391277,image,FALSE
CompanyJ_1762,245 lbs in EACH HAND  (via @larrywheels),40,11579,334503,346082,video,FALSE
CompanyJ_1763,"Game of Zones Season 6, Episode 3: The North Remembers. Kyle Lowry loses it when the Raptors trade DeMar  #GameOfZones",118,4487,356261,360748,video,FALSE
CompanyJ_1764,"Pepper Redmond? Ashton Dulin? DeAndre Hopkins, Davante Adams and Christian McCaffrey have to decide: Prospect or made up?",121,193,35617,35810,video,FALSE
CompanyJ_1765,"18 years ago, Mike Vick became the first black QB to get drafted No. 1 overall.  Broke the mold. (via @nflthrowback)",116,3046,357862,360908,carousel,FALSE
CompanyJ_1766,Harrell is ready for Game 6.,28,4656,380135,384791,image,FALSE
CompanyJ_1767,Patrick Mahomes is the newest cover athlete for Madden 20 (via @eamaddennfl),76,3980,321082,325062,image,FALSE
CompanyJ_1768,"From tunnel shots to taking naps, pregame rituals power players confidence through the playoffs  From B/R x Stitch Fix",118,174,52628,52802,video,FALSE
CompanyJ_1769,"Nick Bosa has been around the league for as long as he can remember. Now its his turn to walk across the stage wearing a suit that reminds him of his roots.  From B/R x @mbymichaelstrahan, JCPenney",197,168,31544,31712,video,FALSE
CompanyJ_1770,"Josh Allen credits the birth of his son as the inspiration that tailored him for this moment on draft day, and hes wearing a suit that holds a special place in his heart.  From B/R x @mbymichaelstrahan, JCPenney",211,93,26805,26898,video,FALSE
CompanyJ_1771,Kyler Murray goes No. 1 overall to the Arizona Cardinals!,57,642,114711,115353,video,FALSE
CompanyJ_1772,Baker & Kyler make history for the University of Oklahoma!,58,468,141569,142037,image,FALSE
CompanyJ_1773,Kyler becomes the first athlete to be a first round pick in both the MLB & NFL ,79,1536,292511,294047,image,FALSE
CompanyJ_1774,Bosa brothers ,14,426,128754,129180,image,FALSE
CompanyJ_1775,Oakland was CONFUSED after taking Clemson DE Clelin Ferrell No. 4 ,66,3529,268976,272505,image,FALSE
CompanyJ_1776,Celtics confirm the passing of NBA legend John Havlicek. RIP   13x All Star 8x champion Finals MVP HOF,102,5242,462455,467697,image,FALSE
CompanyJ_1777,Joe Buddens reaction to the Giants drafting Daniel Jones  (via @cynsantana),75,3825,247599,251424,video,FALSE
CompanyJ_1778,NFL draft No. 7 overall pick:  2018- Josh Allen  2019- Josh Allen,65,1047,223303,224350,image,FALSE
CompanyJ_1779,Dwayne Haskins goes No. 15 overall to the Washington Redskins!,62,2342,299428,301770,image,FALSE
CompanyJ_1780,Oh boy ,7,2163,226976,229139,video,FALSE
CompanyJ_1781,Haskins has a chip on his shoulder,34,4052,348166,352218,image,FALSE
CompanyJ_1782,Lamar is ready to go Hollywood in Baltimore,43,1133,220052,221185,image,FALSE
CompanyJ_1783,Josh Jacobs is living out his dream Homeless in middle schoolUnknown before Bama interestGot buzz by posting his own highlightsSlept on dorm floor because he was so used to itFirst RB drafted in 2019,199,1485,331586,333071,carousel,FALSE
CompanyJ_1784,The future of the Giants? ,26,4974,262996,267970,image,FALSE
CompanyJ_1785,"Chiefs announce theyve suspended Tyreek Hill from all team activities following the release of disturbing recording where he told his fiancee You need to be terrified of me, b---h",179,7651,331602,339253,image,FALSE
CompanyJ_1786,"With my hands   James Harrison, Von Miller, JuJu and other stars discuss how theyd beat Thanos",94,508,61590,62098,video,FALSE
CompanyJ_1787,Dame wasnt hearing it.,22,4454,374252,378706,image,FALSE
CompanyJ_1788,"Why not prove em wrong, @russwest44",35,8158,475437,483595,image,FALSE
CompanyJ_1789,Mayor of Flavortown gives his pitch,35,3369,438075,441444,image,FALSE
CompanyJ_1790,The moment Deebo Samuel (@uno_captain) got drafted by the 49ers is what its all about ,86,1429,280663,282092,video,FALSE
CompanyJ_1791,Vlad Jr. first major league at-bat: walks up to Lil Nas X  (via @mlbcut4),73,1030,199116,200146,video,FALSE
CompanyJ_1792,Quinnen Williams: *sneezes*  Quinnen Williams: Bless you (via @thecheckdown),76,3261,258749,262010,video,FALSE
CompanyJ_1793,"Josh Rosen has been traded to Miami, per @adamschefter",54,2075,262688,264763,image,FALSE
CompanyJ_1794,"Seahawks WR Doug Baldwin may not be able to play again due to multiple injuries, per @adamschefter",98,2278,219869,222147,image,FALSE
CompanyJ_1795,KD drops 50 and ends the Clippers season ,41,6192,573723,579915,image,FALSE
CompanyJ_1796,KD says Im nice after dropping a 50 piece on the Clippers,57,3112,296913,300025,video,FALSE
CompanyJ_1797,Kevin Durant dropped a playoff career-high 50 PTS to eliminate the Los Angeles Clippers.,88,1404,227336,228740,video,FALSE
CompanyJ_1798,"""Since we left, I've been screaming that a team needs to go there."" KD is fully on board to bring the Sonics back (via @nbaontnt)",129,2063,321940,324003,video,FALSE
CompanyJ_1799,Proud dad  Vlad Guerrero watching @vladdyjr27 get his first hit (via @mlb),74,401,121040,121441,video,FALSE
CompanyJ_1800,Im Kevin Durant. You know who I am. Since then:  38 PTS | 14-23 FG 33 PTS | 12-21 FG 45 PTS | 14-26 FG 50 PTS | 15-26 FG,120,5736,421761,427497,image,FALSE
CompanyJ_1801,"Sparks have acquired All-Star Chiney Ogwumike for a 2020 first-round pick, per @wojespn",87,2033,133517,135550,image,FALSE
CompanyJ_1802,Messi is the first Barcelona player to win 10 La Liga titles  (via @brfootball),79,854,133406,134260,image,FALSE
CompanyJ_1803,Whos the best bet to win the East? @br_betting,46,1717,82253,83970,video,FALSE
CompanyJ_1804,James gang in the house to watch Bronny and the Strive for Greatness squad (via @br_hoops),90,628,172787,173415,video,FALSE
CompanyJ_1805,Rams picked Last Chance U star Dakota Allen (Texas Tech LB) in the seventh round  First player from the show to get drafted,123,5136,455025,460161,image,FALSE
CompanyJ_1806,The ride isnt over. All went undrafted:  Adam Thielen  Phillip Lindsay  Doug Baldwin  Chris Harris Jr.  Antonio Gates  James Harrison  Jason Peters  Michael Bennett  Wes Welker  Kurt Warner  Tony Romo  Adam Vinatieri  Warren Moon  John Randle,242,3865,270230,274095,image,FALSE
CompanyJ_1807,Drake said he cant guard you after Kawhi hit a nasty combo,58,2543,438427,440970,video,FALSE
CompanyJ_1808,Kawhi drops 45 and the Raptors take a 1-0 lead ,47,1557,319424,320981,image,FALSE
CompanyJ_1809,Kawhis postgame interview got cut short and he was okay with it ,64,3184,540703,543887,video,FALSE
CompanyJ_1810,Kawhi Leonard could not be stopped in Game 1 as he finished with 45 PTS and 11 REB in Toronto,93,3391,338744,342135,video,FALSE
CompanyJ_1811,Nuggets win a pivotal Game 7 and move on to the 2nd round ,58,2241,345331,347572,image,FALSE
CompanyJ_1812,JAMAL MURRAY GAME 7 DAGGER ,27,1752,256728,258480,video,FALSE
CompanyJ_1813,Celtics catching fire  Giannis in MVP form  KD as locked in as ever  Rockets coming for revenge   Were in for a great day of basketball.,136,1334,304557,305891,image,FALSE
CompanyJ_1814,Look at him now ,16,3851,521958,525809,image,FALSE
CompanyJ_1815,Will the Rockets figure out how to stop the Warriors this time?,63,3750,349678,353428,image,FALSE
CompanyJ_1816,"Celtics dominate in Game 1, 112-90  Horford: 20 PTS | 11 REB | 3 BLK Giannis: 7-21 FG",85,3763,372850,376613,image,FALSE
CompanyJ_1817,Kyrie looking like Bean.,24,2015,251923,253938,video,FALSE
CompanyJ_1818,@kingjames Yeezy 1 x Nike LeBron 15 . @brkicks,46,2173,259618,261791,carousel,FALSE
CompanyJ_1819,COLD.,5,5526,472782,478308,image,FALSE
CompanyJ_1820,STEPH CALLED GAME 1 ,20,10720,520866,531586,video,FALSE
CompanyJ_1821,"No call on Harden, CP3 ejection to close out Game 1. Rough ending for the Rockets.",82,9563,381836,391399,video,FALSE
CompanyJ_1822,Kevin Durant dropped 35 PTS and 5 REB in Game 1 to take a 1-0 series lead,73,1549,227367,228916,video,FALSE
CompanyJ_1823,Kyrie lookin like Kobe in Game 1 ,33,2902,341456,344358,video,FALSE
CompanyJ_1824,This is wild  (via @cgrhandpainted),35,2151,290192,292343,video,FALSE
CompanyJ_1825,"Arya Stark, forever clutch.",27,13600,666020,679620,carousel,FALSE
CompanyJ_1826,Kemba could get up to $221M from Charlotte,42,3572,283561,287133,image,FALSE
CompanyJ_1827,Arya had other plans ,21,1890,207666,209556,image,FALSE
CompanyJ_1828,God Shammgod turns 43 today. Created one of the coldest moves in basketball history ,84,4639,505683,510322,video,FALSE
CompanyJ_1829, The Champions S2 Premiere ,27,1372,192592,193964,video,FALSE
CompanyJ_1830,He opened up a tab for the entire @adidasoriginals store ,57,479,64859,65338,video,FALSE
CompanyJ_1831,"My mom has always put everyone before herself & sacrificed things unimaginable.""   DeAndre Hopkins' mom, Sabrina Greenlee, is visually impaired after being assaulted with boiling chemicals in 2002. She will be the subject of a new film, per @Variety",249,893,297275,298168,image,FALSE
CompanyJ_1832,A wing defender is the only thing standing in @jharden13 and @cp3's way of getting to the rim ,94,223,42298,42521,video,FALSE
CompanyJ_1833,Slow-mo Spice shakes Embiid  (via @nba),39,844,125603,126447,video,FALSE
CompanyJ_1834,Drake is HYPED ,15,2735,263314,266049,video,FALSE
CompanyJ_1835,"Jimmy Butler dropped 30 PTS, 11 REB and 5 AST in Game 2 to tie up the series 1-1",80,890,244396,245286,video,FALSE
CompanyJ_1836,The Sixers put an end to their woes in Toronto ,47,755,181399,182154,image,FALSE
CompanyJ_1837,Dame hit Jokic with a dirty step-back,37,1621,224688,226309,video,FALSE
CompanyJ_1838,My name isnt James. Its literally Jimmy. Butler responds to Brett Brown calling him James ,90,1379,289728,291107,video,FALSE
CompanyJ_1839,UP & UNDER,10,1025,160038,161063,video,FALSE
CompanyJ_1840,"Scottie Pippen says he definitely sees the comparison between KD and Jordan: When they catch the ball in their sweet spot, youre at their mercy (via @rachel_nichols, The Jump)",175,5769,430808,436577,image,FALSE
CompanyJ_1841,"13 years ago today, Kobe forced OT then hit the winner vs. Phoenix  VINTAGE",75,7237,718436,725673,carousel,FALSE
CompanyJ_1842,And the average age of the squad is only 24  (via @brfootball),62,489,74736,75225,image,FALSE
CompanyJ_1843,Jokic's feel for the game is special.,37,960,158685,159645,image,FALSE
CompanyJ_1844,"Mahomes can hoop, Mookie can run routes, Baker can rip moonshots  These athletes are great at more than one sport",113,468,145379,145847,video,FALSE
CompanyJ_1845,"Jamaal Charles is signing a one-day contract to retire with the Chiefs, per @610sportskc  11 years  4x Pro Bowler  7,563 rushing yards  2,593 receiving yards  5.4 YPC (4th all-time)  310 catches  64 total TDs (via @nflthrowback)",228,4269,538184,542453,carousel,FALSE
CompanyJ_1846,Ajaxs passing is unreal  (via @brfootball),42,880,113403,114283,video,FALSE
CompanyJ_1847,Backward nutmeg is FILTHY  (via @brfootball),44,747,110454,111201,video,FALSE
CompanyJ_1848,"A former DII hooper thought he could take on WNBA player and daughter of Dee Brown, Lexie Brown... She gave him BUCKETS (via @hoopstatenetwork)",143,8343,355676,364019,video,FALSE
CompanyJ_1849,Giannis hit the Steph shimmy ,29,1228,153551,154779,video,FALSE
CompanyJ_1850,We have a series.,17,1504,275482,276986,image,FALSE
CompanyJ_1851,"Happy birthday @travisscott. Who copped the ""Cactus Jack"" AJ1? (@brkicks)",73,658,178902,179560,image,FALSE
CompanyJ_1852,Harden got absolutely raked by Draymond. He's still in the game.,64,9497,540740,550237,image,FALSE
CompanyJ_1853,CP3s reaction to the Rockets getting a foul ,44,3062,368829,371891,video,FALSE
CompanyJ_1854,This man cant see and hes still getting buckets. Cold.,54,2711,317915,320626,video,FALSE
CompanyJ_1855,Shaq threatened To knock Chuck out,34,7953,415902,423855,video,FALSE
CompanyJ_1856,- Bucks came back strong to tie the series at 1-1 - Warriors close out in the clutch to take a 2-0 series lead  What a night in the NBA ,136,306,71235,71541,video,FALSE
CompanyJ_1857,"Salah sits down with Taylor Rooks to discuss the Champions League final, facing Messi, basketball and more. (@brfootball)",121,347,85709,86056,video,FALSE
CompanyJ_1858,Messi left Boateng for dead the last time he was in the UCL semifinals  (via @brfootball),89,1378,121281,122659,video,FALSE
CompanyJ_1859,"21 years ago today, Spike Lee released He Got Game.  Kobe didnt audition because he wanted to train all summer  Spike asked Ray Allen to audition after watching him at MSG in 97 It was scripted for Denzel to lose 11-0, but he scored because he refused to get zipped",265,1467,247527,248994,image,FALSE
CompanyJ_1860,Look at the security guard ,27,4635,366209,370844,video,FALSE
CompanyJ_1861,MESSI UNREAL FREE KICK  (via @brfootball),41,2335,154586,156921,video,FALSE
CompanyJ_1862,Scored against every single English team hes ever faced  (via @brfootball),74,728,143116,143844,image,FALSE
CompanyJ_1863,Joe Theismann gives new Redskins QB Dwayne Haskins his blessing to wear No. 7,77,2810,415845,418655,image,FALSE
CompanyJ_1864,N U T M E G,11,946,167937,168883,video,FALSE
CompanyJ_1865,Things getting chippy between the Nuggets and Blazers ,54,1093,136352,137445,video,FALSE
CompanyJ_1866,"Shump does have the height, weight and reach advantage   In partnership with @dazn_usa X B/R",92,243,43054,43297,video,FALSE
CompanyJ_1867,"5 years ago today, Dame hit his first playoff game-winner.  Sent the Rockets home in Game 6. Cold-Blooded.",106,3051,542196,545247,carousel,FALSE
CompanyJ_1868,Deebo went back home to bring in his new career as an NFL WR for the 49ers. His whole family were there for support when San Francisco made the call to him in South Carolina where he grew up.,191,830,240521,241351,video,FALSE
CompanyJ_1869,The BEND  (via @victorsaenz3),29,1749,164804,166553,video,FALSE
CompanyJ_1870,"2 years ago today, IT dropped 53 points in the playoffs on his late sister Chyna's 23rd birthday   All heart. (via @nbatv)",122,3494,408477,411971,video,FALSE
CompanyJ_1871,Bronny James was too smooth in his EYBL debut  (via @br_hoops),62,1187,209942,211129,video,FALSE
CompanyJ_1872,"Defensive tackle, turned wrestler, turned top-paid actor  Happy birthday to the man of many crafts, Dwayne Johnson ",115,1294,353682,354976,image,FALSE
CompanyJ_1873,"DAngelo Russell reportedly cited at airport after police found marijuana hidden in container that was made to look like an Arizona Iced Tea can, per @usatoday",158,21096,716443,737539,image,FALSE
CompanyJ_1874,"Game of Zones Season 6, Episode 4, Melo and the Model: Melo has a tough time adjusting to the Rockets system ",109,1680,269975,271655,video,FALSE
CompanyJ_1875,Embiids reactions after hitting a nasty windmill dunk ,54,2748,282877,285625,video,FALSE
CompanyJ_1876,"Embiid exploded for 33 points, 10 boards and 5 blocks. The Sixers took a 2-1 lead in the series.",96,1438,251723,253161,image,FALSE
CompanyJ_1877,No one was more hyped about Phillys Game 3 win than @theofficialai3,67,626,137883,138509,video,FALSE
CompanyJ_1878,"Joel Embiid bounced back strong and dominated Game 3 with 33 PTS, 10 REB, 5 BLK",79,792,179884,180676,video,FALSE
CompanyJ_1879,"One year ago today, LeBronto was born. King was in a ZONE.",58,7141,673283,680424,carousel,FALSE
CompanyJ_1880,"This weightlifter with cerebral palsy has inspired pro-athletes, lifting twice his weight and training non-stop",111,1101,116966,118067,video,FALSE
CompanyJ_1881,"Eight years ago today, D-Rose won MVP.  Youngest ever (22)  25.0 PPG | 7.7 AST  Most wins in the league  Joined MJ as only Bull to win it  Only player to win besides LeBron from 2009-2013",187,2274,323112,325386,image,FALSE
CompanyJ_1882,Giannis block and dunk electrified the arena. Brook dishes on how the Bucks turned the tables in game 2.  From B/R x Wells Fargo,128,270,47192,47462,video,FALSE
CompanyJ_1883,Kyrie knows what hes talking about.,35,4508,421041,425549,image,FALSE
CompanyJ_1884,Run it ,7,2377,308406,310783,image,FALSE
CompanyJ_1885,Celtics look on as the Bucks take a 2-1 series lead.,52,2039,269849,271888,image,FALSE
CompanyJ_1886,"Despite going down 2-1, Kyrie stayed proving he has the best handles in the league",82,821,135034,135855,video,FALSE
CompanyJ_1887,"Giannis Antetokounmpo finished with 32 PTS, 13 REB, 8 AST and 3 BLK in Game 3 to lead the Milwaukee Bucks to a 2-1 series lead",126,3375,399485,402860,video,FALSE
CompanyJ_1888,RODNEY HOOD STEALS GAME 3 IN 4OT  BLAZERS GO UP 2-1,51,3376,392989,396365,video,FALSE
CompanyJ_1889,CJ McCollum (41 PTS) took over in crunch time and led the Portland Trail Blazers to a historic 4OT win in Game 3 vs. the Denver Nuggets to take a 2-1 series lead,161,777,234502,235279,video,FALSE
CompanyJ_1890,Instant classic,15,788,269951,270739,image,FALSE
CompanyJ_1891,@hoodie5 channeled his inner Dame Time in 4OT ,46,1057,245617,246674,image,FALSE
CompanyJ_1892,You know who he is. Nobody can stop KD this postseason.,55,1946,173935,175881,video,FALSE
CompanyJ_1893,"18 months ago, there were fears Ryan Shazier might never walk again.  Last night, he danced at his wedding  (via @love_ola_9)",125,1711,254523,256234,video,FALSE
CompanyJ_1894,Today is 10 years since Brons first MVP.  Won three of next four MVPs  Donated car to local charity  Got award at St. Vincent-St. Mary  Kobe finished 2nd; Wade 3rd,163,2822,456861,459683,carousel,FALSE
CompanyJ_1895,Capela denied Iggy ,19,2372,340027,342399,image,FALSE
CompanyJ_1896,The Beard drops 41 in Game 3 to keep the Rockets alive in the series!,69,3007,385311,388318,image,FALSE
CompanyJ_1897,Harden dagger. Steph missed dunk.  Rockets take Game 3.,55,4641,281291,285932,video,FALSE
CompanyJ_1898,Rockets deny the Warriors in Game 3.,36,1830,187559,189389,video,FALSE
CompanyJ_1899,"James Harden (41 PTS, 9 REB, 6 AST) led the Houston Rockets to a Game 3 OT win at home. The Golden State Warriors hold 2-1 series lead.",135,921,200398,201319,video,FALSE
CompanyJ_1900,Lonzo and Bron took the news differently ,41,1189,228345,229534,image,FALSE
CompanyJ_1901,Canelo Alvarez wins by unanimous decision over Daniel Jacobs in middleweight title unification bout  #CaneloJacobs,114,1772,176197,177969,image,FALSE
CompanyJ_1902,James Harden with the ice-cold dagger to put the Warriors away ,63,2489,275091,277580,video,FALSE
CompanyJ_1903,Bron wanted to see if Zion could really play after dominating weaker HS competition. He proved himself at Duke: Every possession it seemed like he could make a difference on the outcome (via @HBO),196,1962,515349,517311,image,FALSE
CompanyJ_1904,Kawhi drops 39 in Game 4 to even the series at 2-2 ,51,1698,284957,286655,image,FALSE
CompanyJ_1905,Kawhi is absolutely dominating the series vs. Sixers averaging 38 PPG ,70,1626,297805,299431,video,FALSE
CompanyJ_1906,SETH CURRY GOING OFF. Hes got 16 PTS (4 threes) at the half ,60,872,138211,139083,video,FALSE
CompanyJ_1907,Jamal Murray showed out with 34 PTS to tie the series against the Blazers ,74,1283,305564,306847,video,FALSE
CompanyJ_1908,Jokic broke the mic ,20,1889,257888,259777,video,FALSE
CompanyJ_1909,A lot on the line this week ,28,1869,196644,198513,image,FALSE
CompanyJ_1910,Strength and balance are next level  (via @christopher_joyce18),63,5980,302065,308045,video,FALSE
CompanyJ_1911,"Five years ago today, KD called his mom the real MVP ",53,5303,671009,676312,carousel,FALSE
CompanyJ_1912,This went in.,13,1912,393077,394989,image,FALSE
CompanyJ_1913,History  Chiquita Evans is the first woman drafted to the @nba2kleague,70,992,93490,94482,video,FALSE
CompanyJ_1914,"Last Chance U star Ronald Ollie (DL, Nicholls State) announces hes signing with the Raiders",91,7192,452034,459226,image,FALSE
CompanyJ_1915,"Chuck had a rough day on the course at the ""2019 Black Masters""  (via @nbaontnt)",80,3661,170977,174638,video,FALSE
CompanyJ_1916, The Champions Ep. 2  (@brfootball),35,541,121241,121782,video,FALSE
CompanyJ_1917,Even the giants of the paint cant stop @JHarden13 from reverting Lord Basketballs curse.,88,72,27228,27300,video,FALSE
CompanyJ_1918,Kenneth Faried touts Hardens MVP performance and CP3s amazing ability to read the court in critical Game 3 win  From B/R x Wells Fargo,134,205,57642,57847,video,FALSE
CompanyJ_1919,"Talk that talk, Ja!",19,2262,292729,294991,image,FALSE
CompanyJ_1920,The Greek Freak mean mug is undefeated ,39,1397,136665,138062,video,FALSE
CompanyJ_1921,Giannis drops 39 & the Bucks take a commanding 3-1 series lead on Boston ,73,5961,523839,529800,image,FALSE
CompanyJ_1922,BEARD. BEHAVIOR.,16,1597,138523,140120,video,FALSE
CompanyJ_1923,"Technically, he was right ",26,8945,483698,492643,image,FALSE
CompanyJ_1924,Point God.,10,1595,118410,120005,video,FALSE
CompanyJ_1925,SERIES. TIED. ,14,2570,295750,298320,image,FALSE
CompanyJ_1926,38 PTS | 10 REBS | 4 ASTS,25,2040,152213,154253,video,FALSE
CompanyJ_1927,"You good, @shaq?  (Via @nbaontnt)",33,2019,146783,148802,video,FALSE
CompanyJ_1928,Harden dropped 38 to even the series. Giannis went off for 39. What a night ,76,410,61764,62174,video,FALSE
CompanyJ_1929,"Hes still emotional over the infamous Ramos injury in Champions League, has nothing to say to the haters who still doubt him and thinks his hair is better than Odells. @MoSalah is learning to embrace his newfound fame.",218,427,74539,74966,video,FALSE
CompanyJ_1930,OBJ wants to build a dynasty,28,3982,294095,298077,image,FALSE
CompanyJ_1931,Jokic has been a triple-double machine in his first NBA playoffs,64,480,60603,61083,video,FALSE
CompanyJ_1932,"Chet Holmgren is only a HS sophomore and hes already 7'0"" getting buckets effortlessly. @br_hoops",97,2722,124956,127678,video,FALSE
CompanyJ_1933,WHAT A GOAL . @brfootball,25,249,38943,39192,video,FALSE
CompanyJ_1934,Barcelona blew a 3-0 lead and Messi couldn't believe it  @brfootball,68,2540,166452,168992,video,FALSE
CompanyJ_1935,This is what it feels like to come back and make the Champions League final. @brfootball,88,1115,129709,130824,video,FALSE
CompanyJ_1936,LeBron knows something about historic comebacks (via @brfootball),65,1665,280779,282444,image,FALSE
CompanyJ_1937,"WHAT. A. COMEBACK!   Down 3-0 after the first leg, Liverpool win 4-0 without Salah and Firmino to advance to the Champions League final (via @brfootball)",153,658,62860,63518,video,FALSE
CompanyJ_1938,"The switch to ""Bucks in 5"" real quick  (via @nickgopaul86)",58,2223,223265,225488,video,FALSE
CompanyJ_1939,"""I think the series is over."" The Celtics have gone 0-3 since Paul Pierce said the Bucks were done ",99,8400,406002,414402,image,FALSE
CompanyJ_1940, KAWHY NOT?,11,1386,300908,302294,carousel,FALSE
CompanyJ_1941,Kawhi showed his Mamba Mentality,32,1891,153873,155764,video,FALSE
CompanyJ_1942,The many faces from the Raptors 36-point W,42,914,127179,128093,video,FALSE
CompanyJ_1943,Portland hasnt had an answer for Nikola Jokic ,46,1921,304504,306425,image,FALSE
CompanyJ_1944,Hernangomez put on the moves and the Nuggets bench lost it ,59,3386,311937,315323,video,FALSE
CompanyJ_1945,Caught them sleeping with a CORNER KICK FAKE  (via @brfootball),63,596,88513,89109,video,FALSE
CompanyJ_1946,4 years ago today: D-Rose hit the buzzer-beater...and the stare ,64,4509,545031,549540,carousel,FALSE
CompanyJ_1947,Zion LAUNCHED that so casually  *NSFW* (via @chrissidy_wack),60,2943,341644,344587,video,FALSE
CompanyJ_1948,Coach World Peace ,18,4191,283552,287743,image,FALSE
CompanyJ_1949,ScHoolboy Q makes changes to his hometown squad that will get them back to contention next year.,96,1214,157926,159140,video,FALSE
CompanyJ_1950,No lead is safe (via @brfootball),33,2144,193613,195757,image,FALSE
CompanyJ_1951,Super Mario Run should be at every ballpark this summer  (via @mlbcut4),71,1998,291041,293039,video,FALSE
CompanyJ_1952,This whole sequence is WILD  (via @brfootball),46,288,50835,51123,video,FALSE
CompanyJ_1953,Tottenham vs. Liverpool  The 2019 Champions League final ,57,976,112888,113864,image,FALSE
CompanyJ_1954,TOTTENHAM SCORE LAST MINUTE WINNER TO GO THROUGH TO THE CHAMPIONS LEAGUE FINAL,78,906,73316,74222,video,FALSE
CompanyJ_1955,@stevenash was in tears at full-time of Tottenham's win,55,2080,232501,234581,video,FALSE
CompanyJ_1956,The LeBron-AD trade deadline madness . Catch this weeks #GameOfZones early only in the B/R app (link in bio),108,299,47409,47708,video,FALSE
CompanyJ_1957,Kyrie shows up in big games. Will he do the same tonight? ,58,3700,261157,264857,image,FALSE
CompanyJ_1958,"Ty Lue has informed the Lakers that he is moving on from trying to become Lakers head coach, per Brad Turner",108,6156,355819,361975,image,FALSE
CompanyJ_1959,"It's been #BeardSeason the past two games for Harden averaging 39.5 PPG, 9.5 RPG, 5.0 APG. Can he keep it going tonight? ",121,4564,424536,429100,image,TRUE
CompanyJ_1960,Bucks end the Celtics season!,29,18304,802144,820448,video,FALSE
CompanyJ_1961,The Kyrie Decision awaits.,26,13633,592346,605979,image,FALSE
CompanyJ_1962,Last time Kyrie is in a Celtics jersey?,39,2077,101994,104071,video,FALSE
CompanyJ_1963,"""Paul Pierce sucks"" chants to close out Game 5 in Milwaukee ",60,906,103945,104851,video,FALSE
CompanyJ_1964,This is the year of the Greek Freak.  Career-high PPG  Career-high APG  Career-high RPG  Career-high FG %  MVP front-runner  NBAs best record  Conference Finals,160,2798,475273,478071,image,FALSE
CompanyJ_1965,Kevin Durant goes to the locker room after suffering an apparent non-contact injury on lower leg,96,3309,128786,132095,video,FALSE
CompanyJ_1966,Draymond was HYPED after hitting a big time 3 in Game 5 ,56,2777,141178,143955,video,FALSE
CompanyJ_1967,Wild sequence seals Game 5 for the Warriors ,44,2146,117270,119416,video,FALSE
CompanyJ_1968,Steve Kerr not holding back after the win,41,2340,224156,226496,image,FALSE
CompanyJ_1969,"Steph Curry (25 PTS, 6 REB, 5 AST) and Klay Thompson (27 PTS 4 REB 3 STL) went off in the Warriors' Game 5 win to take a 3-2 series lead against the Rockets",156,1123,215511,216634,video,FALSE
CompanyJ_1970,This goal was a MESS  (via @saoroque.fc),40,2041,190926,192967,video,FALSE
CompanyJ_1971,"Lakers fans will stage a protest tomorrow outside of Staples Center to voice their frustration with the franchise, per @am570lasports",133,15555,587878,603433,image,FALSE
CompanyJ_1972,Are Raptors real contenders? How prepared is The Process? A playoffs without LeBron is teaching a lot about other teams.,120,1632,86135,87767,video,FALSE
CompanyJ_1973,"Game of Zones Season 6, Episode 5: Loyalty: Lonzo, Ingram and the young Lakers get caught up in the trade deadline madness. Dirk knights Kristaps and Luka in Dallas.",165,2135,265865,268000,video,FALSE
CompanyJ_1974,Tim Anderson pledges $500 per stolen base this season to his anti-violence charity League of Leaders,100,914,203244,204158,image,FALSE
CompanyJ_1975,That time Embiid prepped for a playoff game watching some Dragon Ball  Happy #gokuday (via @nbaontnt),101,4121,318516,322637,video,FALSE
CompanyJ_1976,"For the first time, the UCL & Europa League finalists are all Premier League teams  (via @brfootball)",101,762,108508,109270,image,FALSE
CompanyJ_1977,Mikey Williams hasnt even finished 8th grade yet... (via @_mikeywilliams_),74,1209,109108,110317,video,FALSE
CompanyJ_1978,Clint Frazier's cleat game is untouchable @brkicks,50,3040,327561,330601,carousel,FALSE
CompanyJ_1979,Jimmy and the Sixers force a Game 7 ,36,1379,282899,284278,image,FALSE
CompanyJ_1980,JoJo and the 76ers DENIED the Raptors in Game 6 ,48,2363,152685,155048,video,FALSE
CompanyJ_1981,Dame and the Blazers are headed to Game 7!,42,1295,325843,327138,image,FALSE
CompanyJ_1982,Things got HEATED between Will Barton and Seth Curry in Game 6 ,63,1513,143605,145118,video,FALSE
CompanyJ_1983,Logo Lillard torched the Nuggets from 3PT land in Game 6 ,57,425,88200,88625,video,FALSE
CompanyJ_1984,Damian Lillard scored 32 PTS on 6-13 3-PT to even up the series against the Nuggets at 3-3.,91,705,236592,237297,video,FALSE
CompanyJ_1985,"Give me the ball, and everybody get out of the way   Four years ago today, LeBron called his own number with Game 4 of the Eastern Conference Semifinals on the line.",165,3178,444873,448051,carousel,FALSE
CompanyJ_1986,Celebrated graduation like the iconic Dame game-winnerstaredown included (via @angeljuliab),91,1372,253549,254921,video,FALSE
CompanyJ_1987,Bucks fans showing no mercy right down to the phone number  (via @krosesharkey),79,5805,545180,550985,image,FALSE
CompanyJ_1988,"Three years ago today, Steph Curry became the first unanimous MVP ever.  Single-season 3s record  Scoring champ  50/40/90 club  Steals leader  73 wins",150,6655,625520,632175,carousel,FALSE
CompanyJ_1989,"""They call it an embarrassment."" Unnamed Lakers players sounded off on what the franchise is doing, per @chrisbhaynesnba",120,3010,349773,352783,image,FALSE
CompanyJ_1990, and the Roc are in the building for Game 6,43,1080,225121,226201,image,FALSE
CompanyJ_1991,Steph comes alive in the 4th and the Warriors are headed to the WCF ,68,7561,542340,549901,image,FALSE
CompanyJ_1992,The Rockets just can't get by the Warriors ,43,7891,430951,438842,video,FALSE
CompanyJ_1993,Draymond gets the last laugh over Harden ,41,1345,105728,107073,video,FALSE
CompanyJ_1994,4Q finger injury didn't stop Steph from closing out the series against Houston ,79,1380,132168,133548,video,FALSE
CompanyJ_1995,WYD this summer?,16,2185,310926,313111,image,FALSE
CompanyJ_1996,Stephen Curry (33 PTS) and Klay Thompson (27 PTS) stepped up in place of an injured Kevin Durant in Game 6 and closed out the Houston Rockets on the road.,154,2444,288249,290693,video,FALSE
CompanyJ_1997,The Mother of Dragons pulled up to Dubs-Rockets #gameofthrones,62,3855,248052,251907,video,FALSE
CompanyJ_1998,"This couple changed the engagement shoot game by recreating iconic NBA moments  (via @rowshow, @thomas.bullock)",111,3866,356490,360356,carousel,FALSE
CompanyJ_1999,"Kyrie has ""had discussions with people about playing for the Lakers"" ahead of his free agency this summer, per @windhorstespn",125,8438,507366,515804,image,FALSE
CompanyJ_2000,"""Kick me off the court again, boy."" Steph got the last laugh after Chris Paul kicked him off the court pregame (via ReidForgrave/Twitter)",137,3473,313816,317289,video,FALSE
CompanyJ_2001,"39 years ago today, Dr. J went up and under",43,904,243434,244338,image,FALSE
CompanyJ_2002,"Bronny, Skyy Clark, Dior Johnson and Emoni Bates put on a SHOW  @br_hoops",73,380,128300,128680,video,FALSE
CompanyJ_2003,Incredible  (via @danthemancina),32,526,111874,112400,video,FALSE
CompanyJ_2004,"Breaking: Frank Vogel has agreed to become the next head coach of the Lakers, per @wojespn",90,6809,345720,352529,image,FALSE
CompanyJ_2005,"""Frank Vogel, Frank Ocean, Frank Gore, don't matter, this my team"" ",67,5165,386354,391519,image,FALSE
CompanyJ_2006,Mikey Williams is a problem in the making  (via @br_hoops),58,1417,164189,165606,video,FALSE
CompanyJ_2007,"8 years ago today, LeBron took down the Boston Celtics for the first time in the postseason  James ended Game 5 on a 10-0 run to close out the series",149,2774,374892,377666,image,FALSE
CompanyJ_2008,#NAME?,48,2071,146278,148349,video,FALSE
CompanyJ_2009,Best two words in sports: GAME 7,32,1680,230828,232508,image,FALSE
CompanyJ_2010,Happy Mothers Day ,18,560,208060,208620,image,FALSE
CompanyJ_2011,Manchester City wins the Premier League for the second year in a row!  (via @brfootball),88,544,84209,84753,image,FALSE
CompanyJ_2012,@shaq heard about a 13-year-old player who wears size 18s and struggles to find/afford shoes.  He bought him 10 pairs from a store that took care of him when he had the same problem growing up  (via @CNN),204,714,182752,183466,image,FALSE
CompanyJ_2013,"On this day in 1997, Kobe put up FOUR air balls in the 4th and OT vs. Utah to end his rookie season. He used it to change his career   Only 18 years old  Shot at local HS into the a.m.  Dropped out of He Got Game  Motivated him for 20 years",240,2546,415826,418372,image,FALSE
CompanyJ_2014,Pro skater at 14. First 900 spin ever. Timeless video games. Worth over $140M. Built 500+ skateparks. Changed narrative around skating.  Happy 51st to the legendary Tony Hawk ,175,2108,313701,315809,image,FALSE
CompanyJ_2015,Blazers eliminate the Nuggets and advance to the Western Conference Finals!,75,6198,553996,560194,image,FALSE
CompanyJ_2016,Game on the line. CJ delivers. What a performance.,50,1200,161955,163155,video,FALSE
CompanyJ_2017,Two Northeast Ohio legends with clutch blocks in a Game 7,57,2678,288410,291088,video,FALSE
CompanyJ_2018,Back in the WCF for the first time since 1999-2000  Rip City.,61,1278,248119,249397,image,FALSE
CompanyJ_2019,Blazers Game 7 summary,22,1454,143408,144862,video,FALSE
CompanyJ_2020,McCollum dropped 37 PTS & 9 REB on 17-29 FG,43,916,224134,225050,video,FALSE
CompanyJ_2021,Seth vs. Steph ,15,4096,537719,541815,image,FALSE
CompanyJ_2022,Kobe confirmed ,15,1488,316921,318409,image,FALSE
CompanyJ_2023,Kawhi going IN for Game 7. 36 and counting ,43,644,135556,136200,video,FALSE
CompanyJ_2024,Tobias with the smooth cross ,29,529,80959,81488,video,FALSE
CompanyJ_2025,Kawhi carries Toronto to the Eastern Conference Finals!,55,5200,592859,598059,image,FALSE
CompanyJ_2026,KAWHI FOR THE WIN. WOW,22,18886,1041198,1060084,video,FALSE
CompanyJ_2027,Kawhis reaction to his game-winner is priceless.,48,4699,466364,471063,video,FALSE
CompanyJ_2028,Pure emotion.,13,2898,514006,516904,image,FALSE
CompanyJ_2029,Kawhis game winner has Drake ready to drop a classic,52,1952,315470,317422,image,FALSE
CompanyJ_2030,Joel Embiid was very emotional with his girlfriend after Game 7 (via @johnclarknbc),83,21676,735106,756782,video,FALSE
CompanyJ_2031,Embiid gets perspective from his coach after a gut-wrenching Game 7 loss,72,835,129502,130337,video,FALSE
CompanyJ_2032,The 6 God was on the Raptors side in Game 7 ,44,2600,273252,275852,video,FALSE
CompanyJ_2033,Buzzer-beaters. Clutch.,23,1295,287177,288472,image,FALSE
CompanyJ_2034,"""That was the first buzzer beating Game 7 winner in NBA history""  Kawhi: ",73,4085,464420,468505,video,FALSE
CompanyJ_2035,Gobert knows when to put the rivalry aside ,43,4180,561747,565927,image,FALSE
CompanyJ_2036,Kawhi averaged 34.7 PPG vs. Philly and capped it with an iconic buzzer-beater. A series for the ages.,101,480,78990,79470,video,FALSE
CompanyJ_2037,Russell Wilson surprised his mom with a new house on Mothers Day. Her reaction  (via @dangerusswilson),102,2243,376337,378580,carousel,FALSE
CompanyJ_2038,He said whats up to @50cent mid-fight  (via @bellatormma),57,925,147789,148714,video,FALSE
CompanyJ_2039,Queensbridge. AAU legend. Infamy in Indiana. Finals Glory. Quiet Storm: The Ron Artest Story drops on @SHOsports on 5/31.,121,262,32716,32978,video,FALSE
CompanyJ_2040, The Champions Ep. 3  (@brfootball),35,514,108326,108840,video,FALSE
CompanyJ_2041,"Breaking: Dallas Wings are finalizing a trade to send WNBA All-Star Liz Cambage to the Las Vegas Aces, per BradyKlopferNBA/Twitter",130,6699,211103,217802,image,FALSE
CompanyJ_2042,Conference Finals. 4 teams. Who makes it out?,45,796,100511,101307,video,FALSE
CompanyJ_2043,Lottery tonight ,16,2047,279948,281995,image,FALSE
CompanyJ_2044,Rozier isn't interested in running it back with the same team.,62,4755,280727,285482,image,FALSE
CompanyJ_2045,"Knicks would shift focus to a deal for Anthony Davis if they get the No. 1 pick, per @shamsnba",94,9289,420006,429295,image,FALSE
CompanyJ_2046,Steph and Seth Curry are set to make history in the conference finals,69,720,111766,112486,video,FALSE
CompanyJ_2047,And then there were four. Conference Finals begin today ,56,3589,356934,360523,image,FALSE
CompanyJ_2048,Whos winning the @zionlw10 Sneaker Lottery? (via @brkicks),58,3803,382367,386170,carousel,FALSE
CompanyJ_2049,Curry household using the coin toss to decide which parent will root for Seth and Steph  (via @sydelcurrylee),109,1223,158889,160112,video,FALSE
CompanyJ_2050,Warriors-Rockets  Nuggets-Blazers   Two incredible series set up for what could be a historic Western Conference Finals #ControlTheGame,135,222,69546,69768,video,FALSE
CompanyJ_2051,NBA fans ahead of tonights lottery ,35,2197,231474,233671,video,FALSE
CompanyJ_2052,Could Zion and RJ make history as the 2nd pair of teammates to be taken 1 and 2 in the NBA Draft?,97,736,107435,108171,video,FALSE
CompanyJ_2053,Pelicans get the 1st overall pick in the 2019 NBA draft  Is Zion New Orleans-bound?,83,14813,687739,702552,image,FALSE
CompanyJ_2054,Knicks fans after falling to No. 3...,37,3519,207251,210770,video,FALSE
CompanyJ_2055,Uh-oh (via @master_tesfatsion),30,2755,159561,162316,video,FALSE
CompanyJ_2056,Lakers secured a higher pick than Cavs in Brons first year in LA,64,3057,370974,374031,image,FALSE
CompanyJ_2057,What couldve been  (via @brkicks),33,6894,529099,535993,image,FALSE
CompanyJ_2058,36 points and 9 threes for Steph and the Warriors take Game 1 ,62,1991,298865,300856,image,FALSE
CompanyJ_2059,Steph WENT OFF for nine 3s in Game 1 ,37,912,95364,96276,video,FALSE
CompanyJ_2060,"Stephen Curry wasted no time in Game 1, dropping 36 points and hitting nine 3-pointers to lead the Golden State Warriors to a 1-0 series lead.",142,1419,231200,232619,video,FALSE
CompanyJ_2061,Imagine playing against your sibling in the Western Conference Finals,69,3350,518786,522136,image,FALSE
CompanyJ_2062,Watch Kawhi Leonard's game-winner in Game 7 from every angle.,61,2517,342303,344820,video,FALSE
CompanyJ_2063,Tiger is hot off a Masters win  but Francesco Molinari might steal his spotlight at the PGA Championship,104,109,17629,17738,video,FALSE
CompanyJ_2064,Is the tanking era truly over?,30,3951,363798,367749,image,FALSE
CompanyJ_2065,Nutmegged him WITH HIS HEAD  (via @sharif_eljackson) @brfootball,64,1053,129751,130804,video,FALSE
CompanyJ_2066,"18 years ago today, Allen Iverson was named MVP of the league.  First player since 92-93 Jordan to lead league in PPG (31.1) and SPG (2.5)  With 93/124 first-place votes, AI beat out Duncan and Shaq  At 60"" and 165 pounds, hes the shortest and lightest player to ever win",271,2515,431763,434278,image,FALSE
CompanyJ_2067,At least say order Postmates or something Mystics superstar @De11eDonne is tired of the kitchen comments  New Take It There with @TaylorRooks,141,1364,68018,69382,video,FALSE
CompanyJ_2068,Giannis silenced the Celtics  Kawhi made history in Game 7  The Bucks-Raptors Eastern Conference Finals matchup is a must watch #ControlTheGame,143,221,60405,60626,video,FALSE
CompanyJ_2069,Bucks took care of business in Game 1 of the ECF ,49,1779,330969,332748,image,FALSE
CompanyJ_2070,THE LOPEZ GAME 29 PTS 12-21 FG 4-11 3PT 4 BLK Season-high | Playoff career-high,79,2681,441886,444567,carousel,FALSE
CompanyJ_2071,Shaq started a Barkley sucks chant with the Milwaukee crowd  (via @nbaontnt),76,767,186061,186828,video,FALSE
CompanyJ_2072,Kawhi shot 10-26 & didnt make a FG in the 4th quarter.,54,3530,322337,325867,image,FALSE
CompanyJ_2073,Tiger hasnt won back-to-back majors since 2006. Can he do it this weekend at the #PGAChampionship?,98,628,84065,84693,video,FALSE
CompanyJ_2074,Steph & Klay dominated Game 1: can the Warriors be stopped out West?,68,7,952,959,video,FALSE
CompanyJ_2075,Tania Tares trick shots are unreal ,35,1050,81029,82079,video,FALSE
CompanyJ_2076,"Game of Zones Season 6, Episode 6: The Lottery. Teams make their Zion pitch to the lottery gods...and LeBron is drinking through it all ",136,1533,216066,217599,video,FALSE
CompanyJ_2077,Wild ,5,3439,420877,424316,image,FALSE
CompanyJ_2078,Dame puts on for Oakland  #TownBusiness,39,1151,367389,368540,image,FALSE
CompanyJ_2079,CJ finally met Jennifer in person  (via @trailblazers),54,685,152046,152731,video,FALSE
CompanyJ_2080,Tacko Fall is force of nature ,30,4858,509958,514816,image,FALSE
CompanyJ_2081,Iggy LOCKED DOWN Dame and ran straight to the locker room,57,5779,303113,308892,video,FALSE
CompanyJ_2082,TOWN BUSINESS  Warriors take Game 2 and 2-0 series lead,55,1974,312498,314472,image,FALSE
CompanyJ_2083,Just like old times...,22,1000,303173,304173,image,FALSE
CompanyJ_2084,Curry finished with 37 PTS | 8 REB | 8 AST to help GS tale 2-0 series lead,74,1238,228237,229475,video,FALSE
CompanyJ_2085,Iggy stole Game 2 from Portland,31,1588,256983,258571,image,FALSE
CompanyJ_2086,"With two minutes left in Game 2, Seth tried to jinx his big bro at the free throw line: Thats like 70 in a row Stephs response: Bout to be 72""  (via @957thegame)",161,3083,706795,709878,carousel,FALSE
CompanyJ_2087,"The Knicks may have lost out on Zion, but @howardabeck says they could still win the AD lottery ",96,1555,249360,250915,video,FALSE
CompanyJ_2088,Big moves could be coming this summer  (via @brfootball),56,3375,392941,396316,image,FALSE
CompanyJ_2089,Technology is wild (via @jeffstaple)  @brkicks,46,1527,137442,138969,video,FALSE
CompanyJ_2090,Dirks eating GOOD.  Big man says hes gained 15 pounds since retiring because he hasnt worked out once and eats ice cream almost every day (@1053thefandfw),154,3600,553420,557020,image,FALSE
CompanyJ_2091,Tyreke Evans has been dismissed and disqualified from the NBA for violating the anti-drug policy.,97,8383,396075,404458,image,FALSE
CompanyJ_2092,Its a different Eastern Conference without LeBron,49,1911,307002,308913,image,FALSE
CompanyJ_2093,"Manu, Boris, Splitter and Patty made a Spurs version of the Banana Boat  They call themselves the #WienerBoatBoys  (via @diawboris)",131,2570,407055,409625,image,FALSE
CompanyJ_2094,"Former Oregon WR Keanon Lowe wrestled a gunman to the ground at a Portland high school, per The Oregonian",105,3251,460679,463930,image,FALSE
CompanyJ_2095, LAs calling  Milwaukee trying to send Kawhi back to SoCal,58,708,134778,135486,video,FALSE
CompanyJ_2096,Bucks defeat the Raptors by 22 to take a 2-0 series lead. They are 10-1 in the playoffs ,88,2722,456048,458770,image,FALSE
CompanyJ_2097,"Giannis Antetokounmpo led the Milwaukee Bucks to a 2-0 series lead at home, finishing with 30 PTS, 17 REB, 5 AST and 2 BLK.",123,784,192548,193332,video,FALSE
CompanyJ_2098,The Great Ones  Giannis and the Bucks took the Raptors to the Smackdown Hotel in Game 2,87,2341,486617,488958,image,FALSE
CompanyJ_2099,Kareem & Giannis. Elite company.,32,912,290423,291335,image,FALSE
CompanyJ_2100,"Chuck gave Malcolm Brogdon $45,000 to build a well for his charity that helps bring clean water to Africa  (via @nbaontnt)",122,4070,453006,457076,video,FALSE
CompanyJ_2101,"EJ got emotional after he returned home to Milwaukee and the city declared May 17th as ""Ernie Johnson Jr. Day""  (via @nbaontnt)",127,1515,303908,305423,video,FALSE
CompanyJ_2102,"21 years ago today, Jordan won MVP for final time in his career.  Fifth time winning it, tying Bill Russell for second all time  Played all 82 games for third consecutive season, averaging 28.7 PPG  Went on to sixth Finals MVP before retiring again",248,2826,429916,432742,image,FALSE
CompanyJ_2103,Flash never stops being a proud dad  (via @dwyanewade),54,405,164487,164892,carousel,FALSE
CompanyJ_2104,Im gonna ride til I cant no more,32,1458,253542,255000,image,FALSE
CompanyJ_2105,FIRST ROUND KO FOR DEONTAY WILDER,33,2094,322692,324786,image,FALSE
CompanyJ_2106,Wilder put him to SLEEP in the first round  (via @marfilmz),59,3465,361756,365221,video,FALSE
CompanyJ_2107,Steph drops 36 and the Warriors take a 3-0 lead,47,3426,382282,385708,image,FALSE
CompanyJ_2108,Vintage Dray ,13,2027,261568,263595,image,FALSE
CompanyJ_2109,Dray made sure the Warriors stayed confident during 2nd half run to win Game 3 (sound on),89,1553,185571,187124,video,FALSE
CompanyJ_2110,Stephen Curry led the Golden State Warriors in Game 3 with 36 PTS and 6 REB. The Warriors now hold a 3-0 series lead.,117,1586,256290,257876,video,FALSE
CompanyJ_2111,"Damian Lillard has separated ribs and is playing through his injury, per @shamsnba",82,6569,534939,541508,carousel,FALSE
CompanyJ_2112,Kevin Garnett turns 43 today. Nobody wanted it more. Champ MVP DPOY 15x All-Star 12x All-Defensive Gold medalist 7th-most games 20th-most points 10th-most rebounds T-most seasons ever (21) Broke barriers as HS draftee Highest-paid in NBA history,245,2892,501293,504185,image,FALSE
CompanyJ_2113,Messi is La Liga top scorer for the SIXTH time  (via @brfootball),65,1627,349242,350869,image,FALSE
CompanyJ_2114,Draymond has been dissecting the Blazers.  12 PTS | 10 REB | 5 AST | 3 BLK 16 PTS | 10 REB | 7 AST | 5 BLK 20 PTS | 13 REB | 12 AST | 4 STL  Engine.,148,2800,429212,432012,carousel,FALSE
CompanyJ_2115,"10 years ago today, Kobe (40) and Melo (39) combined for 79 points in Game 1 of the WCF.  Mamba later called Melo the player that I enjoyed guarding the most. He was the most difficult because of his size and his speed",218,5058,641136,646194,carousel,FALSE
CompanyJ_2116,Dray got fed up and made a change ,34,2100,260524,262624,image,FALSE
CompanyJ_2117,I dont think youve really seen it in the NBA before; Brook Lopez dishes on Giannis jaw-dropping plays as Bucks take 2-0 lead  From B/R x Wells Fargo,148,174,59394,59568,video,FALSE
CompanyJ_2118,Raps bench wanted to know how many steps Giannis took ,54,8297,389650,397947,video,FALSE
CompanyJ_2119,Kawhi caused a two-man pileup ,30,2029,269758,271787,video,FALSE
CompanyJ_2120,#NAME?,59,1319,152832,154151,video,FALSE
CompanyJ_2121,KAWHI TOOK OFF ,15,1373,141409,142782,video,FALSE
CompanyJ_2122,Kawhi comes up clutch and gets the Raptors their first win of the series,72,1801,309605,311406,image,FALSE
CompanyJ_2123,Kawhi put the team on his back. Scored 19 of his 36 in 4th Q and OTs,68,900,228357,229257,video,FALSE
CompanyJ_2124,Only took Kawhi one postseason to set this franchise record ,60,2646,384289,386935,image,FALSE
CompanyJ_2125,"Sorry Game of Thrones, but this was the best series finale ( swipe)",67,6066,660072,666138,carousel,FALSE
CompanyJ_2126,"""I stand tall and I've developed to be who I am."" (via @brfootball)",67,201,63490,63691,video,FALSE
CompanyJ_2127,Oh ,3,1338,171125,172463,image,FALSE
CompanyJ_2128,Dray trying to set a good example ,34,1907,350941,352848,image,FALSE
CompanyJ_2129,"25 years ago today, Scottie Pippen bodied Patrick Ewing then stepped over him: That was probably the easiest dunk I ever did. (via @NBATV)",138,3626,439610,443236,carousel,FALSE
CompanyJ_2130,You saw the Friends Kyrie 5. What if Nike made these?  @BRKicks,63,5945,389933,395878,carousel,FALSE
CompanyJ_2131, The Champions: Ep. 4  (@brfootball),36,552,97737,98289,video,FALSE
CompanyJ_2132,Giannis when guarded by Kawhi in Game 3:  41 possessions 4 points 2-12 FG 0-3 3PT 1 assist 2 turnovers  The Klaw clamped him. (via @nba),136,5527,457115,462642,image,FALSE
CompanyJ_2133,THE MEYERS LEONARD GAME. He has 25 PTS at half ,47,2235,373062,375297,image,FALSE
CompanyJ_2134,Steph and the Warriors sweep the Blazers ,41,10532,677519,688051,image,FALSE
CompanyJ_2135,Blazers come up empty in the series ,36,7288,422383,429671,video,FALSE
CompanyJ_2136,Steph knocks his brother out the playoffs ,42,16975,614477,631452,video,FALSE
CompanyJ_2137,Warriors join the '56-57 Celtics as the only teams in NBA history to make 5 straight finals,91,5183,344076,349259,image,FALSE
CompanyJ_2138,All love in the Curry family  (via @nbcsauthentic),50,751,134389,135140,video,FALSE
CompanyJ_2139,Steph and Dray making history ,30,1317,247326,248643,image,FALSE
CompanyJ_2140,Steph surpasses some of the all-time greats,43,3154,417595,420749,carousel,FALSE
CompanyJ_2141,#NAME?,48,492,67889,68381,image,FALSE
CompanyJ_2142,Did they get it right ,22,3356,272879,276235,image,FALSE
CompanyJ_2143,Giannis shouldve gotten out of Kawhis way ,42,1189,125837,127026,video,FALSE
CompanyJ_2144,Drake is loving Giannis free throw woes ,40,2448,168893,171341,video,FALSE
CompanyJ_2145,Drake helping coach Nurse relax ,32,917,132664,133581,video,FALSE
CompanyJ_2146,Kawhi got em. Series tied.,26,1258,260116,261374,image,FALSE
CompanyJ_2147,Gianna Bryant is a bucket in the making  (via @Ballislife),58,1150,105605,106755,video,FALSE
CompanyJ_2148,"On this day in 2003, LeBron signed with Nike for $90M @brkicks",62,5453,630230,635683,carousel,FALSE
CompanyJ_2149,This 20-year-olds rare disease doesnt stop him from being a baller ,67,1638,96725,98363,video,FALSE
CompanyJ_2150,"KD or Bron at the 3? @igotgame_12 names his dream starting lineup   Ja Morant on calling himself Point God, modeling his game after Russ and playing with Zion in AAU on a new Take It There with @TaylorRooks",206,1215,205492,206707,video,FALSE
CompanyJ_2151,Kawhi took flight in Game 4 ,28,928,89662,90590,video,FALSE
CompanyJ_2152,"Juwan Howard is expected to sign with Michigan as their new HC, per @jon.rothstein",82,4271,341406,345677,image,FALSE
CompanyJ_2153,Season starts Friday ,21,2442,135554,137996,image,FALSE
CompanyJ_2154,This seasons top defenders ,27,6952,361597,368549,carousel,FALSE
CompanyJ_2155,Memphis' No. 1 recruiting class is ready to go.  No. 1 James Wiseman  No. 14 Precious Achiuwa  No. 37 Boogie Ellis  No. 48 DJ Jeffries  No. 56 Lester Quinones  No. 98 Malcolm Dandridge  No. 108 Damion Baugh (via @br_hoops),222,2320,279087,281407,image,FALSE
CompanyJ_2156,"Ten years ago today, LeBron drained a 3 with .5s left to call game in the ECF ",78,2835,388191,391026,carousel,FALSE
CompanyJ_2157,"16 years later, Kyle Korver never forgot the Nets ""traded"" him for a copy machine (via @creighton1878)",102,2240,531978,534218,video,FALSE
CompanyJ_2158,Had to humble him real quick  (via @branchnout50),49,948,119003,119951,video,FALSE
CompanyJ_2159,Drake causing issues in the series ,35,6521,373197,379718,image,FALSE
CompanyJ_2160,WR Floyd Allen signed with the Texans this week. Unreal story.  Torn ACL ruined D-I chance  Bethany College (NAIA)  Two JUCOs  Quit football  Homeless (slept in car)  Walked on at Ole Miss  Earned scholarship  NFL contract,222,1455,371472,372927,carousel,FALSE
CompanyJ_2161,"Quavo is all in for Trae Young winning ROTY  (via @quavohuncho, @traeyoung)",75,1537,164161,165698,video,FALSE
CompanyJ_2162,"Former summer leaguer and D-II guard Jordan Stevens showed up to a private run where nobody knew who he was.  Cooked everyone in sight (via @ballislife, @jay_smoove23)",167,2179,189686,191865,video,FALSE
CompanyJ_2163,The leagues best of 2018-19,27,11304,588817,600121,image,FALSE
CompanyJ_2164,2nd and 3rd teams ,18,5098,337110,342208,carousel,FALSE
CompanyJ_2165,"Kyle Lowry is rewriting his playoff history in the ECF, says @howardabeck ",74,416,69263,69679,video,FALSE
CompanyJ_2166,The Celtics try everything to solve their chemistry issues ,59,753,182257,183010,video,FALSE
CompanyJ_2167,Klay will miss out on a supermax extension worth $221M over 5 years,67,1833,120741,122574,video,FALSE
CompanyJ_2168,LeBron joins rare company ,26,2723,294949,297672,image,FALSE
CompanyJ_2169,Aaron Rodgers couldnt hang ,27,2462,198310,200772,video,FALSE
CompanyJ_2170,"Daughter of Milwaukee Bucks owner, Mallory Edens, rocking a Pusha T shirt ",74,6832,541301,548133,image,FALSE
CompanyJ_2171,Kawhi's step-back had Drake wildin',35,882,157399,158281,video,FALSE
CompanyJ_2172,This Fun Guy was playing no games in Milwaukee,46,5368,689325,694693,carousel,FALSE
CompanyJ_2173,Raptors did what no other team could tonight.,45,3111,382560,385671,image,FALSE
CompanyJ_2174,Drake wants all the smoke  (via @champagnepapi),47,3016,284207,287223,carousel,FALSE
CompanyJ_2175,"Kawhi Leonard took over Game 5 with 35 PTS, 7 REB & 9 AST to give the Raptors a 3-2 series lead in the ECF",106,1159,207028,208187,video,FALSE
CompanyJ_2176,Bucks to the Finals confirmed ,30,5933,502039,507972,image,FALSE
CompanyJ_2177,Kawhi is built for this ,24,1611,332734,334345,image,FALSE
CompanyJ_2178,Steve Butcher uses his love for basketball to create these unreal tattoo designs ,81,607,80125,80732,video,FALSE
CompanyJ_2179,This Kawhi fake ,16,5561,454861,460422,video,FALSE
CompanyJ_2180,Giannnis is ready to go all out in Game 6,41,8337,495191,503528,image,FALSE
CompanyJ_2181,"While the Bucks and Raptors battle it out, the Warriors are ready for the Finals",80,709,106415,107124,video,FALSE
CompanyJ_2182,Drakes preaching for his childhood team like its Gods Plan,58,1650,153525,155175,video,FALSE
CompanyJ_2183,"HOFer Tracy McGrady was a walking bucket.  Drafted No. 9 in 1997 out of HS  Back-to-back scoring champ, 2002-04  Scored 13 points in 33 seconds  7-time All-Star  Happy 40th Birthday, T-Mac ",189,2190,352903,355093,image,FALSE
CompanyJ_2184,Federer is a magician (via @tennislegend),41,5618,333825,339443,video,FALSE
CompanyJ_2185,The 2019 WNBA season kicks off tonight ,39,12780,403169,415949,image,FALSE
CompanyJ_2186,Dray is still in awe the Warriors wont be seeing the King in the Finals,71,2126,308637,310763,image,FALSE
CompanyJ_2187,"Three years ago today, Thunder annilhilated the Warriors in Game 4 to take a commanding 3-1 lead in the WCF (SWIPE )",116,11709,608779,620488,carousel,FALSE
CompanyJ_2188,#NAME?,51,1068,219267,220335,image,FALSE
CompanyJ_2189,That touch  (via @levisdudiis),30,1010,165171,166181,video,FALSE
CompanyJ_2190,"Dwyane got an ALL-NBA vote, but it wasnt from Gab Union   The whole Wade house voted for Klay (via @dwyanewade)",111,1827,241126,242953,video,FALSE
CompanyJ_2191,"Four pro-bowlers took control in the All-New #BMWUSA #3series, competing for the best football player in the drivers seat.  From, B/R & @BMWUSA #TheUltimateDrive #ad",165,116,29595,29711,video,FALSE
CompanyJ_2192,LeBron became the all-time playoff scoring leader two years ago today,69,4833,533840,538673,carousel,FALSE
CompanyJ_2193,19-year-old Portugal stud Joao Felix met Ronaldo for the first time and his description is on point  (via @brfootball),118,537,155951,156488,image,FALSE
CompanyJ_2194,Drake just wants more life for his Raptors but his sideline antics got the Bucks in their feelings,98,868,101692,102560,video,FALSE
CompanyJ_2195,"""I'm trying to tell the bum to get up and fight."" 54 years ago today, Muhammad Ali had one of the most iconic moments in sports ",128,1777,437715,439492,image,FALSE
CompanyJ_2196,"Brook Lopez credits Raptors' supporting cast after Game 5 loss, says Bucks need the 'Utmost Energy' to extend series  From B/R x Wells Fargo",140,288,47316,47604,video,FALSE
CompanyJ_2197,The audacity  (via @kennysmith),31,4504,497935,502439,image,FALSE
CompanyJ_2198,KAWHI JUST WANTS IT MORE ,25,1087,175253,176340,video,FALSE
CompanyJ_2199,KAWHI ME A RIVER,16,4990,520865,525855,video,FALSE
CompanyJ_2200,A new King in the East. Raptors are going to the NBA Finals!,60,11064,1025512,1036576,image,FALSE
CompanyJ_2201,Kawhi was too much for Giannis this series,42,3461,197264,200725,video,FALSE
CompanyJ_2202,Drake got the last laugh ,25,1840,261217,263057,video,FALSE
CompanyJ_2203,History for The 6ix,19,2125,328382,330507,image,FALSE
CompanyJ_2204,Another Drake-Nurse massage? Kawhi not ,39,1270,210742,212012,video,FALSE
CompanyJ_2205,Nothing but respect ,20,1563,301568,303131,video,FALSE
CompanyJ_2206,Gods Plan ,10,1474,351143,352617,image,FALSE
CompanyJ_2207,Chills,6,2228,528759,530987,carousel,FALSE
CompanyJ_2208,Giannis walked out of his presser after losing ECF in Game 6,60,10069,507873,517942,video,FALSE
CompanyJ_2209,More Life,9,1284,355603,356887,image,FALSE
CompanyJ_2210,VanVleet cant even get on the road  (NSFW) (via @fredvanvleet),62,1003,207456,208459,video,FALSE
CompanyJ_2211,Kawhi took Giannis soul in Game 6,33,2983,267091,270074,video,FALSE
CompanyJ_2212,Fred VanVleet has been lights out since having a son Monday   BEFORE (playoffs): 4 PPG | 25.6 FG % | 19.5 3PT %  SINCE: 16 PPG | 68 FG % | 82.4 3PT %,149,2436,468254,470690,carousel,FALSE
CompanyJ_2213,"Friends, until the engines roar, @juju and @presidentmal compete for bragging rights riding in the All-New #BMWUSA #3series  From, B/R & @BMWUSA #TheUltimateDrive #ad",166,127,36370,36497,video,FALSE
CompanyJ_2214,"Toronto went WILD last night  (via @gauravkapoor08, @ajs2467, @masonrewbury)",76,2524,246353,248877,video,FALSE
CompanyJ_2215,"Kobe missed.  Then Shaq missed.  17 years ago today, Robert Horry saved the Lakers. (via @NBATV)",96,5042,323533,328575,video,FALSE
CompanyJ_2216,"Kawhis on a playoff run for the ages.  31.2 PPG | 8.8 RPG | 50.7 FG%  Raptors first NBA Finals  Iconic buzzer-beater  Helped stop Giannis  7 games with 35+ points  Playoff points leader by 100+  Playoff leader in PTS, FGM, MIN, STL",231,3230,578010,581240,carousel,FALSE
CompanyJ_2217,It's still all love in Milwaukee for Giannis (via @Bucks),57,1292,201718,203010,video,FALSE
CompanyJ_2218,OOOOHH BLOCKED BY JAMES (JR) (via @br_hoops),44,1355,189866,191221,video,FALSE
CompanyJ_2219,@kevinhart4real dominating against his daughter on a 7-foot rim ,64,1602,199985,201587,video,FALSE
CompanyJ_2220,OUT. COLD.  All he saw was  (via @dazn_usa),43,2011,180708,182719,video,FALSE
CompanyJ_2221,14-year-old Gabe Cupps gave LeBron a run for his money in a 3-point shootout  (via @br_hoops),93,1131,145562,146693,video,FALSE
CompanyJ_2222,A lot of trophies on the line ,30,1060,137390,138450,image,FALSE
CompanyJ_2223,This Raptors jersey collection  (via @rsr7n),44,1587,144120,145707,video,FALSE
CompanyJ_2224,Ja Morant has agreed to a multi-year endorsement deal with Nike. @brkicks,73,1781,459353,461134,image,FALSE
CompanyJ_2225,"A year ago today, 20-year-old Jayson Tatum threw down a poster on one of his childhood idols. Still wild.",105,5196,577349,582545,carousel,FALSE
CompanyJ_2226,This kid in Bangkok helps raise money for school by juggling a toilet paper roll in the street  (via @chrismdwyer) @brfootball,126,1018,105900,106918,video,FALSE
CompanyJ_2227,Priorities ,11,2647,407283,409930,image,FALSE
CompanyJ_2228, The Champions: Season 2 Finale  (via @brfootball),50,516,117366,117882,video,FALSE
CompanyJ_2229,"In 2014, a young Kawhi (22) won Finals MVP and kept the Heat from their third straight championship.  Five years later, hes trying to stop another three-peat. (via @nbatv)",171,3503,566532,570035,carousel,FALSE
CompanyJ_2230,LeBron and TT living their best lives  *NSFW* (via @djmeel),59,1611,160042,161653,video,FALSE
CompanyJ_2231,Security footage caught @stevenash running down the hallway after Tottenhams semifinal comeback ,96,1012,181263,182275,video,FALSE
CompanyJ_2232,"Three years ago today, Klay put on an all-time shooting clinic in Game 6 to save the Warriors in the WCF ",105,861,98158,99019,video,FALSE
CompanyJ_2233,RJ Hampton is bypassing college to hoop professionally overseas (@br_hoops),75,1863,233283,235146,image,FALSE
CompanyJ_2234,Last time Kawhi saw Golden State in the playoffs (2017):  26 PTS in 24 MIN  Spurs had 23-point lead  Landed on Zazas foot and hurt ankle  Warriors came back and swept,166,1877,280905,282782,carousel,FALSE
CompanyJ_2235,"Ron Artest, Elton Brand and Lamar Odom went 69-1 in the summer of 1996 ",71,1068,167375,168443,video,FALSE
CompanyJ_2236,Turn is FILTHY  (via @brfootball),33,2753,185629,188382,video,FALSE
CompanyJ_2237,"Rob Pelinka allegedly made up a story about Kobe having dinner with Heath Ledger after seeing The Dark Knight to study how he locks in for a role, per @baxter  Ledger died six months before the movie came out.",209,5775,365502,371277,image,FALSE
CompanyJ_2238,Bronny James (@bronny) just hit 1M followers in less than 24 hours   The heir to the throne is ready to dominate (via @br_hoops),128,1550,201163,202713,video,FALSE
CompanyJ_2239,@terrellowens vs. @deandrehopkins? Yup.  Who will back up the talk with performance in the All-New #3series?  #TheUltimateDrive From B/R & @BMWUSA #BMWUSA #ad,158,170,42888,43058,video,FALSE
CompanyJ_2240,Hand to Kawhi.  Danny Greens coming into the Finals with a new Thrones piece  (Via @diamondboi),95,1366,152214,153580,video,FALSE
CompanyJ_2241,The technology in #BMWUSAs All-New #3series calls for #TheUltimateDrive challenge  Four pro bowlers. 2 races. 1 winner. Check back tomorrow.   From B/R & @BMWUSA #ad,165,110,20021,20131,video,TRUE
CompanyJ_2242,The photographer will never forget this first pitch  (via @mlbcut4),67,2082,138376,140458,video,FALSE
CompanyJ_2243,You already know what day it is in the James household  (via @KingJames),72,4569,297316,301885,video,FALSE
CompanyJ_2244,Kawhi. Steph. Draymond.  Who will be the x-factor of the NBA Finals?,68,27,1840,1867,video,FALSE
CompanyJ_2245,Shooters shoot   Get buckets in the 6ix and by the Bay  Play Shoot Your Shot now  (link in bio),95,143,22630,22773,video,FALSE
CompanyJ_2246,"Jordan Harold campaigned for a roster spot outside the Panthers training facility by saying he would ""pass rush for hot wings"" (via @willkunkel)",144,304,54548,54852,video,FALSE
CompanyJ_2247,DeMar still has love for the Raptors ,37,1886,407419,409305,image,FALSE
CompanyJ_2248,SS/RP Bobby Witt Jr. wins @Gatorade National Baseball Player of the Year  .500 BA  15 HR  54 RBI,96,204,24369,24573,video,FALSE
CompanyJ_2249,Klay looking to take care of business ,38,2398,264801,267199,image,FALSE
CompanyJ_2250,Randy Moss and Primetime want all the smoke in any 2v2  (via @deionsanders),75,1249,113737,114986,video,FALSE
CompanyJ_2251,Eden Hazard after Chelseas Europa League win: I think this is goodbye  (via @brfootball),88,1328,141658,142986,image,FALSE
CompanyJ_2252,A winners mentality ,20,2207,261187,263394,image,FALSE
CompanyJ_2253,DSJ thought we paired him with a world renowned trainer but he was Just OK ,75,606,95062,95668,video,FALSE
CompanyJ_2254,"Bronny James and Zaire Wade will both play at Sierra Canyon High School next season, per Tarek Fattal  x  (via @br_hoops)",121,10713,812551,823264,image,FALSE
CompanyJ_2255,The takeover.  x (via @br_hoops),32,1786,413214,415000,image,FALSE
CompanyJ_2256,"10 years ago today, the Magic eliminated the Cavs in the ECF. Closest we got to LeBron vs. Kobe in the Finals... (via @nbahistory)",130,2452,300332,302784,carousel,FALSE
CompanyJ_2257,Metta never held back ,22,1345,273808,275153,image,FALSE
CompanyJ_2258,LeBron will be a Finals spectator for the first time in nearly a decade.,72,1448,130953,132401,video,FALSE
CompanyJ_2259,"DeMarcus Cousins (quad) will be active to play for Game 1, per @shamsnba",72,6262,392580,398842,image,FALSE
CompanyJ_2260,Will the Warriors continue their dynasty or will the Raptors be crowned as new champions?  Heres what you missed  #ControlTheGame,129,248,50027,50275,video,FALSE
CompanyJ_2261,D-Wade chugging wine on the water in Greece. Retirement life  (via @dwyanewade),79,1831,188099,189930,video,FALSE
CompanyJ_2262,Juwan Howard cried tears of joy in his return to Michigan  (via @umichbball),76,2564,350725,353289,carousel,FALSE
CompanyJ_2263,#NAME?,86,430,55726,56156,video,FALSE
CompanyJ_2264,"Warriors will secure their place among the GOAT dynasties if they win the NBA Finals, says @howardabeck",103,570,66140,66710,video,FALSE
CompanyJ_2265,The road to a championship continues tonight in Toronto ,56,385,64464,64849,video,FALSE
CompanyJ_2266,Oakland is ready for another championship run ,46,365,51197,51562,video,FALSE
CompanyJ_2267,"Warriors-Raptors players have got a fit off all playoffs, but who's had the most refined looks? (Via @brkicks)",110,155,38744,38899,video,FALSE
CompanyJ_2268,The Warriors are 4 wins away from reaching a 3-Peat. Will they make it to the top?,82,773,88552,89325,video,FALSE
CompanyJ_2269,The Finals MVP will be won by ______________? ,46,1234,75627,76861,video,FALSE
CompanyJ_2270,Drake is repping the OG Curry for Game 1 ,41,1427,192033,193460,video,FALSE
CompanyJ_2271,Drake's troll game leveled up for the Finals ,45,4006,682082,686088,image,FALSE
CompanyJ_2272, Paul Pierce sucks  Pierce egged on Raptors fans at Game 1  (via @ben.golliver),79,1820,217321,219141,video,FALSE
CompanyJ_2273,Drake and E40 not in the studio anymore  (via @e40),51,1599,366918,368517,image,FALSE
CompanyJ_2274,Greatest shooter ever ,22,1780,234458,236238,image,FALSE
CompanyJ_2275,Spicy P takes over in Game 1 as the Raptors secure their first Finals win in franchise history!,95,7283,742589,749872,image,FALSE
CompanyJ_2276,"Drake called Dray ""trash"" immediately after the game ",53,16804,661160,677964,video,FALSE
CompanyJ_2277,"""Warriors are better without KD!"" KD:",37,2820,254483,257303,video,FALSE
CompanyJ_2278,Warriors couldnt get past Spicy P  in Game 1,44,689,88223,88912,video,FALSE
CompanyJ_2279,"Spicy P played like an NBA Finals veteran: Siakam posted 32 PTS, 8 REB, 5 AST, 2 BLK and shot 14/17 from the field to lead the Toronto Raptors to a 1-0 series lead.",164,1124,212038,213162,video,FALSE
CompanyJ_2280,Drake-carys,11,2992,391753,394745,image,FALSE
CompanyJ_2281,Somebody take @champagnepapi's phone ,37,1703,202022,203725,image,FALSE
CompanyJ_2282,Pascal is doing it all for his father ,38,1627,410115,411742,image,FALSE
CompanyJ_2283,One of the most viral moments in Finals historyJR Smiths Game 1 blunder is still wild a year later ,99,1305,132155,133460,video,FALSE
CompanyJ_2284,Spicy P was too much for Golden State in Game 1 ,48,3968,398475,402443,video,FALSE
CompanyJ_2285,Looks like Kawhi did not want to make eye contact with the Raptors mascot ,74,7141,411812,418953,video,FALSE
CompanyJ_2286,"What a time to be alive  Toronto in their first NBA Finals, Tottenham in their first UCL Final (via @brfootball)",112,1954,323270,325224,image,FALSE
CompanyJ_2287,Mamba Mentality.,16,1788,298966,300754,image,FALSE
CompanyJ_2288,Dray knows its Warriors vs. everyone.,37,9099,411122,420221,image,FALSE
CompanyJ_2289,DSJ stays locked in by connecting with close friends and eating well on the road ,81,273,50367,50640,video,FALSE
CompanyJ_2290,Tottenham vs. Liverpool  Who's winning it all?,46,272,26532,26804,video,FALSE
CompanyJ_2291,Dray really walking around Toronto in a Drake hoodie  (via @money23green),73,3545,321083,324628,video,FALSE
CompanyJ_2292,Shes here  Liz Cambage makes her Aces debut in Phoenix against the Mercury tonight,82,4161,207416,211577,image,FALSE
CompanyJ_2293,Giannis too big for the rides at Disney  (via @nick_razz),57,4455,605775,610230,video,FALSE
CompanyJ_2294,"Salah, Firmino and Dele Alli have been bringing the heat  (From B/R Football x adidas soccer)",93,114,24604,24718,video,FALSE
CompanyJ_2295,"Big game, big fans for the Champions League final  (via @brfootball)",68,626,152023,152649,image,FALSE
CompanyJ_2296,@DeAndreHopkins was chirping @terrellowens the whole time at #TheUltimateDrive with #BMWUSA  #ad,96,200,68527,68727,video,FALSE
CompanyJ_2297,"Mo Salah puts Liverpool ahead in under TWO MINUTES, a year after leaving the Champions League final injured ",108,457,64375,64832,video,FALSE
CompanyJ_2298,GOT EM,6,245,36818,37063,video,FALSE
CompanyJ_2299,LIVERPOOL WINS THE 2019 CHAMPIONS LEAGUE! ,42,1066,133744,134810,image,FALSE
CompanyJ_2300,Winner vs. Barcelona then a dagger in the final ,48,322,54151,54473,video,FALSE
CompanyJ_2301,LIVERPOOL'S FIRST EUROPEAN TROPHY IN 14 YEARS ,46,1066,159926,160992,video,FALSE
CompanyJ_2302,Deja Vu  (via @brfootball),26,2889,378547,381436,image,FALSE
CompanyJ_2303,Captain Jordan Henderson with his dad after Liverpools win  (via @brfootball),77,543,103369,103912,video,FALSE
CompanyJ_2304,D-Wade couldnt get in Gabs head  *NSFW* (via @dwyanewade),57,2098,300652,302750,video,FALSE
CompanyJ_2305,Andy Ruiz did the unthinkable vs. Anthony Joshua last night  (via @boymeetsworld),81,2498,328430,330928,video,FALSE
CompanyJ_2306,Andy Ruiz Jr. became the first Mexican heavyweight champ ever last night  Victory over Anthony Joshua was one of the biggest upsets since Tyson/Douglas (+1200),159,4559,508342,512901,image,FALSE
CompanyJ_2307,"D-Wade surprised everyone at Marjory Stoneman Douglas High Schools graduation today   Last year, he met with students after the tragic shooting. One fallen student was buried in his Heat jersey, so Flash wrote his name on his shoes. That night: Game-winner. (via @ashhankash, @miamiheat)",287,885,366099,366984,carousel,FALSE
CompanyJ_2308,Warriors gotta pull out all the stops to avoid going down 2-0,61,2259,371042,373301,image,FALSE
CompanyJ_2309,Prez  Commish,13,3899,441524,445423,image,FALSE
CompanyJ_2310,Wheres Kevin?,13,3589,389616,393205,image,FALSE
CompanyJ_2311,Toronto gave Obama a standing O and an MVP chant  (via @taylorrooks),68,3033,202721,205754,video,FALSE
CompanyJ_2312,Curry drops 23 and the Warriors tie the series 1-1.,51,8986,449009,457995,image,FALSE
CompanyJ_2313,Andre Iguodala Game 2 dagger   Series tied at 1-1,49,1547,115141,116688,video,FALSE
CompanyJ_2314,Game 1 vs. Game 2,17,8413,670143,678556,image,FALSE
CompanyJ_2315,Iguodala came up clutch again,29,3023,328647,331670,image,FALSE
CompanyJ_2316,True Warrior,12,1345,328771,330116,image,FALSE
CompanyJ_2317,Kawhi with another priceless postgame answer ,45,2962,410430,413392,video,FALSE
CompanyJ_2318,ZLATAN GONNA ZLATAN  (via @mls),31,1812,179341,181153,video,FALSE
CompanyJ_2319,27 years ago today:  (via @NBATV),33,1530,143001,144531,video,FALSE
CompanyJ_2320, ( swipe),9,2657,293494,296151,carousel,FALSE
CompanyJ_2321,Iguodala has Stephs back ,25,4233,389133,393366,image,FALSE
CompanyJ_2322,"Three years ago today, we lost Muhammad Ali.  56-5 record  Olympic gold medalist  First 3x heavyweight champ  Worldwide activist  More than an athlete",150,1542,279806,281348,carousel,FALSE
CompanyJ_2323,The details on this full-leg LeBron tattoo  (via @ustinovatattoo),65,6867,419778,426645,carousel,FALSE
CompanyJ_2324,@demar_derozan reflects on his friendship with Nipsey Hussle and says the two had dinner 2-3 weeks before the LA rappers tragic death ,134,351,99002,99353,video,FALSE
CompanyJ_2325,Respect ,8,1623,300670,302293,image,FALSE
CompanyJ_2326,"This kids date broke up with him before prom so he hit up @juju to go  (via @anthony_m099, @wpxi)",97,6171,558004,564175,carousel,FALSE
CompanyJ_2327,"Breaking: @kawhileonard has filed a federal lawsuit against Nike. He claims he designed the logo that appeared on his apparel and Nike copyrighted the logo without his consent, per matthewkish/Twitter (via @brkicks)",215,4310,492786,497096,image,FALSE
CompanyJ_2328,"BryantTO SHAQ!!!  19 years ago today, the Lakers dynasty reached their first Finals together with an iconic lob in Game 7",121,1686,376055,377741,carousel,FALSE
CompanyJ_2329,Aaron Donald is a cheat code. Unfair hand speed  (via Jon Heath/Broncos Wire),77,3283,468565,471848,video,FALSE
CompanyJ_2330,Spurs star @demar_derozan says hes still rooting for the Raptors these Finals but explains why he was hurt when the trade went down. Season finale of Take It There with @TaylorRooks,181,967,157709,158676,video,FALSE
CompanyJ_2331,Salah changing the world  (via @brfootball),43,1721,182809,184530,image,FALSE
CompanyJ_2332,Steph wishes he would've handled things differently,51,2708,194832,197540,video,FALSE
CompanyJ_2333,"Pelicans have begun listening to teams about potential Anthony Davis deals, per @shamsnba",89,10418,443449,453867,image,FALSE
CompanyJ_2334,"@Raptors said ""Hang this in the Louvre"" and she really did (via @athinavandame)",79,654,166376,167030,video,FALSE
CompanyJ_2335,JuJu pulled up to prom and everyone chanted F--k AB ,52,1319,148933,150252,video,FALSE
CompanyJ_2336,Kobe and the Lakers Youth Foundation donated his Wizenard book to LeBron's @ipromiseschool ,91,1431,351421,352852,image,FALSE
CompanyJ_2337,Serena Williams is the first athlete to make Forbes Richest Self-Made Women list ,81,964,178670,179634,image,FALSE
CompanyJ_2338,Iggy was the hero in Game 2. Who will step up in Game 3?,56,2348,227648,229996,video,FALSE
CompanyJ_2339,"On this day in 1991, Jordan switched hands midair  (via @nbatv)",63,2191,200123,202314,video,FALSE
CompanyJ_2340,"In Game 1 of 2008 Finals, Paul Pierce came back in the 3Q after being carried out in a wheelchair... the rest is history",120,3676,156283,159959,video,FALSE
CompanyJ_2341,D-Rose not holding back ,24,4667,350712,355379,image,FALSE
CompanyJ_2342,Kyrie went home and reminisced with his childhood crossing guard  (via @kyrieirving),84,1227,325729,326956,video,FALSE
CompanyJ_2343,Breaking: Vince Carter announces next season will be his last,61,3313,301795,305108,image,FALSE
CompanyJ_2344,This free-kick from Ronaldo   (via @daniielmrodrigues) @brfootball,66,1225,157963,159188,video,FALSE
CompanyJ_2345,Son ran on the court to hug his dad after seeing him cry in a loss at the French Open. Respect. (via @eurosport),112,2229,349660,351889,video,FALSE
CompanyJ_2346,This Raiders janitor went OFF  (via @thejabram / @lefkoeshow),61,3176,307776,310952,video,FALSE
CompanyJ_2347,Warriors bumping Pushas Story of Adidon pregame  (via @bsotv),61,2770,181858,184628,video,FALSE
CompanyJ_2348,Klay has been ruled out for Game 3.,35,2376,355076,357452,image,FALSE
CompanyJ_2349,Kawhi couldnt be more locked in for Game 3 (via @yahoosportsca),63,4757,283854,288611,video,FALSE
CompanyJ_2350,?,1,7458,401519,408977,image,FALSE
CompanyJ_2351,Steph has 47 and the Warriors are still down...,47,9617,584915,594532,image,FALSE
CompanyJ_2352,Kawhi leads the Raptors to a 2-1 series lead in the NBA Finals,62,3041,240138,243179,video,FALSE
CompanyJ_2353,Steph drops a playoff career-high 47 PTS and its still not enough.,66,2231,212337,214568,image,FALSE
CompanyJ_2354,6ix years later.  Danny Green still money in the #NBAFinals ,60,2050,447748,449798,carousel,TRUE
CompanyJ_2355,"Fun guy, mean dunk.",19,920,105669,106589,video,FALSE
CompanyJ_2356,Steph Curry did all he could in against the Raptors despite the loss,68,1359,196798,198157,video,FALSE
CompanyJ_2357,Crazy what can change in a year,31,2767,256859,259626,image,FALSE
CompanyJ_2358,Dray aint worried at all.,25,5032,314673,319705,image,FALSE
CompanyJ_2359,"18 years ago today, Iverson dropped 48 on the Lakers and stepped over T-Lue.  Iconic.",85,1212,228641,229853,carousel,FALSE
CompanyJ_2360,Kyle Lowry didnt appreciate what happened in Game 3,51,2596,151932,154528,video,FALSE
CompanyJ_2361,Steph learned last night: it takes more than one (via @brfootball),66,6632,490720,497352,image,FALSE
CompanyJ_2362,"Kawhi watched Jordan highlights for 4-5 hours at a time and snuck his phone into team dinners to have them on, per a San Diego State manager.  He called them Mike highs. (via @theathletichq)",190,3192,495286,498478,image,FALSE
CompanyJ_2363,Breaking: KD (calf) is OUT for Game 4 of the NBA Finals,55,13723,545287,559010,image,FALSE
CompanyJ_2364,Patrick Beverley tries to lure KD to the Clippers. A new king is crowned in the East. Watch the #GameOfZones finale ,116,2294,277278,279572,video,FALSE
CompanyJ_2365,Fitzmagic pulling out the Mahomes no-look dime (via @miamidolphins),67,1139,130644,131783,video,FALSE
CompanyJ_2366,"Carson Wentz agrees to a 4-year extension with the Eagles, per @caplannfl",73,2156,215977,218133,image,FALSE
CompanyJ_2367,"6 years ago today, Tony Parker silenced South Beach with an incredible bank shot over Bron to steal Game 1 (via @nba)",117,3009,427235,430244,carousel,FALSE
CompanyJ_2368,Vince gonna be dunking when hes 60 (via @nbatv),47,1527,221173,222700,video,FALSE
CompanyJ_2369,On his way to get  (via @gisele),32,2821,256488,259309,video,FALSE
CompanyJ_2370,"Seven years ago today, @kingjames destroyed the Celtics in Game 6 with his legacy on the line (45 PTS | 19-26 FG | 15 REB | 5 AST)",130,3689,253962,257651,video,FALSE
CompanyJ_2371,"Klay, Kawhi or Steph  Who you got deciding Game 4 of the Finals?",64,9,1782,1791,video,FALSE
CompanyJ_2372,Brons offseason on social is the vibe everybody needs to be on,62,870,168453,169323,video,FALSE
CompanyJ_2373,BREAKING: Eden Hazard officially joins Real Madrid on a deal until 2024 (via @brfootball),89,3070,279965,283035,image,FALSE
CompanyJ_2374,First day of the @fifawomensworldcup  (via @brfootball),55,526,79733,80259,image,FALSE
CompanyJ_2375,Warriors Game 4 mood ,21,4696,278533,283229,video,FALSE
CompanyJ_2376,"Cleveland, this is for you ",27,1728,400680,402408,image,FALSE
CompanyJ_2377,Board Man gets paid!  Kawhi drops 36 PTS as the Raptors take a commanding 3-1 series lead in the NBA Finals!,108,9240,775569,784809,image,FALSE
CompanyJ_2378,Kawhi was a PROBLEM in Game 4 ,30,2646,471203,473849,carousel,FALSE
CompanyJ_2379,Drake was ALL HYPE after Toronto took Game 4  *NSFW* (via @champagnepapi),73,3423,215149,218572,video,FALSE
CompanyJ_2380,Fred VanVleet chipped a tooth after a nasty elbow in Game 4...,62,1735,186901,188636,video,FALSE
CompanyJ_2381,Will they?,10,11299,461464,472763,image,FALSE
CompanyJ_2382,"Kawhi Leonard continued his dominance in the NBA Finals, dropping 36 PTS, 12 REB, 4 STL in Game 4. The Toronto Raptors now hold a 3-1 series lead.",146,1876,346296,348172,video,FALSE
CompanyJ_2383,"After taking a 3-1 lead, Kawhis goal remains simple: play to win ",65,1504,191996,193500,video,FALSE
CompanyJ_2384,FIFA 20 taking it back to the street  (via @brfootball),55,1784,120620,122404,image,FALSE
CompanyJ_2385,The young Lakers learned the hard way that playing with your idols doesnt always go as planned,94,3833,416528,420361,image,FALSE
CompanyJ_2386,Too quick with it  (via @brfootball),36,2442,185947,188389,video,FALSE
CompanyJ_2387,Last time a team came back from down 3-1 in the finals...,57,5359,433546,438905,video,FALSE
CompanyJ_2388,GGG put him to SLEEP  (via @mistabless),39,766,108592,109358,video,FALSE
CompanyJ_2389,LaMelo pulled out the step-back 3 in his Drew League debut  (via @br_hoops),75,3408,376093,379501,video,FALSE
CompanyJ_2390,"Four years ago today, Bron dropped 40 and carried the Cavs to a 2-1 lead on the Warriors  They didnt have Love/Kyrie, and their second-leading scorer was Delly (20)",164,7202,633515,640717,carousel,FALSE
CompanyJ_2391,Formiga is 41 years old and in her SEVENTH World Cup  (via @brfootball),71,1111,155608,156719,image,FALSE
CompanyJ_2392,KD BACK!? No. 35 (calf) is cleared to practice ahead of Game 5 Monday.,70,20574,730060,750634,image,FALSE
CompanyJ_2393,Klays laugh ,12,3883,248101,251984,video,FALSE
CompanyJ_2394,Kawhi leads the 2019 playoffs in:  Minutes  Points (by over 100)  Rebounds  Steals  Field goals  Free throws,108,3171,528855,532026,carousel,FALSE
CompanyJ_2395,Nations League  Another trophy for Ronaldo (via @brfootball),60,967,170402,171369,image,FALSE
CompanyJ_2396,Dejounte Murray's little brother graduated and made honor roll so he bought him a car  (via @dejountemurray),108,5246,772939,778185,carousel,FALSE
CompanyJ_2397,"David Ortiz hospitalized after being shot in Dominican Republic during an apparent robbery, per @cdn37",102,11937,516115,528052,image,FALSE
CompanyJ_2398,Kyle Lowry explains what real pressure is. Powerful ,52,1383,188142,189525,video,FALSE
CompanyJ_2399,Kawhi is on fire. KD might be coming back. Can the Warriors come back from 3-1?,79,15,1469,1484,video,FALSE
CompanyJ_2400,Players send David Ortiz's love as he recovers in intensive care ,65,356,83525,83881,video,FALSE
CompanyJ_2401,"Breaking: Tony Parker is retiring from the NBA after 18 seasons, per @marcjspears",81,3116,467743,470859,image,FALSE
CompanyJ_2402,This chapter is officially closed.,34,2999,526595,529594,carousel,FALSE
CompanyJ_2403,KDs on the verge of changing the NBA Finals,43,2187,135756,137943,video,FALSE
CompanyJ_2404,Tierna Davidson knows the secret to a winning mindset when shes on the road ,76,194,21302,21496,video,FALSE
CompanyJ_2405,"KD IS BACK. Durant plans to play in Game 5 tonight, per @wojespn",64,8516,423638,432154,image,FALSE
CompanyJ_2406,"Teamwork  (via @hikki10, h/t @brfootball)",41,1345,174518,175863,video,FALSE
CompanyJ_2407,From @tissot.us  x B/R,22,138,48442,48580,video,FALSE
CompanyJ_2408,"Lakers and Knicks are ADs two desired long-term destinations, per @shamsnba",75,3248,305518,308766,image,FALSE
CompanyJ_2409,No compromises for Kawhi,24,1565,336745,338310,image,FALSE
CompanyJ_2410,KD has exited Game 5 in the 2Q with an apparent lower leg injury. Prayers up ,77,21675,797668,819343,image,FALSE
CompanyJ_2411,Heart of a Champion!  Steph drops 31 PTS & the Warriors push the NBA Finals to a Game 6!,88,11075,601886,612961,image,FALSE
CompanyJ_2412,Finals Klay gets it done  ( @coorslight),40,1526,121636,123162,video,FALSE
CompanyJ_2413,The Splash Bros send the Finals back to The Bay ,48,1666,300492,302158,carousel,FALSE
CompanyJ_2414,More than a game. Drake showed love to KD after his injury.,59,3098,338774,341872,video,FALSE
CompanyJ_2415,Kevin Durant has an Achilles injury. Players around the NBA showed their support ,81,1221,162837,164058,video,FALSE
CompanyJ_2416,Keep your head up @easymoneysniper,34,2210,339926,342136,image,FALSE
CompanyJ_2417,"Bob Myers fighting back tears talking about KD's injury: I dont believe theres anyone to blameif you have to, you can blame me."" (via @nbatv)",141,4847,232885,237732,video,FALSE
CompanyJ_2418,22 years ago today: MJs Flu Game,32,4871,574907,579778,carousel,FALSE
CompanyJ_2419,#NAME?,18,1570,156236,157806,carousel,FALSE
CompanyJ_2420, (via @brfootball),18,6217,340800,347017,image,FALSE
CompanyJ_2421,Drake leaving like he just played 40 minutes  (via @tsn_official),65,6157,436544,442701,video,FALSE
CompanyJ_2422,And make sure you remember the Jr. in his name.,47,873,254201,255074,video,FALSE
CompanyJ_2423,Giannis and his brother had to hit the woah after their workout  (via @giannis_an34),84,6578,434866,441444,video,FALSE
CompanyJ_2424,Alex Morgan scores FIVE goals in the USWNTs opening World Cup match  (via @brfootball),86,606,63897,64503,video,FALSE
CompanyJ_2425,13-0. HISTORIC.,15,1941,190244,192185,image,FALSE
CompanyJ_2426,The Lakers are GIGANTIC favorites to get Anthony Davis  (via @br_betting),73,2359,220716,223075,image,FALSE
CompanyJ_2427,"AB and the Raiders will be the team featured on this season of ""Hard Knocks"" ",77,1845,235995,237840,image,FALSE
CompanyJ_2428,She stared JuJu down before megging him  (via @juju),52,2034,246845,248879,video,FALSE
CompanyJ_2429,Kobe and Metta targeted specific players to bully game-to-game: We had fun doing that ,86,603,132257,132860,video,FALSE
CompanyJ_2430,"On this day in 1991, Michael Jordan won his first title at 28.  Beat childhood hero, Magic  No one can ever take this away from me",130,1801,286807,288608,carousel,FALSE
CompanyJ_2431,"Kyrie will not opt into player-option for next season, will become unrestricted free agent, per @shamsnba",105,9563,507008,516571,image,FALSE
CompanyJ_2432,"Two years ago today, @easymoneysniper won his first NBA title and Finals MVP  Get well soon, KD ",96,4630,531220,535850,carousel,FALSE
CompanyJ_2433,"Breaking: KD confirms hes torn his Achilles: Surgery was today and it was a success, EASY MONEY",95,7850,751358,759208,carousel,FALSE
CompanyJ_2434,KD just wanted to hoop,22,1045,179693,180738,image,FALSE
CompanyJ_2435,"11-year-old Laila Anderson is a Blues superfan. She has a rare immune disease that's kept her mostly homebound.  Tonight, she gets to go to Game 7 of the Stanley Cup Final ",172,383,53647,54030,video,FALSE
CompanyJ_2436,"Kyrie Irving expected to sign with ROC Nation Sports ahead of free agency, per @wojespn",87,3424,394563,397987,image,FALSE
CompanyJ_2437,Jim had a special message for Pam ahead of Game 7  (via @johnkrasinski),71,3455,279878,283333,video,FALSE
CompanyJ_2438,Blues win first Stanley Cup in 52-year history with 4-1 victory over Bruins in Game 7 ,86,2845,270269,273114,image,FALSE
CompanyJ_2439,"8 years ago today, Dirk and the Mavs upset the Heat to capture their first title. Nowitzki averaged 26 PTS, 10 REB & 2 AST to win Finals MVP",140,4083,465273,469356,carousel,FALSE
CompanyJ_2440,Nothing sweeter than this. 11-year-old Blues superfan Laila Anderson celebrates St. Louis 1st Stanley Cup ,106,839,218001,218840,image,FALSE
CompanyJ_2441,Koepka or Tiger? Both have a strong chance to take down the US Open,67,174,30405,30579,video,FALSE
CompanyJ_2442,Respect to Kawhi,16,1794,357398,359192,image,FALSE
CompanyJ_2443,@iambarondavis mean poster on AK-47 is one of the best moments in Oracles history,81,2395,239292,241687,video,FALSE
CompanyJ_2444,Real teammates ,15,1276,306158,307434,image,FALSE
CompanyJ_2445,June 13 will be remembered as the start of the most epic Finals comeback ,73,8154,874052,882206,carousel,FALSE
CompanyJ_2446,"Kyrie is prepared to sign with the Brooklyn Nets this offseason, per Steve Bulpett",82,12150,494351,506501,image,FALSE
CompanyJ_2447,Warriors need Game 6 Klay tonight.  2016 vs. OKC 41 PTS 14-31 11-18 3PT W  2018 vs. HOU 35 PTS 13-23 9-14 3PT W,111,1806,306742,308548,carousel,FALSE
CompanyJ_2448,Warriors honoring Oracle and KD for their final home game ,58,2185,386145,388330,image,FALSE
CompanyJ_2449,Klay has passed LeBron to become No. 3 on the all-time playoff threes list ,75,2896,469820,472716,image,FALSE
CompanyJ_2450,Raptors win their first NBA title in franchise history!,55,16634,1108662,1125296,image,FALSE
CompanyJ_2451,The Drake curse is over  ,25,5329,586903,592232,image,FALSE
CompanyJ_2452,Klay was carried off the court after an awkward landing and knee injury. He came back in and drilled two FTs ,109,1415,144734,146149,video,FALSE
CompanyJ_2453,Mood in Toronto ,16,9896,548038,557934,video,FALSE
CompanyJ_2454,Kawhi stops another potential 3-peat for the second time this decade ,69,3265,445261,448526,image,FALSE
CompanyJ_2455,Drake been waiting a long time for this feeling  (via @tsn_official),68,1107,130042,131149,video,FALSE
CompanyJ_2456,Kawhi becomes the third player to win Finals MVP with two different teams.,74,2191,540804,542995,image,FALSE
CompanyJ_2457,Spicy P and the Raptors closed out the Finals at Oracles last game ,67,533,90808,91341,video,FALSE
CompanyJ_2458,VanVleet stepped up when it mattered most ,42,2730,484339,487069,image,FALSE
CompanyJ_2459,FUN GUY    (via @NBA),21,1661,256288,257949,video,FALSE
CompanyJ_2460,Aubrey hype ,12,1989,414993,416982,image,FALSE
CompanyJ_2461,"Breaking: Klay Thompson suffered a torn ACL in Game 6, per @wojespn",67,19802,676968,696770,image,FALSE
CompanyJ_2462,Kawhis coming back North with an NBA trophy for Toronto,55,747,265412,266159,image,FALSE
CompanyJ_2463,The Klaw never lost faith,25,2433,493587,496020,image,FALSE
CompanyJ_2464,The Gasol family makes history ,31,2847,653980,656827,image,FALSE
CompanyJ_2465,Steph and Dray are confident in the Dubs future.,48,5939,440496,446435,image,FALSE
CompanyJ_2466,Kawhi dancing to the sounds of victory  (via @tsn_official),59,1387,174720,176107,video,FALSE
CompanyJ_2467,Drizzy got jokes  (via @champagnepapi),38,1518,198633,200151,video,FALSE
CompanyJ_2468,Kawhi needs to frame this,25,1932,538311,540243,image,FALSE
CompanyJ_2469,"Fred VanVleets story just got even better.  Went from: Wichita State stud Final Four Too small (6'0"") Undrafted 4th-string PG  To: NBA champion Key shooter and defender $18M extension",183,4958,773985,778943,image,FALSE
CompanyJ_2470,We really might get a season without these two next year. Brutal.,65,5893,494234,500127,image,FALSE
CompanyJ_2471,Jeremy Lin is an NBA Champion ,30,11329,752111,763440,image,FALSE
CompanyJ_2472,Lakers are already favorites for the chip next season  (via @br_betting),72,9951,360529,370480,image,FALSE
CompanyJ_2473,Still the last team to three-peat ,34,4068,486076,490144,image,FALSE
CompanyJ_2474,The city of Toronto has one mission this summer: re-sign Kawhi,62,1269,130872,132141,video,FALSE
CompanyJ_2475,"Klay Thompsons father Mychal says there is no question he will re-sign this summer, per @con_chron",98,2848,342953,345801,image,FALSE
CompanyJ_2476,@stevenashs footwork:   @brfootball x @stevenashfdn Showdown: 6/19 at 6 PM in NYC. Open to the public,101,363,54362,54725,video,FALSE
CompanyJ_2477,Game 6ix was cinematic ,23,932,267459,268391,image,FALSE
CompanyJ_2478,"10 years ago today, Kobe won his 4th title and 1st without Shaq ",64,2918,430422,433340,carousel,FALSE
CompanyJ_2479,"Nets highly unlikely to keep DAngelo Russell if they sign Kyrie Irving, per Ian Begley",86,21840,591106,612946,image,FALSE
CompanyJ_2480, LeBron  Russ  CP3  Squad came through for Liberty vs. Aces (via @wnba),71,1605,237611,239216,video,FALSE
CompanyJ_2481,Not everyone is down with new Drake music ,42,3688,380296,383984,video,FALSE
CompanyJ_2482,"Reef looking healthy, dunking on his little brother  (via @cporter_, @br_hoops)",79,1570,342388,343958,video,FALSE
CompanyJ_2483,Today marks five years since the Klaw stopped his first three-peat   Finals MVP: 17.8PPG/ 6.4 RPG/1.6 SPG  Spurs Big 3 last Finals appearance  LeBrons last year in Miami,169,1802,474437,476239,carousel,FALSE
CompanyJ_2484,Trae Young got caught doing the most  (via @spidadmitchell),59,1773,362222,363995,video,FALSE
CompanyJ_2485,A King and a Prince  (via @k.mbappe),36,809,209233,210042,image,FALSE
CompanyJ_2486,"Like father, like son. Bronny hitting game-winners  (via @br_hoops, @ballingonthebeach) #BallingOnTheBeach",106,1177,149012,150189,video,TRUE
CompanyJ_2487,He got Kawhi's celebration tatted  (via @jtattoos),50,1703,247399,249102,carousel,FALSE
CompanyJ_2488,"Breaking: Anthony Davis is headed to the Lakers for Lonzo Ball, Brandon Ingram, Josh Hart and 3 1st round picks, including No. 4 overall pick in 2019 draft, per @wojespn",169,48528,1368541,1417069,image,FALSE
CompanyJ_2489,AD becomes the next star big man for the Lakers,47,10680,786877,797557,image,FALSE
CompanyJ_2490,L.A. MOOD ,10,1784,237636,239420,video,FALSE
CompanyJ_2491,Lonzos time in L.A. is over ,28,24789,666776,691565,video,FALSE
CompanyJ_2492,The NBA landscape has been flipped,34,3600,473524,477124,image,FALSE
CompanyJ_2493,"Kemba Walker will be top target for Lakers in free agency after reaching an agreement in principle to trade for AD, per @marcsteinnba",133,9091,572660,581751,image,FALSE
CompanyJ_2494,AD knew all along,17,2334,404803,407137,video,FALSE
CompanyJ_2495,I got this,10,1457,358122,359579,image,FALSE
CompanyJ_2496,Lakers need a point guard now ,30,8339,499007,507346,image,FALSE
CompanyJ_2497,LaVar speaks,12,12054,418986,431040,image,FALSE
CompanyJ_2498,Fury-Wilder II coming soon,26,1494,288787,290281,image,FALSE
CompanyJ_2499,CP3's dad taught him that teammates come first  #HappyFathersDay,64,358,90819,91177,video,TRUE
CompanyJ_2500,Kawhis chilling now  (via @sergeibaka),38,7168,629320,636488,video,FALSE
CompanyJ_2501,"Fathers Day, 1996: MJ dedicated his fourth title to his father, who was murdered in 1993.  First full year back from baseball  Collapsed on the floor in tears",158,1467,407466,408933,image,FALSE
CompanyJ_2502,Russ throwing down alleys with his pops. Father/son bonding at its finest  (via @russwest44),92,1509,236003,237512,video,FALSE
CompanyJ_2503,THE @USWNT ARE THROUGH TO THE WORLD CUP KNOCKOUTS!,50,719,123703,124422,image,FALSE
CompanyJ_2504,"Tyson Fury is 6'9"", 263 pounds. Wow. (via @trboxing)",52,6795,549436,556231,video,FALSE
CompanyJ_2505,Brow mural in LA  Not even 24 hours after the trade (via @gz.jr),64,1676,331078,332754,image,FALSE
CompanyJ_2506,"Lakers expected to pursue Kawhi Leonard in free agency, per @kevinoconnornba",76,17331,716249,733580,image,FALSE
CompanyJ_2507,"Fred wants Kawhi to stay, but if not...",39,3546,490679,494225,image,FALSE
CompanyJ_2508,He SHREDDED the defense  (via @hendo_matt),42,2416,286918,289334,video,FALSE
CompanyJ_2509,Over 100 people are already lined up for the Raptors parade tomorrow  (via SNFaizalKhamisa/Twitter),99,1080,141759,142839,video,FALSE
CompanyJ_2510,"ANYTHINGS POSSIBLEEEE!!  11 years ago today, the Big Three broke Bostons championship drought and KG gave us an iconic interview (via @nbatv)",141,2758,480339,483097,carousel,FALSE
CompanyJ_2511,Klaw  6 God (via @nba),22,3800,565206,569006,video,FALSE
CompanyJ_2512,Board Man vibing to the MVP chants  (via @NBA),46,589,134694,135283,video,FALSE
CompanyJ_2513,Crowd was chanting One more year! to Kawhi but Lowry got them chanting for five  (via @yahoosportsca),101,3019,341139,344158,video,FALSE
CompanyJ_2514,Marc Gasol is chugging wine on the parade bus  (via @iamlateknight),67,2819,336117,338936,video,FALSE
CompanyJ_2515,"Melo Ball is signing with the @nbls Illawarra Hawks in Australia, says he wants to be the No. 1 pick next year @br_hoops (via @rachel_nichols, The Jump)",152,2012,252509,254521,image,FALSE
CompanyJ_2516,FUN GUY. Kawhi broke out the laugh to end his speech ,53,8802,685894,694696,video,FALSE
CompanyJ_2517,"Nine years ago today, Metta let it fly",38,697,190632,191329,image,FALSE
CompanyJ_2518,We the Champs ,14,1261,353398,354659,carousel,FALSE
CompanyJ_2519,Busted out the behind the back throw  (via @ry_tapz),52,1842,252489,254331,video,FALSE
CompanyJ_2520,Can't stop watching... (via riolutm/Twitter | h/t @brgaming),60,3680,292039,295719,video,FALSE
CompanyJ_2521,"Kawhis focus is on the Clippers if he leaves Toronto, not the Lakers, per @wojespn: The idea of him being a third wheel on a team trying to create a superteam, that has not been Kawhis M.O.",189,8659,581853,590512,image,FALSE
CompanyJ_2522,"Six years ago today, Ray Allen hit one of the most cold-blooded shots of all time ",82,2296,274588,276884,carousel,FALSE
CompanyJ_2523,Shareef ONeal missed last season after having heart surgery. This past weekend he showed up at the Drew and left no doubt that hes back  @br_hoops,146,718,155743,156461,video,FALSE
CompanyJ_2524,Haircut got Bron feeling himself (via @kingjames),49,9806,416162,425968,video,FALSE
CompanyJ_2525,"James Harden and Chris Pauls relationship is unsalvageable  CP3 demanded a trade and Harden told the front office to choose between them after losing to the Warriors, per VinceGoodwill/Twitter",192,23352,699159,722511,image,FALSE
CompanyJ_2526,CP3 and Harden earlier this season  (via @princejohndouglas),60,14865,618968,633833,video,FALSE
CompanyJ_2527,"Leo Messi has told Barcelona that he wants the club to re-sign Neymar instead of signing Griezmann, per @elmundo_es (h/t @brfootball)",133,3530,313387,316917,image,FALSE
CompanyJ_2528,"Al Horford is no longer discussing a deal with Boston, will enter free agency to sign a three- or four-year deal elsewhere, per SteveBHoop/Twitter",146,6674,448594,455268,image,FALSE
CompanyJ_2529,"Bron, Kyrie and the Cavs made history against the Warriors three years ago today.  The Block  The Shot  The 3-1 comeback",120,5900,609509,615409,carousel,FALSE
CompanyJ_2530,#NAME?,72,2428,313496,315924,video,FALSE
CompanyJ_2531,Being an unknown recruit didnt stop @igotgame12_ from climbing to the top of draft boards ,90,365,93713,94078,video,FALSE
CompanyJ_2532,"Mike Conley is being traded to Jazz for Jae Crowder, Kyle Korver and draft picks, per @shamsnba",95,9679,661302,670981,image,FALSE
CompanyJ_2533,Potential top-five pick Jarrett Culver could become Jimmy Butler 2.0 ,69,942,108923,109865,video,FALSE
CompanyJ_2534,They switched to soccer in the middle of a tennis match  (via @tennistv),72,3660,451095,454755,video,FALSE
CompanyJ_2535,Ja is ready for the critics ,28,2862,484181,487043,image,FALSE
CompanyJ_2536,NFL HOF Steve Young surprises Sophie Jones with the Gatorade National Girls Soccer Player of the Year award ,108,255,25907,26162,video,FALSE
CompanyJ_2537,"On this day in 1988, Isiah Thomas severely sprained his ankle in Game 6 of the NBA Finals vs. the Lakers.  Zeke played through it and went off for 25 of his 43 PTS in the 3Q  (via @nba)",185,2719,346346,349065,carousel,FALSE
CompanyJ_2538,"Ja Morant's ""world class"" trainer was...just OK  ( @att)",56,2459,451378,453837,video,FALSE
CompanyJ_2539,"Space Jam 2 will feature key roles for:  Damian Lillard Anthony Davis Klay Thompson Diana Taurasi Nneka Ogwumike  Will also include several other NBA and WNBA players, per @shamsnba",181,7719,559820,567539,image,FALSE
CompanyJ_2540," NBA champion  League MVP  31,560 PTS  20-year career  Maverick legend  Future Hall-of-Famer  Happy 41st Birthday, @swish41",123,1425,260837,262262,image,FALSE
CompanyJ_2541,"After the Raptors went up 3-2 on the Bucks, Nick Nurse told a story about winning Game 1 of the D-League Finals but not finishing the series at home.  Kawhi interrupted and joked, In the D-League? Im done listening to this. (via Zach Lowe)",239,7660,681115,688775,image,FALSE
CompanyJ_2542,"From Zion Williamson to Coby White, draft is stacked with studs atop the boards.",80,624,109202,109826,video,FALSE
CompanyJ_2543,Today in 2013: LeBron's dominant Game 7 performance secured the Heat going back-to-back  Bron: 37 PTS | 12 REB | 4 AST  Heatles' last chip together,147,2723,236398,239121,video,FALSE
CompanyJ_2544,"His game is exactly like Dwyane Wade coming out of college."" Amir Hinton could be the first D-II player drafted since 2005 ",123,1127,158867,159994,video,FALSE
CompanyJ_2545,"Dwyane Wade delivered Miami its first championship on this day in 2006  Down 0-2, Heat won the next 4  Flash averaged 39.3 PPG during that streak  Finals MVP at 24 ",164,2142,297528,299670,image,FALSE
CompanyJ_2546,THE @USWNT HYPE TRAIN ROLLS ON TO THE KNOCKOUT ROUND (via @brfootball),70,845,77808,78653,carousel,FALSE
CompanyJ_2547,The USWNT get their revenge ,28,167,26541,26708,video,FALSE
CompanyJ_2548,Zion needs to be in the dunk contest this season ,49,782,126300,127082,video,FALSE
CompanyJ_2549,"Hawks have acquired Pelicans' No. 4 pick in exchange for No. 8, 17 and 35 picks; Pelicans are sending Solomon Hill, No. 57 pick and future second-round pick, per @wojespn",170,3308,350983,354291,image,FALSE
CompanyJ_2550,"@CamReddish reveals why #CAMFAM, Mama Jones  , #TGBTG and the Norristown ""N"" make up his @JCPenney Draft-Day suit",113,164,38749,38913,video,TRUE
CompanyJ_2551,Bol Bol pulled up to the draft like a supervillain ,51,3902,457579,461481,image,FALSE
CompanyJ_2552,"""Underdog"" @drehunter_ reveals why ""Skills Over Politics"" and his 215 roots grace his @JCPenney Draft-Day suit",110,137,30546,30683,video,FALSE
CompanyJ_2553,Pelicans select Zion Williamson with the No. 1 pick!,52,1707,410010,411717,video,FALSE
CompanyJ_2554,The Ja Morant Show is headed to Memphis ,40,700,112272,112972,video,FALSE
CompanyJ_2555,Knicks get RJ Barrett in the 2019 draft!,40,1055,195573,196628,image,FALSE
CompanyJ_2556,The future is bright for the Pelicans ,38,11857,794387,806244,image,FALSE
CompanyJ_2557, Its a Tennessee thing,22,750,125124,125874,image,FALSE
CompanyJ_2558,Zion had to take it all in after being drafted No. 1 overall ,61,2996,467391,470387,image,FALSE
CompanyJ_2559,"Zion, RJ & Cam make history ",28,1010,207486,208496,image,FALSE
CompanyJ_2560,NBA Draft needs bigger hats ,28,3464,497334,500798,image,FALSE
CompanyJ_2561,RJs New York state of mind ,27,1556,314119,315675,image,FALSE
CompanyJ_2562,#NAME?,94,669,261625,262294,video,FALSE
CompanyJ_2563,Dame dropped a Bagley diss track after the Kings big man called him out  (link in bio to listen),96,1738,344038,345776,image,FALSE
CompanyJ_2564,Bol Bol is headed to the Nuggets carrying on his fathers legacy ,64,3647,462535,466182,image,FALSE
CompanyJ_2565,Bol Bol has a chip on his shoulder,34,3783,446395,450178,image,FALSE
CompanyJ_2566,Emotional night for Zion and his family  (via @nbaontnt),56,862,147592,148454,video,FALSE
CompanyJ_2567,Coby White reacts to his teammate Cam Johnson getting drafted at No. 11  (via @nbatv),85,3985,453334,457319,video,FALSE
CompanyJ_2568,2019 #NBADraft Class got a fit off ,35,1186,267581,268767,image,TRUE
CompanyJ_2569,This is incredible  (via @howridiculous),40,8460,464517,472977,video,FALSE
CompanyJ_2570,"From bodybuilding to hoops, Woody Belfort is a multisport star with cerebral palsy",82,994,98772,99766,video,FALSE
CompanyJ_2571,Ja Morants No. 1 pick? Moms spaghetti ,38,213,59479,59692,video,FALSE
CompanyJ_2572,Kawhi was in awe of Mike Trout (via @mlb),41,1198,200202,201400,video,FALSE
CompanyJ_2573,"Zion vs. RJ  NBA Summer League  July 5, 2019  Las Vegas, NV",59,1228,424121,425349,image,FALSE
CompanyJ_2574,Ja Morant is creative with his style,36,174,105605,105779,video,FALSE
CompanyJ_2575,New era in the Big Easy,23,1224,290103,291327,image,FALSE
CompanyJ_2576,Eight years later ,18,688,197892,198580,image,FALSE
CompanyJ_2577,He wasnt ready  (via @ferjani_safi) @brfootball,47,1987,233170,235157,video,FALSE
CompanyJ_2578,Make sure to celebrate Go Hoop Day on 6/23!,43,761,169922,170683,video,FALSE
CompanyJ_2579,"Jimmy in his art bag today: Im drawing pictures of GOATs  (via @jimmybutler, NSFW)",82,1097,134240,135337,video,FALSE
CompanyJ_2580,Franchise changers ,19,1756,371154,372910,image,FALSE
CompanyJ_2581,"This never happens in baseball.  Pujols gets a curtain call on the road, from his old home crowd in St. Louis. (via @mlb)",121,1599,224146,225745,video,FALSE
CompanyJ_2582,Donovan Mitchell welcomes his friend and Warriors draft pick Eric Paschall into the exclusive club of NBA players  (via @caa_basketball),136,640,219065,219705,video,FALSE
CompanyJ_2583,"Shaq says he wouldnt develop a three if he played in the league today: Im not gonna do what everybody else does. Everyone else is gonna have to try to stop me  (via @speedymorman, @nbatv)",187,4887,533080,537967,carousel,FALSE
CompanyJ_2584,@cp3 crossing kids up to get ready for Go Hoop Day . Get out and play today!,76,801,113506,114307,video,FALSE
CompanyJ_2585,"The Brow wore a ""That's all folks"" shirt to his final game with the Pelicans ",77,1589,214514,216103,image,FALSE
CompanyJ_2586,The 2011 draft changed the league eight years ago today. Cavs drafted Kyrie No. 1 Kawhi/George Hill trade Kemba went No. 9 off NCAA run Klay picked one spot after Jimmer Jimmy Butler taken 30th IT picked last (60th),215,2640,517283,519923,image,FALSE
CompanyJ_2587,LaDainian Tomlinson turns 40 today.  One of the greatest ever   HOF  2006 MVP  2x rushing leader  3x First Team All-Pro  Season TD record (31)  Season rushing TD record (28)  Season points record  No. 2 all-time rushing TD  No. 6 all-time rushing yards (via @nflthrowback),272,2115,260096,262211,carousel,FALSE
CompanyJ_2588,Bron putting up shots on the set of Space Jam 2  (via @jamesfgoldstein),71,3413,394811,398224,video,FALSE
CompanyJ_2589,"Kawhi Leonard is declining his $21.3M player option with Raptors and is ""seriously considering re-signing,"" per @chrisbhaynesnba",128,3692,435082,438774,image,FALSE
CompanyJ_2590,RJs intro at the Garden will give you chills  (via @nyknicks),61,5425,732138,737563,video,FALSE
CompanyJ_2591,Clippers fans are ready for Kawhi's free agency  (via @byandrewgreif/Los Angeles Times),87,2538,249533,252071,image,FALSE
CompanyJ_2592,"27 years ago today, Orlando drafted @shaq No. 1 out of LSU. League was never the same. (via @nbaontnt)",102,1804,434085,435889,carousel,FALSE
CompanyJ_2593,UD isnt closing the door just yet ,34,2500,244700,247200,image,FALSE
CompanyJ_2594,Hardens season was historic but the argument for Giannis as MVP is too strong ,78,2247,111232,113479,video,FALSE
CompanyJ_2595,"KD and Kyrie have reportedly met twice recently to discuss their desire to continue their careers on the same team  League exec also says KD is really pissed off at the Warriors following his Achilles injury, per @ric_bucher",224,7749,494357,502106,image,FALSE
CompanyJ_2596,"Through all the struggles and comparisons, @traeyoung heard it all and overcame  #NBAAwards",91,1079,152627,153706,video,TRUE
CompanyJ_2597,Chris Paul was cooking everybody on #GoHoopDayand letting them hear about it   Get your limited @gohoopday x B/R merch  Link in bio,131,616,123791,124407,carousel,TRUE
CompanyJ_2598,LEGO Kawhi is still clutch in Game 7  (via @goldyeller),55,2365,288561,290926,video,FALSE
CompanyJ_2599,Luka continues to rack up the hardware ,39,2340,386708,389048,image,FALSE
CompanyJ_2600,"@shaq, wyd  #NBAAwards",22,5114,613266,618380,video,TRUE
CompanyJ_2601,Spicy P stepped his game up in 2019 to get Most Improved ,57,1790,211241,213031,image,FALSE
CompanyJ_2602,Lou Will ties up J Crossover for most 6th Man of the Year awards of all-time,76,3058,383385,386443,image,FALSE
CompanyJ_2603,They didnt have to do Shaq like that ,37,4622,693663,698285,video,FALSE
CompanyJ_2604,D-Roses 50-point game wins the @houseofhighlights Moment of the Year Award ,75,2227,515309,517536,carousel,FALSE
CompanyJ_2605,Back-to-back  Rudy Gobert wins his second DPOY,46,3622,398747,402369,image,FALSE
CompanyJ_2606,"Kawhi and the Clippers have a meeting ""tentatively scheduled"" for July 2nd, per @thefrankisola",94,2428,309010,311438,image,FALSE
CompanyJ_2607,Your 2019 NBA MVP: Giannis Antetokounmpo ,41,7467,814827,822294,image,FALSE
CompanyJ_2608,From undiscovered gem to NBA MVP. What a journey it's been for Giannis ,71,2363,564292,566655,video,FALSE
CompanyJ_2609, M-V-P ,7,1192,151696,152888,video,FALSE
CompanyJ_2610,Giannis delivers his MVP speech  Powerful.,42,8408,858752,867160,video,FALSE
CompanyJ_2611,Your 2019 @BRKicks Sneaker MVP: PJ Tucker ,42,1999,320838,322837,carousel,FALSE
CompanyJ_2612,Challenge completed. @giannis_an34 @kobebryant,46,1359,372831,374190,image,FALSE
CompanyJ_2613,MVP.,4,1275,286758,288033,image,FALSE
CompanyJ_2614,NBA is global   MVP: Nigeria/Greece MIP: Cameroon ROY: Slovenia DPOY: France NBA Champions: Canada,98,3240,436035,439275,image,FALSE
CompanyJ_2615,WONDER WOMEN We teamed up with eight game-changing artists and designers to create their dream soccer jerseys. Link to cop in bio,129,1384,107453,108837,carousel,FALSE
CompanyJ_2616,"10 years ago today, the 2009 class shook up the landscape of the league.  Blake: 1st  Beard: 3rd  Steph: 7th  DeMar: 9th",120,1593,295226,296819,carousel,FALSE
CompanyJ_2617,On to the next Mamba Mentality Challenge ,41,1032,237002,238034,image,FALSE
CompanyJ_2618,Magic wouldnt mind seeing D-Lo return to the Lakers,51,3952,394507,398459,image,FALSE
CompanyJ_2619,Mahomes no-look. Saquons Superman. Hops cyclone. The next generation has arrived @brgridiron ,93,359,89234,89593,video,FALSE
CompanyJ_2620,Theres nobody in the league like @aarondonald99  Hes working to keep it that way  @brgridiron,93,952,122618,123570,video,FALSE
CompanyJ_2621,Have to try harder than that in goal vs. @jimmybutler ,54,913,196928,197841,video,FALSE
CompanyJ_2622,"There's an ""excellent chance"" Klay takes a meeting with Clippers if Warriors do not have five-year, $190M deal for Thompson at start of free agency, per @wojespn",161,6343,465117,471460,image,FALSE
CompanyJ_2623,16 years ago today: One of the most iconic drafts in league history  One of the greatest of all-time One of the most lethal scorers One of the most transcendent bigs One of the most influential guards And many important role players,232,3277,380779,384056,image,FALSE
CompanyJ_2624,Mike Vick turns 39 today (@brgridiron)  175 career TDs First black QB drafted No. 1 Transformed the QB position Season QB rushing record Career QB rushing record Youngest QB to win a playoff game Set record for QB fantasy points One of the GOAT video game athletes (via @nflthrowback),284,2948,211551,214499,carousel,FALSE
CompanyJ_2625,"KD has declined his player option and will become an unrestricted free agent this summer, per @wojespn",102,14764,693400,708164,image,FALSE
CompanyJ_2626,Rings speak louder than chemistry rumors,40,3317,322285,325602,image,FALSE
CompanyJ_2627,Ochocincos summer diet is a whole mood  (via @ochocinco),56,818,139983,140801,video,FALSE
CompanyJ_2628,Edelman recruiting KD to Boston  @brgridiron,44,1787,219807,221594,image,FALSE
CompanyJ_2629,"Lakers have ""serious interest"" in acquiring D'Angelo Russell this summer, per @shamsnba",87,9302,672320,681622,image,FALSE
CompanyJ_2630,"WAYNE ROONEY OH MY GOODNESS  (via @mls, h/t @brfootball)",56,106,4314,4420,video,FALSE
CompanyJ_2631,"IT is confident he can return to his old self: ""I'm going to get back to a level that I was playing at, I'm excited to show what I can do again,"" per @wojespn",158,5122,498624,503746,image,FALSE
CompanyJ_2632,"@shannonsharpe84 came into the league as a 7th-rounder. Since then:  HOF  3x champ  4x All-Pro  8x Pro Bowler  62 TDs  Retired as TE TD leader  10,060 receiving yards  No. 4 in TE receiving yards  Happy 51st to a legend. (via @nflfilms, h/t @brgridiron)",253,2902,568209,571111,carousel,FALSE
CompanyJ_2633,#NAME?,76,939,139025,139964,video,FALSE
CompanyJ_2634,How the @uswnt is inspiring the next generation  (via @brfootball),66,244,37116,37360,video,FALSE
CompanyJ_2635,USA vs. Europe in the World Cup knockouts  (via @brfootball),60,507,107916,108423,image,FALSE
CompanyJ_2636,"Six years ago today, the Bucks drafted a little-known prospect with the No. 15 pick.  It was his first time in America and his first time owning a suit.  When asked how he made it to the league, Giannis said, I dont really know",227,1101,329013,330114,image,FALSE
CompanyJ_2637,Jimmy from the top rope  (h/t @iamphillynation),47,5631,635212,640843,image,FALSE
CompanyJ_2638,Bring it back @kingjames!,25,5070,493397,498467,image,FALSE
CompanyJ_2639,"LeBron is gifting AD his No. 23 jersey, per @chrisbhaynesnba  AD waived his $4M trade kicker today and the Lakers now have $32M in cap space, per @wojespn",154,10090,738179,748269,carousel,FALSE
CompanyJ_2640,"Kawhi intends to meet with Lakers and Clippers when free agency starts, per @chrisbhaynesnba",92,3846,406649,410495,video,FALSE
CompanyJ_2641,OBJ  JuJu  Tarik   Lot of one-handed grabs at minicamp and OTAs @brgridiron,75,371,77961,78332,video,FALSE
CompanyJ_2642,AD is taking 23. Is No. 6 Bron back?,36,9388,842464,851852,image,FALSE
CompanyJ_2643,Megan Rapinoe on saying shes not going to the fking White House: I stand by the comments I made ... with the exception of the expletive.,136,6965,178514,185479,video,FALSE
CompanyJ_2644,He didnt have to do them like that  (via @matthewcerilli),57,1533,207276,208809,video,FALSE
CompanyJ_2645,"Kyrie Irving remains just as much of a target for the Lakers as Kawhi Leonard now that they have maximum cap space, per @marcsteinnba",133,5930,563226,569156,image,FALSE
CompanyJ_2646,TODAY. The reigning champions vs. the hosts in the World Cup quarterfinals ,75,858,121370,122228,image,FALSE
CompanyJ_2647,#NAME?,132,819,212523,213342,video,FALSE
CompanyJ_2648,"Fresh off an MVP season, Giannis gets his own signature shoe  (via @brkicks)",76,3720,518826,522546,carousel,FALSE
CompanyJ_2649,"RECOVERY FROM THE GOALKEEPER  (via @pifen2024, h/t @brfootball)",63,6079,408363,414442,video,FALSE
CompanyJ_2650,He tried to guard Giannis 1-on-1  (via @master_tesfatsion),58,2037,259443,261480,video,FALSE
CompanyJ_2651,Leonard proved to every critic that his championship DNA is unquestionable,74,1819,327845,329664,video,FALSE
CompanyJ_2652,US fans traveling in NUMBERS to the @uswnts quarterfinal  (via @americanoutlaws),80,761,85445,86206,video,FALSE
CompanyJ_2653,76ers will have the highest stakes in free agency after going all-in for a playoff run,86,635,117514,118149,video,FALSE
CompanyJ_2654,The @uswnt are through to the World Cup semifinals!,51,1735,226443,228178,image,FALSE
CompanyJ_2655,ICONIC  Four goals in two games for @mrapinoe,45,3822,344761,348583,carousel,FALSE
CompanyJ_2656,"LeBron and Anthony Davis plan to be part of Lakers' free agency pitch to Kawhi, per @sramick",92,6147,477682,483829,image,FALSE
CompanyJ_2657,Max Holloway just won the bottle cap challenge  (via @blessedmma),65,2192,247134,249326,video,FALSE
CompanyJ_2658,KDs injury wont stop him from signing wherever he wants   Where will he land?,77,4391,401013,405404,image,FALSE
CompanyJ_2659,"Kevin Durant ""planning to engage"" Warriors, Nets, Clippers, and Knicks at the start of free agency Sunday, per @wojespn",119,2002,331099,333101,image,FALSE
CompanyJ_2660,Khabib ready for his max contract  (via @khabib_nurmagomedov),61,5549,183549,189098,video,FALSE
CompanyJ_2661,"Darren Collison has retired from the NBA after 10 seasons, per @marcjspears",75,8885,616566,625451,image,FALSE
CompanyJ_2662,"Lakers are a ""true threat"" to sign Kahwi away from Raptors; LAL believe they've won the sweepstakes for Leonard, per @marcsteinnba",130,10942,649024,659966,image,FALSE
CompanyJ_2663,"Fun Guy turns 28 today  NBA champion on two different teams  Only player with a Finals MVP in both conferences  About to hit his prime  Happy birthday, Kawhi ",158,2718,487286,490004,image,FALSE
CompanyJ_2664,"Klay Thompson and Warriors plan to reach an agreement on five-year, $190M max contract within the next day, per @shamsnba",121,3522,414574,418096,image,FALSE
CompanyJ_2665,"You coming to New York, bro? Kawhi has a history with fans in NY  (via Jerry West/FB)",85,4819,381391,386210,video,FALSE
CompanyJ_2666,The World Cup final four are set ,33,1176,197090,198266,image,FALSE
CompanyJ_2667,Free agency was Durant's decision and team's aren't worried about his comeback,78,2428,350220,352648,video,FALSE
CompanyJ_2668,"Pistons ""emerging as the favorite"" to sign Derrick Rose, per @thefrankisola",75,4363,452500,456863,image,FALSE
CompanyJ_2669,Bronny wanted to flex his building in Fortnite real quick  (via @bronny),72,1534,156050,157584,video,FALSE
CompanyJ_2670,"Kemba Walker ""plans to commit"" to four-year, $141M max deal with Celtics at beginning of free agency, per @shamsnba ",116,10675,707770,718445,image,FALSE
CompanyJ_2671,"Kyrie Irving and Nets motivated to move quickly towards four-year, $141M max deal when they meet in New York on Sunday, per @wojespn",132,4634,453800,458434,image,FALSE
CompanyJ_2672,Lakers fans doing their part in recruiting Kawhi  (via @gz.jr),62,4069,469465,473534,image,FALSE
CompanyJ_2673,Happy Birthday to the late Craig Sager. These moments were hysterical  (via @nba),81,2310,400472,402782,video,FALSE
CompanyJ_2674,NBA FREE AGENCY. TONIGHT. 6 p.m. ET ,36,2881,515084,517965,image,FALSE
CompanyJ_2675,#NAME?,68,1981,310920,312901,carousel,FALSE
CompanyJ_2676,#NAME?,61,2790,244891,247681,image,FALSE
CompanyJ_2677,Had him walking away to look for it  (via @solarjoy),52,1021,211128,212149,video,FALSE
CompanyJ_2678,"Jimmy Butler is expected to tell MIA officials he wishes to play for the Heat tonight, per @bytimreynolds",105,5039,456701,461740,image,FALSE
CompanyJ_2679,"Dame DOLLA  Lillard is working toward a four-year, $196M supermax extension with Blazers, per @shamsnba ",104,5888,574529,580417,image,FALSE
CompanyJ_2680,"Wolves are at the top of DAngelo Russells wish list  Minnesota is increasingly confident it can make the cap moves to land D-Lo, per @marcsteinnba",146,4734,393956,398690,image,FALSE
CompanyJ_2681,"KD'S DECISION TONIGHT.  Durant will announce where he's going on @theboardroom, per @wojespn",92,10373,449220,459593,image,FALSE
CompanyJ_2682,Decisions for Kawhi Leonard ,28,1673,222622,224295,video,FALSE
CompanyJ_2683,"The Nets seem to believe theyre getting KD along with Kyrie and DeAndre Jordan tonight, per @marcsteinnba",105,5300,493166,498466,image,FALSE
CompanyJ_2684,"Breaking: KD is planning to sign a 4-year, $164M deal with the Nets, per @wojespn",81,24202,1053813,1078015,image,FALSE
CompanyJ_2685,Draymond watching KD leave..,28,21484,814920,836404,video,FALSE
CompanyJ_2686,Knicks fans after the KD-Kyrie announcement,43,15003,711912,726915,video,FALSE
CompanyJ_2687,"Kemba Walker is joining the Celtics on a 4-year, $141M max contract, per @wojespn (from B/R X @americanexpress)",111,2280,305566,307846,video,FALSE
CompanyJ_2688,"D-Rose has agreed to a 2-year, $15M deal with the Pistons, per @wojespn",71,6400,769772,776172,image,FALSE
CompanyJ_2689,"Dame signs a 4-year, $194M supermax extension with the Blazers, per @chrisbhaynesnba (NSFW)",91,2295,287695,289990,video,FALSE
CompanyJ_2690,"Knicks were ""not fully prepared"" to offer KD a full max contract with concerns over his recovery, per @ramonashelburne",118,10887,496620,507507,image,FALSE
CompanyJ_2691,"Heat are finalizing a sign-and-trade with 76ers for Jimmy Butler, per @wojespn",78,6856,686772,693628,image,FALSE
CompanyJ_2692,"Al Horford has agreed to 4-year, $109M deal with the 76ers, per @wojespn",72,6604,443293,449897,image,FALSE
CompanyJ_2693,Brooklyn's Big 3 (from B/R x @americanexpress),46,4437,372848,377285,video,FALSE
CompanyJ_2694,"D'Angelo Russell has been traded to to Warriors in sign-and-trade deal with Nets, per @wojespn",94,37339,1101123,1138462,image,FALSE
CompanyJ_2695,"The Warriors have traded Iggy to the Grizzlies, per @wojespn",60,11173,521401,532574,image,FALSE
CompanyJ_2696,D-Lo to the Warriors. What a wild Day 1 of free agency so far. (from B/R x @americanexpress),92,2801,257078,259879,video,FALSE
CompanyJ_2697,That new Philly five ,21,13856,744253,758109,image,FALSE
CompanyJ_2698,Now we wait for the Board Man.  KD: Nets Kyrie: Nets D-Lo: Warriors Kemba: Celtics Jimmy: Heat Horford: 76ers Tobias: 76ers Middleton: Bucks Redick: Pelicans Porzingis: Mavs Bogdanovic: Jazz Brogdon: Pacers Randle: Knicks Rose: Pistons Pat Bev: Clippers,253,4442,424811,429253,image,FALSE
CompanyJ_2699,KDs brother showing off that new 35 Brooklyn jersey (via @tdurant),66,2225,307825,310050,video,FALSE
CompanyJ_2700,Kyrie linked up with KD in Brooklyn after two wild seasons in Boston,68,1229,176593,177822,carousel,FALSE
CompanyJ_2701,"Breaking: Klay and the Warriors agree to a 5-year/$190M max deal, per multiple reports",86,3040,402237,405277,video,FALSE
CompanyJ_2702,Newest addition in Portland   @hassanwhiteside,46,8254,698266,706520,image,FALSE
CompanyJ_2703, @mrapinoe,10,1365,141736,143101,image,FALSE
CompanyJ_2704,Will Bynum broke out a fake Shammgod at @thebig3 ,49,2750,283392,286142,video,FALSE
CompanyJ_2705,"@jaytatum0 pulled up to Quai 54 in Paris, one of the worlds biggest streetball tournaments, and surprised these kids with a truck full of new  @Jumpman23. New Sneaker Shock  (@brkicks)",184,194,123327,123521,video,FALSE
CompanyJ_2706,Joe Lacob says no Warrior will wear No. 35 as long as he is co-chairman of the team.,84,5103,443098,448201,image,FALSE
CompanyJ_2707,"You get a bag, you get a bag, you get a bag...NBA players signed for more than $3B on the first day of free agency ",115,919,169660,170579,video,FALSE
CompanyJ_2708,"Isaiah Thomas has agreed to a 1-year deal with the Wizards, per @wojespn",72,5382,607894,613276,image,FALSE
CompanyJ_2709,Dylan Windler is a bucket...  (via @nbatv),42,2193,271800,273993,video,FALSE
CompanyJ_2710,Bam Bam Kam Chancellor was a bad man  @brgridiron  The Enforcer walked away from the game one year ago today (via @thecheckdown),128,2504,371364,373868,carousel,FALSE
CompanyJ_2711,TODAY  England vs. @uswnt  For a spot in the World Cup final ,61,962,132790,133752,image,FALSE
CompanyJ_2712, NEW York Knicks ,17,38254,571186,609440,image,FALSE
CompanyJ_2713,@flash_garrett is built different   @brgridiron  Squatting 675 lbs  Box jumps with 50s,86,8488,252304,260792,video,FALSE
CompanyJ_2714, ,1,3748,531808,535556,carousel,FALSE
CompanyJ_2715,The @uswnt are headed back to the World Cup final! ,51,1624,252385,254009,image,FALSE
CompanyJ_2716,WHAT  A  GAME ,14,1040,219475,220515,carousel,FALSE
CompanyJ_2717,Vlads moonshots are disappearing into the lights  (via @alexisbrudnicki),72,4882,453845,458727,video,FALSE
CompanyJ_2718,"Patrick Corbin wearing No. 45 to honor Tyler Skaggs, writes the number on the mound for his late friend (via @mlbcut4)",118,869,286487,287356,carousel,FALSE
CompanyJ_2719,#NAME?,56,1596,442623,444219,image,FALSE
CompanyJ_2720,Another missed shot at an international trophy for Messi  (via @brfootball),75,3683,355988,359671,image,FALSE
CompanyJ_2721,Angels held a moment of silence and wore special patches tonight to honor late pitcher Tyler Skaggs ,100,691,230812,231503,image,FALSE
CompanyJ_2722,This team.  @uswnt  (via @brfootball),37,2058,231398,233456,image,FALSE
CompanyJ_2723,"@wojespn says he was told not to expect a Kawhi decision until at least later today, possibly tomorrow on July 4th",114,4303,456769,461072,image,FALSE
CompanyJ_2724,End of an era ,14,3366,631017,634383,image,FALSE
CompanyJ_2725, (via @brfootball),18,3172,247311,250483,image,FALSE
CompanyJ_2726,"Knicks big man Mitchell Robinson is changing from No. 26 to No. 23 to honor two childhood friends and former teammates who died.  One wore No. 2, the other wore No. 3  (via @nypost)",181,1764,367174,368938,image,FALSE
CompanyJ_2727,Former Giants QB Jared Lorenzen has died at the age of 38.,58,3831,318966,322797,image,FALSE
CompanyJ_2728,USA vs. The Netherlands  Sundays #FIFAWWC final is set ,55,1384,180364,181748,image,TRUE
CompanyJ_2729,Your favorite rappers are getting buckets on the basketball court ,66,2146,159983,162129,video,FALSE
CompanyJ_2730,"Knicks reportedly cancelled a meeting with Kawhi Leonard in fear of missing out on other free agents, per @nypost",113,20504,653895,674399,image,FALSE
CompanyJ_2731,"Legendary, @alexmorgan13  (via @brfootball)",43,498,77881,78379,video,FALSE
CompanyJ_2732,Coach and former NBA player Ricky Davis thinks he was one of the best players there  (via @br_hoops),100,952,277232,278184,video,FALSE
CompanyJ_2733,"Kawhi is not expected to make free agency decision until next few days. He and his reps are taking their time before deciding, per @theathletichq",145,4358,383156,387514,image,FALSE
CompanyJ_2734,Zion is gonna be so fun  (via @pelicansnba),43,3130,309437,312567,video,FALSE
CompanyJ_2735,Happy Fourth of July! ,22,698,137622,138320,image,FALSE
CompanyJ_2736,Giannis view in Greece looks like a painting  (via @giannis_an34),65,2375,428225,430600,video,FALSE
CompanyJ_2737,These throwback looks are the vibe for every BBQ this July 4th,62,542,176486,177028,carousel,FALSE
CompanyJ_2738,#NAME?,38,2867,547782,550649,carousel,FALSE
CompanyJ_2739,"KD to BK isnt the first time he shook up the league  3 years ago today, he left OKC for the Bay and the rest is history",119,926,131931,132857,video,FALSE
CompanyJ_2740,"Five-star recruit Jalen Johnson has verbally committed to Duke, per @evandaniels  Swipe  for highlights! @br_hoops",114,1090,218826,219916,carousel,FALSE
CompanyJ_2741,#NAME?,50,5426,263915,269341,video,FALSE
CompanyJ_2742,This is unreal  (via @wade_bright),34,4064,707559,711623,video,FALSE
CompanyJ_2743,"Four years ago today, the @USWNT won the World Cup for the third time. On Sunday, they go for No. 4  ",101,749,123183,123932,image,FALSE
CompanyJ_2744,Summer league always goes OFF. Which rookie will tear it up this year?,70,592,77794,78386,video,FALSE
CompanyJ_2745,Dreamville got their revenge on the rap game ,45,3377,380599,383976,image,FALSE
CompanyJ_2746,#NAME?,102,9013,333282,342295,video,FALSE
CompanyJ_2747,Thats why @abs footwork and hands are elite  (via @doctor_reef),63,3177,333327,336504,video,FALSE
CompanyJ_2748,WHAT A COMEBACK.  15-year-old Coco Gauff comes back from being a set down to advance to the Round of 16 at Wimbledon ,117,2014,294749,296763,carousel,FALSE
CompanyJ_2749,"@shareefoneal got new ink of the vintage @shaq alley-oop reaction  (: @koolmac, @stevewiebe)",92,921,210705,211626,carousel,FALSE
CompanyJ_2750,"Wizards have traded Dwight Howard to the Grizzlies for CJ Miles, per @shamsnba & @wojespn",89,5483,359749,365232,image,FALSE
CompanyJ_2751,@paulpogba got a 2-for-1 ,25,945,146749,147694,video,FALSE
CompanyJ_2752,Zion 360  (via @NBA),20,3040,428533,431573,video,FALSE
CompanyJ_2753,An earthquake happened during the Knicks-Pelicans summer league game and all games have been postponed for tonight ,115,1973,282764,284737,video,FALSE
CompanyJ_2754,Zion did not disappoint in his summer league debut ,51,4018,369800,373818,video,FALSE
CompanyJ_2755,"Fun guy goes Hollywood  Kawhi Leonard will join the Los Angeles Clippers, per @chrisbhaynesnba",94,26314,1047300,1073614,image,FALSE
CompanyJ_2756,"Breaking: Thunder are sending Paul George to the Clippers, per @wojespn",71,19227,793974,813201,image,FALSE
CompanyJ_2757,"What it do, Clippers!",21,4441,421725,426166,video,FALSE
CompanyJ_2758,The battle for LA just got real ,32,9795,734200,743995,image,FALSE
CompanyJ_2759,Lakers front office after Kawhis decision:,42,7304,508472,515776,video,FALSE
CompanyJ_2760,NBA free agency has flipped the league upside down.,51,6226,699144,705370,image,FALSE
CompanyJ_2761,The new dynamic duo in LA ,26,10847,867447,878294,image,FALSE
CompanyJ_2762,Last man standing.,18,18355,915985,934340,image,FALSE
CompanyJ_2763,"OKC offered Westbrook and PG-13 to the Raptors with Siakam as the centerpiece of an asset-crippling deal, but Toronto turned it down, per @wojespn",146,9982,525517,535499,image,FALSE
CompanyJ_2764,That Clippers defense  Pat Bev  Kawhi  PG  Trezl,48,6007,534437,540444,carousel,FALSE
CompanyJ_2765,New title favorites after last night  (via @br_betting),55,4489,301591,306080,image,FALSE
CompanyJ_2766,LakeShow summer ,16,18591,887701,906292,image,FALSE
CompanyJ_2767,"Westbrook and his agent are engaged with OKC GM Sam Presti about a potential trade, per @wojespn",96,22434,641000,663434,image,FALSE
CompanyJ_2768,"Breaking: BOOGIE to LA.  Cousins agrees to a one-year deal with the Lakers, per @wojespn",88,39318,1202054,1241372,image,FALSE
CompanyJ_2769,"Rondos back in LA.  The point guard is returning to the Lakers on a two-year deal, per @wojespn and @ramonashelburne",116,3937,609968,613905,image,FALSE
CompanyJ_2770,"AD was catching lobs from LBJ in 2018 while rocking the Boogie jersey.  Brow was honoring his Pelicans teammate, who tore his Achilles.  All Lakers teammates now ",162,1438,359585,361023,video,FALSE
CompanyJ_2771,@taylorrooks put him through the ringer but @drehunter_ handled his business at this mock press conference   From B/R x @jcpenney,129,152,33898,34050,video,FALSE
CompanyJ_2772,"Zion (bruised knee) is out for the rest of Summer League, David Griffin announced.",82,6858,522226,529084,image,FALSE
CompanyJ_2773,"The Pacers drafted Kawhi Leonard and Paul George in back-to-back years, but they traded the Kawhi pick to the Spurs for George Hill  What couldve been..."" is becoming reality with LAC",183,2686,421013,423699,image,FALSE
CompanyJ_2774,Kawhi Leonard is the first player in NBA history to join a new team right after winning Finals MVP,98,4250,499408,503658,image,FALSE
CompanyJ_2775,Jerry West continues to make banner moves as an executive:  Helped build 1980s Lakers dynasty  Traded Vlade Divac for Kobe  Convinced Shaq to sign with LAL  Stopped Klay-for-Kevin Love trade  Helped recruit KD to Warriors  Signed Kawhi & PG13 in one night,255,4910,538363,543273,image,FALSE
CompanyJ_2776,The World Cup final is TOMORROW @USWNT vs. The Netherlands,58,1075,172349,173424,image,FALSE
CompanyJ_2777,Khabib and Nate Diaz got into an altercation and had to be separated at UFC 239  *NSFW* (via @mattwreford95),108,5347,385729,391076,video,FALSE
CompanyJ_2778,Jon Jones had to be carried out of the octagon after his victory at #UFC239 (via @andreashale),94,1396,240199,241595,video,TRUE
CompanyJ_2779,WORLD CUP FINAL DAY. The defending champions look to bring it home again . Follow @brfootball for everything #uswnt ,116,826,176516,177342,image,TRUE
CompanyJ_2780,"Rival execs have pinpointed the Rockets as a likely suitor in a potential Westbrook trade, per @sramick and @bdawsonwrites  Brodie  Beard reunion?",146,9762,577846,587608,carousel,FALSE
CompanyJ_2781,The crowd in Kansas City for the @uswnt is SERIOUS  (via @sportingkc),69,1620,160505,162125,video,FALSE
CompanyJ_2782,THE @USWNT ARE WORLD CHAMPIONS AGAIN!  @brfootball,50,3337,410429,413766,image,FALSE
CompanyJ_2783,Dominance.,10,1167,237568,238735,image,FALSE
CompanyJ_2784,6 goals and 3 assists in 5 games.  Megan Rapinoe wins the 2019 World Cup Golden Boot AND Golden Ball  (via @brfootball),119,3190,292081,295271,image,FALSE
CompanyJ_2785, L E G E N D A R Y ,19,2098,329651,331749,carousel,FALSE
CompanyJ_2786,The Warriors are retiring Andre Iguodalas No. 9 jersey.  3x champ  2015 Finals MVP,82,6398,567130,573528,image,FALSE
CompanyJ_2787,The USWNT went wild in the locker room after the win  *NSFW* (via @ashlynharris24),82,9299,662789,672088,video,FALSE
CompanyJ_2788,Julie Ertzs World Cup Trophy photoshoot  >>>,44,891,260993,261884,carousel,FALSE
CompanyJ_2789,Pinoe pays tribute to Nipsey.  Respect  (via @brfootball),57,3648,256441,260089,image,FALSE
CompanyJ_2790,The way Jimmy threw the pen after signing his contract  (via @miamiheat),72,3292,451576,454868,video,FALSE
CompanyJ_2791,KD will switch to No. 7 on the Nets after wearing No. 35 for this whole career (via @easymoneysniper),101,9717,659352,669069,image,FALSE
CompanyJ_2792,Brooklyns new duo is official  Swipe ,37,1790,321671,323461,carousel,FALSE
CompanyJ_2793,When the @uswnt sealed their fourth World Cup  (via @brfootball),64,326,56201,56527,video,FALSE
CompanyJ_2794,"Nine years ago today, LeBron joined the Heat and changed the league with The Decision",85,3465,413345,416810,image,FALSE
CompanyJ_2795,"15-year-old phenom @cocogauff has been eliminated from Wimbledon after an unbelievable run.  Youngest to reach main draw  Beat Venus, a childhood idol  Advanced to Round of 16  Only the beginning.",196,1304,240119,241423,image,FALSE
CompanyJ_2796,JR showed up to the MLB All Star celebrity game without a shirt ,64,2435,454171,456606,carousel,FALSE
CompanyJ_2797,PG-13 talking about Kawhi in September  (via @_theoklahoman / YouTube),70,2500,428438,430938,video,FALSE
CompanyJ_2798,"Neymar was a no-show for the start of PSG preseason training today, amid rumors of a return to Barcelona  (@brfootball)",119,1307,243200,244507,image,FALSE
CompanyJ_2799,"New chapter, new number ",24,4320,442407,446727,image,FALSE
CompanyJ_2800,Big comebacks on the biggest stage ,35,209,38000,38209,video,FALSE
CompanyJ_2801,#NAME?,75,1276,164096,165372,video,FALSE
CompanyJ_2802,"The Lakers plan to start LeBron at point guard this year, per @chrisbhaynesnba  SHOWTIME ",89,13301,708085,721386,image,FALSE
CompanyJ_2803,The #BottleCapChallenge is taking over the sports world ,56,495,91277,91772,video,TRUE
CompanyJ_2804,"Westbrook is welcoming the idea of a trade from OKC after 11 years. Miami has expressed interest and appeals to Russ, per @wojespn",130,7361,517767,525128,image,FALSE
CompanyJ_2805,Dwight is ready for a fresh start,33,5232,333066,338298,image,FALSE
CompanyJ_2806,Hard to find a couple with more  than Megan Rapinoe and Sue Bird:  Pinoe: 2x World Cup 2012 Olympic Gold 2019 World Cup Golden Ball & Golden Boot 2012/13 Division 1 Feminine 2x NWSL Shield  Sue: 3x WNBA Champ 2x NCAA Champion 4x Olympic gold 4x World Champ,256,2931,267824,270755,carousel,FALSE
CompanyJ_2807,#NAME?,102,1097,317468,318565,carousel,FALSE
CompanyJ_2808,Vlad Jr.'s dad won the Home Run Derby in 2007.  Tonight Vlad Jr. set the record for most HRs in a single round with 29  (via @mlb),130,1129,294392,295521,carousel,FALSE
CompanyJ_2809,Jaxson Hayes caught a BODY  (via @nbatv),40,5810,506276,512086,video,FALSE
CompanyJ_2810,Emmitt Smith Jr. is following in his fathers footsteps  The Cowboys legend says hes been special since birth @brgridiron,120,604,115455,116059,video,FALSE
CompanyJ_2811,13 years ago today: Zidanes infamous headbutt in the World Cup final  (via @brfootball),87,1511,181128,182639,video,FALSE
CompanyJ_2812,"Boogie is returning to 15, his old Kings number. Bron returning to his Miami 6. Lakers throwing it back this year ",114,5141,600133,605274,image,FALSE
CompanyJ_2813,"James Harden working on his touch with Arsenal  (via @reissnelson, @mranthonyyarde)",83,1321,158958,160279,video,FALSE
CompanyJ_2814,"Nets GM Sean Marks says he found out KD was coming to Nets from his IG post, there was no official meeting until after that ",124,3039,488039,491078,image,FALSE
CompanyJ_2815,Mayweather is now 50-1 ,23,6327,558277,564604,video,FALSE
CompanyJ_2816,New look for @kingjames in year 17?,35,1936,312096,314032,image,FALSE
CompanyJ_2817,Wild All-Star weekend   AL wins their 7th straight All-Star Game  Trout pays respect to No. 45 Skaggs  Vlad's historic shots vs. Alonso's derby heroics  Celebrity love everywhere,178,757,160851,161608,carousel,FALSE
CompanyJ_2818,Take a charge from Tacko Fall at your own risk ,47,4231,454596,458827,video,FALSE
CompanyJ_2819,"9 years ago today, LeBron and Bosh joined Wade in Miami and the Heatles were born  (From @americanexpress x B/R)",112,923,137510,138433,video,FALSE
CompanyJ_2820,"Deal back home is official. 2K needs this, baybee.",50,4377,573283,577660,image,FALSE
CompanyJ_2821,2021 free agency market could be stacked  Kawhi Bron PG Giannis,63,5515,421155,426670,carousel,FALSE
CompanyJ_2822,Pinoes victory dance >>>,24,7320,382898,390218,video,FALSE
CompanyJ_2823,@ab turns 31 today as one of the greats. What a journey  @brgridiron,68,3620,402284,405904,carousel,FALSE
CompanyJ_2824,That was the whole field  @obj LAUNCHED this ball @brgridiron *NSFW* (via @jpqz),80,2260,347231,349491,video,FALSE
CompanyJ_2825,Tyler Herro has taken Summer League by storm  (Swipe  for his best plays),73,4754,461301,466055,carousel,FALSE
CompanyJ_2826,"This 11-year-old kid put the moves on Luke Kuechly...but Luke got him back  (via @4kcotto, h/t @brgridiron)",107,2019,253630,255649,video,FALSE
CompanyJ_2827,Windmill Bronny  (via @br_hoops),32,2384,329634,332018,video,FALSE
CompanyJ_2828,"On this day in 2014, @kingjames announced he was coming home to Cleveland ",74,1766,240818,242584,video,FALSE
CompanyJ_2829,Whatever it takes ,18,3360,479999,483359,image,FALSE
CompanyJ_2830,ADs game will prove to be worth the haul Lakers gave up to land the superstar,77,1694,191810,193504,video,FALSE
CompanyJ_2831, x  Royalty,11,5518,601343,606861,image,FALSE
CompanyJ_2832,"Wades daughter was fed up with videos, just wants Daddys phone  (via @dwyanewade)",81,1107,214462,215569,video,FALSE
CompanyJ_2833,"Three years ago today, Tim Duncan announced his retirement with a press release from the Spurs, which didnt even include any comments from the Big Fundamental.  A quiet end to an iconic career.",193,2467,394615,397082,image,FALSE
CompanyJ_2834, WNBA All-Star Captains: Elena Della Donne & A'ja Wilson  Starters: Liz Cambage Brittney Griner Natasha Howard Jonquel Jones Chelsea Gray Jewell Loyd Kayla McBride Kia Nurse,173,2622,106470,109092,image,FALSE
CompanyJ_2835,"Breaking: Thunder trade Russell Westbrook to Houston for Chris Paul and 2024, 2026 first-round picks, pick swaps in 2021 and 2025, per @wojespn",143,55332,1574671,1630003,image,FALSE
CompanyJ_2836,A look back at Russ and Harden in OKC  (via @nba),49,3208,490105,493313,carousel,FALSE
CompanyJ_2837,OKC was never the same after this...,36,7569,525770,533339,video,FALSE
CompanyJ_2838,Russ is now on the Rockets   One of the coldest dudes in the league  (@coorslight),82,1457,151293,152750,video,FALSE
CompanyJ_2839,End of an era in OKC.,21,5420,570127,575547,carousel,FALSE
CompanyJ_2840,OKC turned Russ and PG into... ,31,4868,378012,382880,image,FALSE
CompanyJ_2841,CP3 heads to OKC,16,12156,645519,657675,image,FALSE
CompanyJ_2842,BRODIE x BEARD are BACK,23,3265,428834,432099,video,FALSE
CompanyJ_2843,The 2nd half of the MLB season is underway ,43,501,32480,32981,video,FALSE
CompanyJ_2844,Breaking: Barcelona have officially signed Antoine Griezmann from Atletico Madrid (via @brfootball),99,3154,242544,245698,image,FALSE
CompanyJ_2845,Wade needs to make some phone calls after Free Agency is over ,62,2779,546559,549338,image,FALSE
CompanyJ_2846,Beckhams #Wimbledon fit >>>,27,1284,244256,245540,carousel,FALSE
CompanyJ_2847,"Plan for OKC is that CP3 doesnt play a game in a Thunder uniform, looking to move him soon, per @wojespn",104,13153,532435,545588,image,FALSE
CompanyJ_2848,That height difference ,23,7374,785612,792986,image,FALSE
CompanyJ_2849,Vlad Jr. is ready for a strong second half after his All-Star weekend ,70,474,85572,86046,video,FALSE
CompanyJ_2850,"Career Retrospective with Thunder: Best Plays, Quotes and Moments",65,3582,495531,499113,video,FALSE
CompanyJ_2851,The #Wimbledon final is about to be a show   Its been 4 years since Djokovic and Federer faced off on the biggest stage,119,719,137629,138348,carousel,FALSE
CompanyJ_2852,These NBA kids will be in the league soon  Which duo you got? @br_hoops,71,6877,610867,617744,image,FALSE
CompanyJ_2853,Harden ready to get that old thing back,39,2602,584184,586786,image,FALSE
CompanyJ_2854,Russ says goodbye to OKC  (via @russwest44),43,1780,529583,531363,carousel,FALSE
CompanyJ_2855,Tyler Skaggs mom Debbie threw out the first pitch and it was right down the middle  (via @mlb),94,784,191887,192671,video,FALSE
CompanyJ_2856,All for Tyler  -Combined no hitter -13-0 win -No. 45 on every jersey -Mom with perfect strike first pitch  Angels left it all on the field,138,1283,328174,329457,carousel,FALSE
CompanyJ_2857,HISTORY   Simona Halep crowned first-ever Romanian #Wimbledon singles champion: It was my moms dream,100,1189,177221,178410,carousel,FALSE
CompanyJ_2858,Jaxson Hayes was an absolute game breaker at summer league this year,68,1729,124244,125973,video,FALSE
CompanyJ_2859,Serena won't change anything,28,3063,212770,215833,image,FALSE
CompanyJ_2860,Thats one way to season your meat  (via @luke_hampton),54,2112,145549,147661,video,FALSE
CompanyJ_2861,"Ice Trae really is cold blooded, even against kids  (via @traeyoung)",68,1554,271120,272674,video,FALSE
CompanyJ_2862,AD3  #LakeShow,14,2769,546958,549727,image,FALSE
CompanyJ_2863,RJ Barrett had himself a game vs. the Wizards ,46,2806,448766,451572,carousel,FALSE
CompanyJ_2864,Svi with one of the NASTIEST crosses of Summer League  (via @nba),65,3504,355333,358837,video,FALSE
CompanyJ_2865,Help mama out  Carsen Edwards always keeps his motivation on his wrist,70,2156,506688,508844,carousel,FALSE
CompanyJ_2866,Giannis wants to be around for the long haul,44,3209,379296,382505,image,FALSE
CompanyJ_2867,"@deandrehopkins is the No. 1 offensive player on Madden 20  @brgridiron  Best in the game on:  Overall (one of four 99s)  Catching (99)  Jumping (99)  Spectacular Catch (99)  Catch In Traffic (99)  Release (99) | (via @EAMaddenNFL, @nflfilms)",242,6578,499197,505775,carousel,FALSE
CompanyJ_2868,"Caught it after the backflip  (via @pedroliveirafs, h/t @brfootball)",68,1538,193783,195321,video,FALSE
CompanyJ_2869,"WHAT. A. MATCH.  @djokernole defeats Roger Federer in a fifth-set tiebreak for his 5th Wimbledon title, 16th Grand Slam overall ",128,2266,286278,288544,image,FALSE
CompanyJ_2870,#NAME?,24,1442,280066,281508,image,FALSE
CompanyJ_2871,Giannis not allowing any buckets  (via @bucks),46,1341,232817,234158,video,FALSE
CompanyJ_2872,Miles Bridges broke out a special move out in Vegas  ( @powerade),65,1159,190857,192016,video,FALSE
CompanyJ_2873,Brock Lesnar cashes in Money In The Bank on Seth Rollins to become new WWE Universal Champion ,94,5217,293259,298476,image,FALSE
CompanyJ_2874,"Anthony Davis will not participate in USA Basketball training camp and FIBA World Cup to ""focus on championship quest with Lakers, per @chrisbhaynesnba",151,2052,424783,426835,image,FALSE
CompanyJ_2875,Drizzy getting in the trick shot game?  (via @champagnepapi),60,1760,255001,256761,video,FALSE
CompanyJ_2876,This years rookie class is showing out at Summer League ,56,454,100163,100617,video,FALSE
CompanyJ_2877,Devin Hesters son Dray is breaking ankles just like his dad @brgridiron  (via @devin_d_hester_23),97,1079,123692,124771,video,FALSE
CompanyJ_2878,"$170M, five-year max extension. @bensimmons just got paid, per @shamsnba ",73,9986,523684,533670,image,FALSE
CompanyJ_2879,@damianlillard in the past year:  Made his fourth ASG  Hit a legendary buzzer-beater  Reached the conference finals  Got a supermax deal  Today he turns 29. Whats next?,168,3369,338951,342320,carousel,FALSE
CompanyJ_2880,No flinching  @iamzlatanibrahimovic (h/t @brfootball),53,1082,185937,187019,video,FALSE
CompanyJ_2881,Did Madden get it right?  @brgridiron,37,17997,296349,314346,image,FALSE
CompanyJ_2882,Dubs are in on D-Lo ,20,3036,338127,341163,image,FALSE
CompanyJ_2883,Former No. 1 pick Anthony Bennett could be returning to the NBA for the first time since 2017 ,94,1487,167936,169423,video,FALSE
CompanyJ_2884,Everyone was jumping out of the gym during the @statefarm dunk contest at B/R Jump-Off ,87,190,70338,70528,video,FALSE
CompanyJ_2885,"The Cavs have waived JR Smith, per @shamsnba",44,10163,433951,444114,image,FALSE
CompanyJ_2886,OKC had a potential dynasty.  Then they had a contender. Now theyre headed toward a rebuild.,92,603,66596,67199,video,FALSE
CompanyJ_2887,Ben just got PAID. One of the coldest passers in the NBA will be in Philly for five more years  (@coorslight),109,1070,108668,109738,video,FALSE
CompanyJ_2888,The King and Board Man get the two highest #2KRatingsin 2K20  (via @brgaming),77,16844,560852,577696,carousel,FALSE
CompanyJ_2889,"Gonna need a new driver after this  (via @hunterprice_, @ty_morley4, @haydenchrist11)",85,1657,166259,167916,video,FALSE
CompanyJ_2890,@aarondonald99s footwork is not fair. That man is 280 POUNDS @brgridiron  (via @210ths),87,2105,235425,237530,video,FALSE
CompanyJ_2891,Arsenal brought out @jharden13 for their away kit release  (via @brfootball),76,1419,265859,267278,carousel,FALSE
CompanyJ_2892,Chucks advice for Zion,22,2174,392671,394845,image,FALSE
CompanyJ_2893,@demar_derozan is fed up with the old face filter  *NSFW*,57,1615,274152,275767,video,FALSE
CompanyJ_2894,Howd he pull that off?  (via @hamblow),38,2622,187747,190369,video,FALSE
CompanyJ_2895,FILTHY  (via @brfootball),25,1484,116074,117558,video,FALSE
CompanyJ_2896,#NAME?,45,3515,561966,565481,image,FALSE
CompanyJ_2897,"Summer Leagues over, but a new season is coming soon   Whats the coldest moment from last season?  (@coorslight)",112,693,110661,111354,video,FALSE
CompanyJ_2898,OKC GM Sam Presti calls Russell Westbrook the most important player in brief history of Thunder ,96,2532,422738,425270,carousel,FALSE
CompanyJ_2899,"Today in 2008: Brandon Jennings became the first American player to go straight from high school to Europe, signing with Italian pro team Virtus Roma",149,1402,285171,286573,image,FALSE
CompanyJ_2900,Bron brought AD over for Taco Tuesday  (via @kingjames),55,13891,950448,964339,video,FALSE
CompanyJ_2901,Bakers hyped for @obj  (via @brgridiron),40,2908,232426,235334,image,FALSE
CompanyJ_2902,"@cristianos control while dodging shots  (via @juventus, h/t @brfootball)",73,1346,167433,168779,video,FALSE
CompanyJ_2903,Giannis is too big for his own kicks tour car  (via @mike_juice14),66,634,191188,191822,video,FALSE
CompanyJ_2904,Enes Kanter used Kyries exact line on choosing No. 11 ,54,6313,492501,498814,image,FALSE
CompanyJ_2905,#NAME?,63,2362,528277,530639,image,FALSE
CompanyJ_2906,"Dame on his Game 5 winner against OKC: ""What can I say. That was for Seattle."" (via @sportsbusinessradio)",105,3982,437167,441149,carousel,FALSE
CompanyJ_2907,"Bheem Goyal, an 8-year-old with cancer, started in goal and got the save  (via @soundersfc)",91,415,98638,99053,video,FALSE
CompanyJ_2908,"On this day in 2002, Kobe pulled up at Rucker Park fresh off a three-peat.  Mamba balled and was dubbed ""Lord of the Rings,"" but the second half got rained out.  Vintage ",170,1580,318831,320411,carousel,FALSE
CompanyJ_2909,Dwights perspective has changed,31,2088,183789,185877,video,FALSE
CompanyJ_2910,Pennys game was pure magic. Happy birthday to @Iam1Cent ,56,2751,266345,269096,video,FALSE
CompanyJ_2911,"A year ago today, Raptors traded for Kawhi  Rested 22 regular season games  Game 7 game-winner vs 76ers in semis  Dunked on MVP twice in ECF  Led Raps to 3 straight road wins in Finals  Finals MVP for Torontos first title  Next chapter in LA will be wild ",255,1666,341633,343299,carousel,FALSE
CompanyJ_2912,"Barcelona have offered PSG $112M + two players in exchange for Neymar, per @skysports ",86,3685,289767,293452,image,FALSE
CompanyJ_2913,(via @brkicks),14,292,121833,122125,video,FALSE
CompanyJ_2914,#NAME?,51,1269,292566,293835,image,FALSE
CompanyJ_2915,@patbev21 got a career payday this summer ($40M). One of his first moves: Buying mom a new house ,97,2020,388308,390328,carousel,FALSE
CompanyJ_2916,"23 years ago today, Shaq signed with the Lakers ",48,1786,412618,414404,carousel,FALSE
CompanyJ_2917,"17 years ago today, the Spurs signed Manu Ginobili after taking him with the 57th pick in the 1999 NBA draft. 4 NBA titles 2x All-Star 2008 Sixth Man of the Year No. 20 retired by Spurs  What a story.",200,2275,343836,346111,carousel,FALSE
CompanyJ_2918,"Road to recovery  (via @easymoneysniper, @iamomeez)",51,3236,472569,475805,carousel,FALSE
CompanyJ_2919,"Wades daughter isnt even one, and shes swimming already  (via @dwyanewade, @kaaviajames)",88,3344,266157,269501,carousel,FALSE
CompanyJ_2920,Lance Stephensons daughter reenacted his poster and guitar celebration and its on point  (via @stephensonlance),111,1180,181643,182823,video,FALSE
CompanyJ_2921,The King raising a winner  (via @br_hoops),42,1671,307216,308887,image,FALSE
CompanyJ_2922,Shaq is always with the vibes  (via @killthenoise),50,5441,487738,493179,video,FALSE
CompanyJ_2923,Everybody needs Aaron Boone energy,34,1863,273125,274988,image,FALSE
CompanyJ_2924,Harden is comedy  (via @kennooodeeezz_),39,2668,384493,387161,video,FALSE
CompanyJ_2925,"23 years ago today, Muhammad Ali shocked the world by lighting the torch at the 1996 Olympics in Atlanta after getting diagnosed with Parkinsons disease in 1984.  Forever legend ",178,874,240042,240916,carousel,FALSE
CompanyJ_2926,#NAME?,59,954,128217,129171,video,FALSE
CompanyJ_2927,"""Ferrari among Fiats""  @iamzlatanibrahimovic backed his talk up with a hat trick against LAFC ",94,945,179132,180077,carousel,FALSE
CompanyJ_2928,Sierra Canyon promises to be a show next season  @br_hoops,58,3627,421053,424680,image,FALSE
CompanyJ_2929,Ray Allen turns 44 today   Jesus Shuttleworth forever  Helped Boston win first ring in 22 years  Took THE corner 3 in 2013 Finals What a career.,144,1818,358706,360524,carousel,FALSE
CompanyJ_2930,"This is what happens when you're Team No Shoes, @patmcafeeshow  #BaHaMarShowdown (@theshowdowngolf)",99,571,78774,79345,video,TRUE
CompanyJ_2931,"JR Smith, Scottie Pippen and Aaron Rodgers took their talents to the golf course in a Team NBA vs. Team NFL battle for charity   @cdwcareers",140,310,76380,76690,video,FALSE
CompanyJ_2932,No ankles are safe at James Hardens camp  (via @jharden13),58,2769,172881,175650,video,FALSE
CompanyJ_2933,1st career grand slam for @vladdyjr27  (via @mlb),49,592,115172,115764,video,FALSE
CompanyJ_2934,This pitch  (via @mlb),22,3766,260318,264084,video,FALSE
CompanyJ_2935,Manny Pacquiao wins the WBA World Welterweight Title at 40 years old and hands Keith Thurman his first pro loss!  #PacquiaoThurman,130,6100,655245,661345,carousel,TRUE
CompanyJ_2936,6 legends will be added to rare company in Cooperstown,54,721,96862,97583,image,FALSE
CompanyJ_2937,Shane Lowry wins at Royal Portrush for his first career major title ,68,342,56842,57184,image,FALSE
CompanyJ_2938,Trae Young dropped 31 PTS in his debut at @drewleague  (via @br_hoops),70,1448,215595,217043,video,FALSE
CompanyJ_2939,"""If you're only making yourself better then you don't stand a f--king chance to ever play in the NBA."" That's real. (via @ricohinesbball)",137,1471,184842,186313,video,FALSE
CompanyJ_2940,He got rolled up in the tarp  (via Randy Wesley),48,2952,246309,249261,video,FALSE
CompanyJ_2941,Someone get Pete Alonso a new bat  (via @mlb),45,1775,257757,259532,carousel,FALSE
CompanyJ_2942,"A bettor put $150 down on Shane Lowry to win The Open at 105-1 odds and won nearly $16,000  (via lsuslick/Twitter | h/t @br_betting)",132,1120,178554,179674,image,FALSE
CompanyJ_2943,LSUs new locker room is WILD  (via @_31savage),46,6274,496277,502551,video,FALSE
CompanyJ_2944,#NAME?,67,1351,298463,299814,carousel,FALSE
CompanyJ_2945,Adam Lefkoe coaches him on how to handle the social media gauntlet   From B/R x @MbyMichaelStrahan x @JCPenney,110,142,58481,58623,video,FALSE
CompanyJ_2946,Tim Duncan is joining the Spurs as an assistant coach. Pop approves ,68,2342,519169,521511,image,FALSE
CompanyJ_2947,Can't wait to see these fits on the Spurs sideline ,51,1236,251782,253018,carousel,FALSE
CompanyJ_2948,"Basketball's next generation has been getting some help from courtside stars like LeBron, D-Wade and Blake Griffin  (@br_hoops)",127,273,99252,99525,video,FALSE
CompanyJ_2949,LaMelo put up 21 points at the Drew League in a win for Team No Shnacks  (@br_hoops),84,1814,170742,172556,video,FALSE
CompanyJ_2950,Tyler Herro is A BUCKET.  15/16 from behind the arc  (via @miamiheat),69,2688,211365,214053,video,FALSE
CompanyJ_2951,"He overcame his fears and landed a 20"" box jump.  This is awesome (via @vinyardbrad, @nubabilityathletics)",106,23606,1121855,1145461,video,FALSE
CompanyJ_2952,From no scholarship to Browns contract. Damon Sheehy-Guiseppis journey is incredible  (@brgridiron),99,9399,763760,773159,carousel,FALSE
CompanyJ_2953,NASTY off the bounce  (via @snipercv) @james.bouknight,54,643,118016,118659,video,FALSE
CompanyJ_2954,Breaking: Zion Williamson signs multiyear deal with Jordan Brand (@brkicks),75,4230,595533,599763,image,FALSE
CompanyJ_2955,#NAME?,51,9649,590408,600057,image,FALSE
CompanyJ_2956,Boxer Maxim Dadashev has died at age 28 from injuries suffered in a fight this past Friday,90,11023,501420,512443,image,FALSE
CompanyJ_2957,Bron knows that fresh cut feeling  (via @kingjames),51,2354,135594,137948,video,FALSE
CompanyJ_2958,Kostas Antetokounmpo to LA got the internet talking about Giannis free agency in 2021 ,86,1028,175372,176400,video,FALSE
CompanyJ_2959,CP3 showed the kids why he's a 9x All Star at his 10th Annual CP3 Elite Guard Camp  (@br_hoops),95,684,76327,77011,video,FALSE
CompanyJ_2960,"""What it do, Mannyyyy"" (via @mannypacquiao)",43,2589,574538,577127,image,FALSE
CompanyJ_2961,Team Elena and Team A'ja are set for #WNBAAllStar  (h/t @wearejayla)  EDD -Brittney Griner -Jonquel Jones -Kia Nurse -Jewel Loyd (Aja Wilson out for ASG) -Diamond DeShields -Liz Cambage -Natasha Howard -Chelsea Gray -Kayla McBride,230,1864,90922,92786,image,TRUE
CompanyJ_2962,Whole crowd was going along with 'Baby Shark'  (via @mlbcut4),61,2850,182842,185692,video,FALSE
CompanyJ_2963,Yankees came out on top vs. Twins in an instant classic  35 hits 26 runs 17 strikeouts 14 walks 10 innings Six home runs  One hero @ahicks31 (via @mlb),151,745,145393,146138,carousel,FALSE
CompanyJ_2964,Preach ,7,1260,131958,133218,image,FALSE
CompanyJ_2965,"Bron's still the record holder for rookie shoe deals, but Zion's the new king of Jordan",87,557,112272,112829,video,FALSE
CompanyJ_2966,"No social media paragraph ""thank you"" from Kawhi, but he still has love for Raps fans ",86,4494,546919,551413,video,FALSE
CompanyJ_2967,That Cali connection ,21,4147,544233,548380,carousel,FALSE
CompanyJ_2968,Clippers made the playoffs last year ,37,3669,290748,294417,carousel,FALSE
CompanyJ_2969,#NAME?,51,6533,348519,355052,image,FALSE
CompanyJ_2970,"Actually broke his ankles  (via u/x1verson, h/t @brgaming)",58,2504,264164,266668,video,FALSE
CompanyJ_2971,"Kawhi says he was ""very close"" to choosing Lakers or Raptors before Clippers, per @rachel_nichols",97,3117,380405,383522,image,FALSE
CompanyJ_2972,DSJ between-the-legs alley in slow-mo  (via @harrington1313),60,1015,176142,177157,video,FALSE
CompanyJ_2973,Last Chance U star Ronald Ollie is getting his shot at the NFL  (@brgridiron),77,1398,123091,124489,video,FALSE
CompanyJ_2974,@obj showing off the hands  (via dan_labbe/TW),46,814,116152,116966,video,FALSE
CompanyJ_2975,"Mahomes is a cheat code in Madden 20  (via @brgaming, T_Riggard/TW)",67,4300,209400,213700,video,FALSE
CompanyJ_2976,Superman passed down the hero genes to Shareef (via @br_hoops),62,787,203127,203914,carousel,FALSE
CompanyJ_2977,Celtics officially sign Tacko Fall,34,3886,430738,434624,carousel,FALSE
CompanyJ_2978,"Irving shared the whole collection of his Spongebob x Nike Kyrie pack, set to drop August 10",92,3655,302189,305844,video,FALSE
CompanyJ_2979,Jimma Gatwech went under BOTH legs  (via @br_hoops),51,1518,139603,141121,video,FALSE
CompanyJ_2980,"Kyler and Larry looking ready for next season  (via @azcardinals, h/t @brgridiron)",82,915,114217,115132,video,FALSE
CompanyJ_2981,Zo gets a 79 rating on 2K  (via @nba2k),39,21690,485783,507473,image,FALSE
CompanyJ_2982,"J. Cole was holding his own against Trae, Melo & JR  (via @cbrickley603, @harrington1313)",89,2886,275266,278152,video,FALSE
CompanyJ_2983,"19-3, Red Sox over Yankees. Biggest win for Boston in rivalry history ",70,3104,258707,261811,carousel,FALSE
CompanyJ_2984,Beal vs. Tatum vs. CP3  (via @drewhanlen),41,3655,311506,315161,video,FALSE
CompanyJ_2985,"Mbappe is too smooth with it (via @psg, h/t @brfootball)",56,1111,172387,173498,video,FALSE
CompanyJ_2986,Always an uphill battle to  status,34,2156,348647,350803,image,FALSE
CompanyJ_2987,"AB pulled up to Raiders camp in a hot air balloon  (via @raiders, h/t @brgridiron)",82,1452,113597,115049,video,FALSE
CompanyJ_2988,"Thoughts on Houston, Russ? Its hot as hell ",43,3068,551919,554987,video,FALSE
CompanyJ_2989,Why not? ,9,1692,360934,362626,carousel,FALSE
CompanyJ_2990,Brodie and Beard already have experience together ,50,1109,237663,238772,image,FALSE
CompanyJ_2991,Bikini Bottom got the exclusives  @kyrieirving (via @brkicks),61,2033,396405,398438,video,FALSE
CompanyJ_2992,"Bobby Wagner and Seahawks have agreed on a 3-year, $54M contract extension, per @taylorrooks $40.2 fully guaranteed, making him the highest paid inside linebacker in the NFL  ( @brgridiron)",189,1254,218042,219296,image,FALSE
CompanyJ_2993,@jaygup is taking any and all ankles  (via @br_hoops | h/t @tiphoops),69,1604,161300,162904,video,FALSE
CompanyJ_2994,Play of the night from JP Crawford  (via @mlb),46,3675,298668,302343,video,FALSE
CompanyJ_2995,"At 19 years old, Neymar split an entire defense for the Puskas-winning goal of 2011  He did it on this day  @brfootball",119,530,169583,170113,carousel,FALSE
CompanyJ_2996,Liz stops by Kobe and Gigi to show love ,40,1258,220863,222121,video,FALSE
CompanyJ_2997,Vacation Klay remains undefeated  (via @shecks),47,1860,201550,203410,video,FALSE
CompanyJ_2998,Bron had to jump in the warm up line real quick  (via @qwik11hoops),67,3191,239153,242344,video,FALSE
CompanyJ_2999,Home run catch  Baby under arm  Dad of the year  (via @mlbcut4),63,1207,195625,196832,video,FALSE
CompanyJ_3000,WBA Super Featherweight Champion Gervonta Tank Davis is relentless  #DavisNunez (via @showtimeboxing),101,2860,210091,212951,video,TRUE
CompanyJ_3001,I made the three more famous than Steph - @chancetherapper ,59,4582,463338,467920,image,FALSE
CompanyJ_3002,Jeremy Lin opens up ,20,7674,460215,467889,image,FALSE
CompanyJ_3003,"Manu Ginobili turns 42 today.  Entered the league as:  57th pick  Unknown  Left as:  4x champ  2x All-Star  One of the GOAT sixth men  One of two players to win NBA, EuroLeague, Olympic titles",192,1146,267465,268611,carousel,FALSE
CompanyJ_3004,"DIDNT SEE THAT COMING  (via @jaimynho10, @streetsoccerbelgium)",62,1952,204359,206311,video,FALSE
CompanyJ_3005,"This battle  NY streetball is electric (via @manilove102, @april1stjust)",72,2106,168425,170531,video,FALSE
CompanyJ_3006,This pass is unreal  (via @brfootball),38,2407,207240,209647,video,FALSE
CompanyJ_3007,16-year-old Bugha wins the first Fortnite World Cup Solos title and takes home the $3M prize  (via @brgaming),109,18197,780706,798903,video,FALSE
CompanyJ_3008,"Antonio Browns son on the route, Derek Carrs son with the dime  Most adorable connection in the NFL  (via @ab | h/t @brgridiron)",128,1169,150407,151576,video,FALSE
CompanyJ_3009,"Summer Messi feeling himself  (via @antonelaroccuzzo, h/t @brfootball)",70,1091,123644,124735,video,FALSE
CompanyJ_3010,"This 13-year-old came in fifth place at the Fortnite World Cup, and could only hug his father after winning $900K  (via @k1ngao, h/t @brgaming)",143,13300,680344,693644,video,FALSE
CompanyJ_3011,Real Madrid was down 7-3 so this fan pulled out the Barca jersey... and the stadium wasnt having it  (via @melissaortiz5),121,3398,258195,261593,video,FALSE
CompanyJ_3012,"Carmelos trainer Chris Brickley says Melo is better than 70 percent of NBA players and wants one more ""farewell season"" to ""do what D-Wade did"" (via @breakfastclubam)",166,8400,510970,519370,image,FALSE
CompanyJ_3013,"Still driving it down the range at 90 years old  (via @jonpaullong, @bob.rowe.39)",81,1040,113957,114997,video,FALSE
CompanyJ_3014,"One year ago today, @kingjames opened the I Promise School. Changing lives  @brkicks",84,817,94798,95615,video,FALSE
CompanyJ_3015,Trae and Bembry playing tag in practice  (via @atlhawks),56,1216,237070,238286,video,FALSE
CompanyJ_3016,"DROPPED HIM. Thielen is surgical with it @brgridiron  (via @kstptv, @vikings)",77,2368,240845,243213,video,FALSE
CompanyJ_3017,"CJ McCollum has agreed to a 3-year, $100M contract extension.  His deal is now 5 years, $157M, per @wojespn",107,2510,380778,383288,carousel,FALSE
CompanyJ_3018,"17 years ago today, the legend @LisaLeslie threw down the first dunk in @WNBA history  (via @LA_Sparks)",103,6009,297338,303347,video,FALSE
CompanyJ_3019,@Kingjames taking the time to do a serenade before #TacoTuesday ,64,1771,139533,141304,video,TRUE
CompanyJ_3020,Mahomes can't stop dropping no-look dimes  (via @chiefsreporter |  @brgridiron),79,1665,193808,195473,video,FALSE
CompanyJ_3021,"Reds' Amir Garrett went at the Pirates all alone, Yasiel Puig still came to his defense after being traded to Cleveland for Trevor Bauer   Madness in Cincinnati",160,1518,310348,311866,carousel,FALSE
CompanyJ_3022,"Michael Thomas just got PAID. 5 years, $100M  @brgridiron",57,4360,355257,359617,image,FALSE
CompanyJ_3023,"12 years ago today: Kevin Garnett was traded to the Celtics, completing Bostons Big 3 ",86,1642,241980,243622,carousel,FALSE
CompanyJ_3024,"Ohio State freshman Ibrahima Diallo hadnt seen his family in over three years, so he went to Senegal to surprise them  (via Chris Holtmann)",139,3061,531733,534794,video,FALSE
CompanyJ_3025,"Trae Young has gained 12 to 16 pounds this offseason and plans to work on his midrange game with Kobe in August, per @crkirschner of @theathletichq",147,4667,500876,505543,image,FALSE
CompanyJ_3026,KD has built a total of 20 courts around the world   His latest: A court for the Bay Area before he left the Warriors (: @apexer),129,2401,386746,389147,carousel,FALSE
CompanyJ_3027,Jokic is somewhere in the woods shirtless showing off his dance moves  (via @negujmosrbski),91,3979,206940,210919,video,FALSE
CompanyJ_3028,"Classic story from Bakers debut last year:  When Baker stepped on the field for his first series, a Jets lineman started talking trash. The Browns O-line came off the field laughing at Baker's response: ""I don't even know who you are, man""  @brgridiron (via @diannaespn)",270,2307,430436,432743,carousel,FALSE
CompanyJ_3029,"D-Rose has a new tattoo added to the collection: a neck tat that says ""God Speed"" (via @killer_tattoos)",103,3730,293675,297405,video,FALSE
CompanyJ_3030,Gucci Mane playing pickup with Michael Vick and Lonnie Walker IV  (via @laflare1017),84,1285,162408,163693,video,FALSE
CompanyJ_3031,"Aaron Donald is ranked No. 1 overall in the #NFLTop100   Top 5: 1. Aaron Donald 2. Drew Brees 3. Khalil Mack 4. Pat Mahomes 5. Todd Gurley (via @nflnetwork, h/t @brgridiron)",173,4367,347101,351468,image,TRUE
CompanyJ_3032,"Lance Stephenson has reached a 1-year, $4M agreement with Liaoning of the Chinese Basketball Association, per @chrisbhaynesnba",126,8933,475942,484875,image,FALSE
CompanyJ_3033,"Eight years ago today, KD pulled up at Rucker Park during the lockout and dropped 66  EASY MONEY (via @tnas04, GreMar Enterprises / @freshfocussports)",150,4198,418936,423134,video,FALSE
CompanyJ_3034,"This chip  (Via @remythe3rd, h/t @brfootball)",45,1028,153347,154375,video,FALSE
CompanyJ_3035,"Beginning tonight, there wont be a week without football until Feb. 2.  27STRAIGHTWEEKS @brgridiron",99,4409,444315,448724,image,FALSE
CompanyJ_3036,Ed Reed is ready to become a Hall of Famer  (h/t @brgridiron),61,1174,248268,249442,image,FALSE
CompanyJ_3037,"Ball got deflected and Juwan Winfree STILL came up with the TD  (via @nick_griffith_tv, h/t @brgridiron)",104,952,178050,179002,video,FALSE
CompanyJ_3038,Melo just wants answers.,24,20423,661751,682174,image,FALSE
CompanyJ_3039,"Mahomes is launching passes and the season hasnt started yet  (via TomKCTV5/Twitter, h/t @brgridiron)",101,3395,318726,322121,video,FALSE
CompanyJ_3040,Nathan Patterson signed an MLB contract with the As after he threw multiple pitches over 95 MPH in a Coors Light challenge  (via @picsbycrispy),143,3849,377132,380981,video,FALSE
CompanyJ_3041,LA could make it happen (via @br_hoops),39,3540,406245,409785,image,FALSE
CompanyJ_3042,Clippers vs. Lakers headlines this years Christmas matchups (h/t @wojespn),74,5475,679333,684808,image,FALSE
CompanyJ_3043,"Hawks are keeping a spot reserved for Vinsanity if he chooses Atlanta, per @theathletichq  Where would you like to see VC spend his final season?",145,7852,522776,530628,image,FALSE
CompanyJ_3044,"14-year-old @calder_hodge_qb5 is trying to become the first-ever double amputee QB in the NFL  Lions gave him a shot today and he delivered  (via @detroitlionsnfl, h/t @brgridiron)",180,2171,259942,262113,video,FALSE
CompanyJ_3045,Happy 42nd birthday @tombrady   Leagues oldest QB is still out here winning rings (via @brgridiron),99,651,85311,85962,video,FALSE
CompanyJ_3046,"From Reed to Gonzalez, yesterdays stars become legends today in Canton (via @brgridiron)",88,260,116654,116914,image,FALSE
CompanyJ_3047,"Draymond Green agrees to four-year, $100M max extension with Warriors, per @wojespn",83,7407,493302,500709,image,FALSE
CompanyJ_3048,"Canton, Ohio is where NFL legends go to rest  These Hall of Fans Honorees experienced football heaven  From B/R x @ford",119,93,27178,27271,video,FALSE
CompanyJ_3049,October 22nd is opening night and it should be a show   Battle of LA in Clips vs. Lakers Zions debut in Raps vs. Pels (h/t @shamsnba),133,2353,439309,441662,carousel,FALSE
CompanyJ_3050,"Ed Reed acted like a Hall of Famer off the field too (via @nflthrowback, h/t @brgridiron)",89,1729,293428,295157,video,FALSE
CompanyJ_3051,Jayson Tatum was a walking bucket at @rumphclassic  (via @br_hoops),67,1739,215499,217238,video,FALSE
CompanyJ_3052,"Last time Lakers-Clippers played on Christmas, Kobe was on his farewell tour",76,1134,291270,292404,carousel,FALSE
CompanyJ_3053,If you aint been a part of it at least you got to witness   ,60,1381,326674,328055,image,FALSE
CompanyJ_3054,Hall of Fame mindset  @brgridiron ,34,3316,494353,497669,carousel,FALSE
CompanyJ_3055,Tom Brady continues to age like fine wine   Two Hall of Fame careers in one @brgridiron,87,2968,311273,314241,image,FALSE
CompanyJ_3056,Dwayne @therock Johnson quietly announced his retirement from wrestling. The Peoples Champ goes down as one of WWEs all-time greats  (via @livekellyandryan),156,3062,400051,403113,carousel,FALSE
CompanyJ_3057,"This poster dunk contest  (via @the.tournament, @pumahoops)",59,3077,344817,347894,video,FALSE
CompanyJ_3058,"Tom Brady is signing a two-year extension with New England that will pay him $23M this year, per @AdamSchefter  TB12 becomes the sixth highest-paid QB in the league @brgridiron",176,1788,259178,260966,image,FALSE
CompanyJ_3059, x ,3,1412,255533,256945,image,FALSE
CompanyJ_3060,"19-year-old double amputee Felipe Nunes shredding at the X Games  (via @felipenunesskate, @davisonbob)",102,1278,130513,131791,video,FALSE
CompanyJ_3061,Keenan Allens route running  @brgridiron (via @chargers),56,3313,329103,332416,video,FALSE
CompanyJ_3062,ISO JOE 4-PT SHOT FTW  (via @thebig3),37,1993,282758,284751,video,FALSE
CompanyJ_3063,These Browns fans got OBJ to pull over his car and sign their license plate  @brgridiron (via @cantstick.2 @beautifullu13),122,1691,364722,366413,video,FALSE
CompanyJ_3064,#NAME?,63,714,141519,142233,video,FALSE
CompanyJ_3065,Hold up  @br_hoops,18,1357,196104,197461,video,FALSE
CompanyJ_3066,When Ozil chipped the keeper and took out two defenders before scoring  (via @brfootball),89,1863,220605,222468,video,FALSE
CompanyJ_3067,#NAME?,72,3821,173639,177460,image,FALSE
CompanyJ_3068,Cant catch this 7-year-old sprinter on the track or the football field  (via @blaze_813),88,1123,236807,237930,video,FALSE
CompanyJ_3069,Nobody is out-dunking Jimma Gatwech right now  (via @br_hoops),62,1461,195469,196930,video,FALSE
CompanyJ_3070,Rookie David Montgomery is running MEAN @brgridiron  (via @ChicagoBears),72,3386,258864,262250,video,FALSE
CompanyJ_3071,The Bay Area native and Dubs superfan had some tough decisions to make,70,1039,130655,131694,video,FALSE
CompanyJ_3072,"Another year of Vinsanity. Vince Carter has agreed to a deal to return to Hawks, per @wojespn",93,1281,211818,213099,image,FALSE
CompanyJ_3073,Giannis wants the glory for his country ,40,2106,332764,334870,image,FALSE
CompanyJ_3074,Isan Diaz's dad had the best reaction to his son taking deGrom deep for his first career MLB hit  (via @mlb),108,1063,217269,218332,video,FALSE
CompanyJ_3075,Wisconsin WR Aron Cruickshank (@ac_hollywood) went full OBJ  (via @badgerfootball),82,972,188802,189774,video,FALSE
CompanyJ_3076,The James family reminding us what day it is ,45,8255,627411,635666,video,FALSE
CompanyJ_3077,"John Wall thinks Melo should sign with the Nuggets to close out his career: It has to be a franchise you built something with, per Chase Hughes of @nbcswashington ( @nbahistory)",177,3068,313176,316244,carousel,FALSE
CompanyJ_3078,Baker  OBJ already looking unstoppable @brgridiron (via @clevelandbrowns),73,1954,230944,232898,video,FALSE
CompanyJ_3079,Damion has Cerebral palsy and he just overcame his fear of swimming by himself  (via @its.damiong),98,3843,331896,335739,video,FALSE
CompanyJ_3080,7-footer Chet Holmgren put the moves on Steph  (via @br_hoops),62,1716,189800,191516,video,FALSE
CompanyJ_3081,This kid is never going to forget the day Vlad Jr. signed his baseball  (via @mlbcut4),86,568,195726,196294,video,FALSE
CompanyJ_3082,PRECISION  (via @brfootball),28,1684,201545,203229,video,FALSE
CompanyJ_3083,"Drake really got his own celebration pics with the Larry OBrien (via @champagnepapi, @antsoulo)",95,1535,219511,221046,carousel,FALSE
CompanyJ_3084,#NAME?,29,6787,517136,523923,video,FALSE
CompanyJ_3085,"NBA will require every team to have a licensed mental health professional on retainer this year, per @sramick",109,5638,493528,499166,image,FALSE
CompanyJ_3086,Wild  (via @tumi_pitbull),25,991,163084,164075,video,FALSE
CompanyJ_3087,KD sets the record straight,27,1727,332007,333734,image,FALSE
CompanyJ_3088,Jalen Suggs 360 windmill  (via @br_hoops),41,818,106164,106982,video,FALSE
CompanyJ_3089,This RJ Davis cross had Steph shook  (via @br_hoops),52,1338,262635,263973,video,FALSE
CompanyJ_3090,"27 years ago today, the Dream Teamfeaturing NBA players for the first timewon Gold at the 92 Olympics ",102,2280,349345,351625,carousel,FALSE
CompanyJ_3091,#NAME?,50,482,106797,107279,video,FALSE
CompanyJ_3092,#NAME?,76,2455,193133,195588,video,FALSE
CompanyJ_3093,USA will pass on the opportunity to add Melo to the FIBA World Cup team,71,6033,249304,255337,image,FALSE
CompanyJ_3094,The Lakers got AD and the Clippers got Kawhi  but the Pelicans really won this NBA offseason,92,2014,124228,126242,video,FALSE
CompanyJ_3095,Moneyball  @damianlillard,25,1764,170325,172089,video,FALSE
CompanyJ_3096,Kuz and Swipa having a dunk-off  (via @nba),43,1582,257833,259415,video,FALSE
CompanyJ_3097,Daniel Jones caps off a perfect drive with a perfect throw  (via @nfl | h/t @brgridiron),88,2399,227483,229882,video,FALSE
CompanyJ_3098,"Damon Sheehy-Guiseppi slept outside a 24-hour gym during Browns tryouts. Now, he scored his first NFL TD.  Cant make this up  (via @thecheckdown | h/t @brgridiron)",163,4453,588921,593374,video,FALSE
CompanyJ_3099,Kyries latest sneaker collab is inspired by his love for Spongebob  @brkicks,76,748,108881,109629,video,FALSE
CompanyJ_3100,"Happy birthday, Prime Time  @brgridiron",39,423,144120,144543,carousel,FALSE
CompanyJ_3101,Bron had jokes for Paul over the 5 pound difference in Melos dumbbells  (via @cp3),82,1429,280212,281641,video,FALSE
CompanyJ_3102,@aarongordon builds a dream dunk contest with $15,49,935,258580,259515,video,FALSE
CompanyJ_3103,#NAME?,125,1223,187683,188906,video,FALSE
CompanyJ_3104,#NAME?,131,2159,500650,502809,carousel,FALSE
CompanyJ_3105,"Antonio Brown has told Raiders officials that he will not play again if he doesn't get to wear his old helmet, per @adamschefter  @brgridiron",141,19667,454128,473795,image,FALSE
CompanyJ_3106,AB is struggling with his new helmet (via @brgridiron),54,2109,216864,218973,video,FALSE
CompanyJ_3107,Donovan Mitchell giving his autographed shoes to a couple young fans is what its all about  (via @nbakicks),107,615,167927,168542,video,FALSE
CompanyJ_3108,Bryce Harper hit a homer while a heckler called him overrated  (via @mlb),73,3301,469326,472627,carousel,FALSE
CompanyJ_3109,"Real Madrid are now more likely than Barcelona to sign Neymar, per @leparisien_psg (h/t @brfootball)",100,2928,253084,256012,image,FALSE
CompanyJ_3110,THE AUDACITY  @jaygup (via @br_hoops),37,904,171276,172180,video,FALSE
CompanyJ_3111,James Harden gifted a group of family and friends $10K after he saw them fishing for food.  Incredible  (via @tpizzzle),119,1864,210124,211988,video,FALSE
CompanyJ_3112,Ja Morant turned 20 today   Never forget this poster.,53,1502,433752,435254,carousel,FALSE
CompanyJ_3113,Derrick Rose and Michael Beasley are now teammates   They went No. 1 & No. 2 overall in the 2008 NBA Draft,106,1917,385104,387021,carousel,FALSE
CompanyJ_3114,From B/R x @MbyMichaelStrahan x @JCPenney,41,199,82084,82283,video,FALSE
CompanyJ_3115,JUMPMAN 2019 ( @nba),20,1164,248397,249561,carousel,FALSE
CompanyJ_3116,This is what an NFL receiver sees during practice @brgridiron  (via @raiders),77,1393,245036,246429,video,FALSE
CompanyJ_3117,"Daniel James father died suddenly three weeks before he joined Manchester United. Today, he scored on his debut and dedicated his goal to his father   @brfootball",162,507,243209,243716,image,FALSE
CompanyJ_3118,"Serena Williams had to retire from the Rogers Cup with an injury, and her opponent Bianca Andreescu came over to comfort her. Respect  (via @sportsnet)",151,5287,689367,694654,carousel,FALSE
CompanyJ_3119,She's automatic with it  (via @leah_church3),44,3266,220461,223727,video,FALSE
CompanyJ_3120,Candace Parker might have the dime of the year for the WNBA season  (via @la_sparks),84,8708,278598,287306,video,FALSE
CompanyJ_3121,"""The one thing I won't do is drop the football""  @mohamedsanus hands are absurd @brgridiron (via @sidelinehustle)",113,1917,340454,342371,video,FALSE
CompanyJ_3122,Rich Paul wants kids to be able to follow in his footsteps,58,2198,225678,227876,image,FALSE
CompanyJ_3123,"Raheem Sterling is considering a $121M endorsement deal with Jordan Brand, per the Telegraph  (@brkicks, @brfootball)",117,2871,310072,312943,image,FALSE
CompanyJ_3124,"Jah is evolving his game (via @swishcultures, @mambasportsacademy)",66,3353,236451,239804,video,FALSE
CompanyJ_3125,Simone Biles is unreal   In the last 3 days:  1st woman to land double-double dismount  1st woman to do triple-double in competition on floor  Tied for most U.S. all-around titles (6),183,812,156270,157082,carousel,FALSE
CompanyJ_3126,The NCAA has removed the bachelor's degree requirement for agents looking to represent players testing the NBA process.  Agents must only be certified by the NBPA.,163,5093,407786,412879,image,FALSE
CompanyJ_3127,Turned on the WHEELS ,21,5630,327266,332896,video,FALSE
CompanyJ_3128,"The start of the NBA season   Zion debut vs. Raptors, battle of LA opening night  Celtics vs. Horford and Philly on Oct. 23  Clippers vs. GSW, Bucks vs. Rockets on Oct. 24  Luka vs. Zion on Oct. 25",197,825,260363,261188,carousel,FALSE
CompanyJ_3129,Cant wait for X-Mas day. These matchups are cold  (@CoorsLight),63,353,80329,80682,video,FALSE
CompanyJ_3130,"16 years ago today, 'Madden 2004 dropped and Mike Vick was immortalized as a video game legend  @brgridiron  Overall: 95  Elusiveness: 92  Speed: 95  Accuracy: 97  Throwing power: 98  Hit Stick created to stop him  Said character was better than Tecmo Bo (via @eamaddennfl, @thecheckdown)",288,3584,308782,312366,carousel,FALSE
CompanyJ_3131,"Dak has turned down a $30M/year deal and is seeking $40M/year, per @janeashleyslater  @brgridiron",97,23421,412179,435600,image,FALSE
CompanyJ_3132,It's been a fun MLB season on and off the diamond this year ,60,374,59688,60062,video,FALSE
CompanyJ_3133,Brady's still going strong  ( @brgridiron),42,1885,364267,366152,image,FALSE
CompanyJ_3134,Thats tough  (via @brianjackson20),34,3444,286074,289518,video,FALSE
CompanyJ_3135,Lonzo's new sleeve features: -MLK -Rosa Parks -Jackie Robinson -Malcolm X -Harriet Tubman -Barack Obama (Via @stevebutchertattoos),130,16702,499455,516157,video,FALSE
CompanyJ_3136,NBA stars vs. their former teams in 2019-20  (SWIPE),52,1928,367177,369105,carousel,FALSE
CompanyJ_3137,"NFL is forming an ""entertainment and social justice partnership"" with Jay-Z and Roc Nation, per @MarkMaske  Roc Nation becomes a co-producer of the Super Bowl halftime show  @brgridiron",185,2845,305857,308702,carousel,FALSE
CompanyJ_3138,"Browns were so happy to see Damon Sheehy-Guiseppi turn his dream to reality @brgridiron  (via @thecheckdown, @clevelandbrowns)",126,2342,590638,592980,carousel,FALSE
CompanyJ_3139,Bron had the kids join in on Taco Tuesday  (via @kingjames),59,4091,317785,321876,video,FALSE
CompanyJ_3140,Mane made Neuer look silly  (via @brfootball),45,531,77064,77595,video,FALSE
CompanyJ_3141,@magicjohnson turns 60 today. Happy birthday to a legend ,57,632,95423,96055,video,FALSE
CompanyJ_3142,"Big Ben and JuJu at Pittsburghs first practice following the death of WR coach Darryl Drake.  R.I.P. coach  (via @tjcoached, @247sports | @brgridiron)",150,3750,698304,702054,carousel,FALSE
CompanyJ_3143,Net stopped the ball but she still lost her beer ,49,1146,120697,121843,video,FALSE
CompanyJ_3144,"Clippers are ""closing in"" on hiring Ty Lue to be the top assistant to Doc Rivers, per @thesteinline",99,3674,332207,335881,image,FALSE
CompanyJ_3145,"Jalen Rose says he plays in a high-stakes, star-studded fantasy football league  @brgridiron  $10K buy-in  Seven years running  Mav Carter, Draymond play  KD ""got upset and left""  Bron finished last and stopped playing (via @getupespn)",235,3151,446491,449642,carousel,FALSE
CompanyJ_3146,What a goal this wouldve been from @cmpulisic  (@brfootball),60,1135,128228,129363,video,FALSE
CompanyJ_3147,K-Love & Liz Cambage want to keep the conversation about mental health going ,77,690,192986,193676,image,FALSE
CompanyJ_3148,J. Cole is money from long range  (via @Cbrickley603),53,2343,160055,162398,video,FALSE
CompanyJ_3149,Jon Gruden went full 'Dreams and Nightmares' in an instant @brgridiron  *NSFW* (via @hardknockshbo),99,3065,286598,289663,video,FALSE
CompanyJ_3150,"3 years ago today, @usainbolt had a historic photoshoot in Rio ",63,1197,433924,435121,carousel,FALSE
CompanyJ_3151,"Titans coach Mike Vrabel was chirping former teammate Tom Brady yesterday.  TB: ""Pay attention to your own s--t"" @brgridiron  (via @atozsports)",143,2966,352034,355000,video,FALSE
CompanyJ_3152,20-20-20. Nipsey wouldve been 34 today  @russwest44,51,2969,444151,447120,video,FALSE
CompanyJ_3153,Sierra Canyons whole starting five is Big Tyme  @br_hoops  @richforever,71,871,153821,154692,video,FALSE
CompanyJ_3154,Iso Joe is still a bucket  The 7-time All-Star cant be stopped in @thebig3,74,829,124181,125010,video,FALSE
CompanyJ_3155,"Breaking: DeMarcus Cousins has suffered a torn ACL, per @shamsnba",65,33265,622437,655702,image,FALSE
CompanyJ_3156,Brady keeping his rookies in check   @brgridiron,48,1181,289953,291134,carousel,FALSE
CompanyJ_3157,Brotherhood.  Players around the league send their best wishes to Boogie ,73,1084,203690,204774,video,FALSE
CompanyJ_3158,"The KIDS from Akron. (via @kingjames, @ipromiseschool)",54,2594,646986,649580,image,FALSE
CompanyJ_3159,"Three serious injuries in the last two years.  Stay strong and get better soon, Boogie. The game needs you ",107,2052,316111,318163,carousel,FALSE
CompanyJ_3160,Lamar Jackson went Madden in this run  (via @thecheckdown | h/t @brgridiron),76,5045,349589,354634,video,FALSE
CompanyJ_3161,Airplane Mode  (h/t @brgridiron),32,1021,197680,198701,image,FALSE
CompanyJ_3162,BRYCE HARPER HITS A WALK-OFF GRAND SLAM  (via @mlb),51,4486,477513,481999,carousel,FALSE
CompanyJ_3163,"I got a hook. I got a bridge. Ill do his ad-libs. Whatever you need, just let my people go.",91,538,82581,83119,video,FALSE
CompanyJ_3164,"A heckler told Bryce Harper he was $330M, 0-for-3. Harper told him to shut the fk up and then hit a walk-off grand slam  (via @schettino10, Edd Barcia)",151,4294,423302,427596,video,FALSE
CompanyJ_3165,"Ten years ago today, @usainbolt set the world record in the 100m dash: 9.58s ",77,962,280105,281067,carousel,FALSE
CompanyJ_3166,"Devin Booker handing out lessons to all his defenders  (via @swishcultures, @chrisjohnsonhoops)",95,4771,282297,287068,video,FALSE
CompanyJ_3167,"NFL is reinstating Patriots WR Josh Gordon, per @adamschefter (h/t @brgridiron)",79,3640,345269,348909,image,FALSE
CompanyJ_3168,"Jay-Z is going to have ""significant ownership interest"" in an NFL team, per @tmz_tv ( @brgridiron)",98,2011,227776,229787,carousel,FALSE
CompanyJ_3169,Looking forward to more Brady to Gordon this season @brgridiron  (via @nfl),75,2155,314465,316620,carousel,FALSE
CompanyJ_3170,SHEESH SPIDA  (via @nba),24,748,194959,195707,video,FALSE
CompanyJ_3171,"Tyson Fury announces rematch with Deontay Wilder is set for February 22nd, if they both win their next fights, via @noworneverespn ",131,3005,327465,330470,image,FALSE
CompanyJ_3172,"THE DISRESPECT  (via @titi_kone, @arturo6.national)",51,2469,277040,279509,video,FALSE
CompanyJ_3173,"AB made his week with the gifted glove  (via @raiders, h/t @brgridiron)",71,1415,183275,184690,video,FALSE
CompanyJ_3174,"Drumline @obj  (via @djmystro, h/t @brgridiron)",47,1038,195296,196334,video,FALSE
CompanyJ_3175,@kuz was getting a fit off and his fellow players weren't feeling it ,69,2023,212848,214871,image,FALSE
CompanyJ_3176,"That stiff arm was FILTHY  (via @nfl, h/t @brgridiron)",54,1320,169120,170440,video,FALSE
CompanyJ_3177,Stipe Miocic TKO's Daniel Cormier in their rematch to win the UFC Heavyweight championship  Nate Diaz beats Anthony Pettis after three years out of the octagon #UFC241,167,835,177571,178406,carousel,TRUE
CompanyJ_3178,Stipe got the best of DC tonight  #UFC241,41,1018,182522,183540,carousel,TRUE
CompanyJ_3179,"Lakers and Dwight Howard have ""mutual interest"" following Boogies ACL injury, per @shamsnba",91,7839,455177,463016,carousel,FALSE
CompanyJ_3180,Former Texas star and NFL running back Cedric Benson has died at age 36 in a reported motorcycle crash.  R.I.P. ,112,14240,577956,592196,image,FALSE
CompanyJ_3181,#NAME?,25,2757,434766,437523,image,FALSE
CompanyJ_3182,"On this day in 1992, Larry Bird retired at 35 as one of the greatest and most influential to ever play. (Swipe  @NBAHistory)",124,3818,442807,446625,carousel,FALSE
CompanyJ_3183,James Harden gets up a one-legged 3-pointer  #YooInMedia #OneLegChallenge (via @ricohinesbball),95,1551,177152,178703,video,TRUE
CompanyJ_3184,NBA rookies voted on their favorite player in the league:  LeBron - 38%  KD - 20%  Kawhi - 8%  Dame - 8%  Book - 5%  Harden - 5% (via @johnschuhmann),149,4636,423828,428464,carousel,FALSE
CompanyJ_3185,Need to see @obj break this out on Sundays @brgridiron  (via @clevelandbrowns),78,1949,264567,266516,video,FALSE
CompanyJ_3186,UH OH.  @brgridiron,19,7672,307776,315448,image,FALSE
CompanyJ_3187,"From throwing rockets in stadium challenges to striking out the side  The viral fan who threw 96 mph in a Coors Field challenge made his MiLB debut  (Via @tysmith_iu21, @njpatterson12, @cpatterson_75)",200,994,202735,203729,carousel,FALSE
CompanyJ_3188,"@saquons elusiveness is next level  (via @kgmadeit1, h/t @brgridiron)",69,1855,232470,234325,video,FALSE
CompanyJ_3189,"Eight months after tearing his Achilles, Emmanuel Sanders is back and making plays  (via @nfl, h/t @brgridiron)",111,1121,251117,252238,carousel,FALSE
CompanyJ_3190,"""Go find that kid who didnt get any offers essentially out of south Florida"" This @richeisenshow rant on Antonio Brown (SWIPE) @brgridiron",138,5670,469308,474978,carousel,FALSE
CompanyJ_3191,OBJ and Baker not playing around with the Giants  @brgridiron (SWIPE ),70,2584,248550,251134,carousel,FALSE
CompanyJ_3192,It's #NBABlockWeek. Never forget.,33,5466,436301,441767,carousel,TRUE
CompanyJ_3193,THEY BURNED EVERYONE ,21,1301,136396,137697,video,FALSE
CompanyJ_3194,"Russ foundation is starting an initiative to promote tech job skills for at-risk young adults.  Programs include coding, computer literacy, computer engineering, robotics, 3-D printing, drone piloting and more  (via @people)",224,3686,458937,462623,image,FALSE
CompanyJ_3195,"Today, Kawhi announced that every student in three SoCal school districts will receive new backpacks for the school year.  That's one million backpacks for the kids  (via @LAClippers)",183,1553,262704,264257,carousel,FALSE
CompanyJ_3196,Carli Lloyd nailed the 55-yard FG  (via @carlilloyd),52,1907,147179,149086,video,FALSE
CompanyJ_3197,"JR hit CJ with a blatant travel and J. Cole couldn't help but laugh  (via @harrington1313, @cbrickley603)",105,2457,277425,279882,video,FALSE
CompanyJ_3198,Dolphins coach Brian Flores played eight straight Jay-Z tracks at practice the day after WR Kenny Stills criticized HOVs new NFL partnership @brgridiron  (via @camerondwolfe),174,3707,301652,305359,carousel,FALSE
CompanyJ_3199,"This is how controllers get broken  (via /u/tompalainan, h/t @brgaming)",71,6599,309126,315725,video,FALSE
CompanyJ_3200,Whyd he celebrate by screaming and hitting a high note?  (via @ykosiris),72,2413,266008,268421,video,FALSE
CompanyJ_3201,Jaylon Smith got $64M from the Cowboys. He grinded to get there  @brgridiron,76,1988,336659,338647,carousel,FALSE
CompanyJ_3202,Trae weighs in on the double-team debate  (via @swishcultures),62,8456,423289,431745,carousel,FALSE
CompanyJ_3203,KD's siding with Book on the double-team debate ,48,5420,390221,395641,carousel,FALSE
CompanyJ_3204,Raiders gotta stop doing Hunter Renfrow like this on #HardKnocks  (@brgridiron),79,2189,360382,362571,carousel,FALSE
CompanyJ_3205,"Ben gonna break out this 3-point shot during the season?  (via @swishcultures, @chrisjohnsonhoops)",98,6538,222034,228572,video,FALSE
CompanyJ_3206,"Norman Powell bought his mom a 2020 Range Rover for her birthday  ""Is this not the bomb dot com?""  (via @normanpowell4)",119,995,179294,180289,video,FALSE
CompanyJ_3207,@melo went off at the Drew League all summer  Shout out to the youngest Ball brother on his 18th birthday! (via @br_hoops),122,878,102585,103463,video,FALSE
CompanyJ_3208,Patrick Mahomes gets surprised with his dream sneaker closet ,61,895,81939,82834,video,FALSE
CompanyJ_3209,"On this day in 2017, the Kyrie era ended in Cleveland when the Cavs traded Uncle Drew to Boston.  That run was timeless.",120,2439,324069,326508,carousel,FALSE
CompanyJ_3210,"Adam Thielen turns 29 today. He got into the NFL by paying $250 for a tryout. @brgridiron  Since then...  19 TDs  100-catch season  Back-to-back 1,000-yard seasons  Most consecutive 100-yard games (T-Calvin)  Team record for 100-yard games in a season (@nfl)",258,1683,304075,305758,carousel,FALSE
CompanyJ_3211,#NAME?,31,2262,196486,198748,video,FALSE
CompanyJ_3212,Carmelos 12-year-old son Kiyan got game  (via @cbrickley603),60,1942,183959,185901,video,FALSE
CompanyJ_3213,"Melvin Gordon pulled up to Popeyes for the new chicken sandwich but they ran out...  (via @melvin, h/t @brgridiron)",115,798,96950,97748,video,FALSE
CompanyJ_3214,"Dolphins coach Brian Flores opened up about player protests (via @wsvn, h/t @brgridiron)",88,3279,282604,285883,carousel,FALSE
CompanyJ_3215,"Happy birthday Kobe,  Best sneaker moments in his career  @brkicks",66,3481,664142,667623,carousel,FALSE
CompanyJ_3216,Tua and Trevor Lawrence enter the season as Heisman favorites   Will one of them be holding the hardware at the end of the season? (@br_betting),144,813,69686,70499,carousel,FALSE
CompanyJ_3217,"Dwight Howard is finalizing buyout with Grizzlies and plans to sign with Lakers, per @shamsnba",94,17005,749280,766285,image,FALSE
CompanyJ_3218,Lakers fans rn ,15,5360,357746,363106,video,FALSE
CompanyJ_3219,Updated look at the Lakers roster ,34,8072,562742,570814,carousel,FALSE
CompanyJ_3220,Pop wasn't trying to be interviewed  (via @7afl),48,1666,246371,248037,video,FALSE
CompanyJ_3221,Ronald Acua Jr. joins Mike Trout as the only players to record a 30 home run and 30 stolen base season under age 22 ,116,648,164206,164854,carousel,FALSE
CompanyJ_3222,"MICHAEL IRVIN IS READY FOR MIAMI VS. FLORIDA (via @mikecugnocbs4, @cbsmiami)",76,8278,378025,386303,video,FALSE
CompanyJ_3223,"From 8 to 24, Kobes killer instinct was unmatched. Happy #MambaDay",66,1145,199641,200786,video,TRUE
CompanyJ_3224,"From Shaq's trade to Miami to the 09 Finals vs. the Magic, relive @kobebryant's first title",91,1778,233173,234951,video,FALSE
CompanyJ_3225,Bronny out at 5am working on his dunk  (via @kingjames),55,1624,186293,187917,video,FALSE
CompanyJ_3226,"After training with @bronny, Gilbert Arenas sees something special ",67,2657,409718,412375,image,FALSE
CompanyJ_3227,Wont be long before #MambaDay is dedicated to Kobe and Gigi Bryant,66,926,237908,238834,carousel,TRUE
CompanyJ_3228,#NAME?,30,3606,416420,420026,carousel,FALSE
CompanyJ_3229,Alabama-Clemson rematch coming?  (@br_betting),46,378,49650,50028,carousel,FALSE
CompanyJ_3230,"If theres a shot to take, @maxisnicee knows its time to yell KOBE #MambaDay ",76,1488,179145,180633,video,TRUE
CompanyJ_3231,Russ and YG feeling it in Houston at James Harden weekend   (via @ashleeonair),78,1633,226137,227770,video,FALSE
CompanyJ_3232,Miami's Turnover Chain through the years  (via @canesfootball),62,1789,279209,280998,carousel,FALSE
CompanyJ_3233,"Breaking: Andrew Luck has informed the Colts he is retiring from the NFL, per @adamschefter (h/t @brgridiron)",109,17348,620222,637570,image,FALSE
CompanyJ_3234,"Andrew Luck is retiring from the NFL after 7 seasons:  2012 No. 1 overall NFL draft pick  171 touchdown passes  23,671 yards  4x Pro Bowl  2018 NFL AP Comeback Player of Year 53-33 record  Made the most of his time in the NFL  @brgridiron",238,3323,318631,321954,image,FALSE
CompanyJ_3235,Retiring wasn't easy for Luck. ( @brgridiron),45,1858,244450,246308,image,FALSE
CompanyJ_3236,@jharden13 is making a $240K+ donation to renovate Houston basketball courts in underserved communities  (H/T @bendubose),121,1913,329960,331873,image,FALSE
CompanyJ_3237,"Andrew Luck was on the sideline during Indys preseason game when news of his retirement broke. Colts fans booed him. Postgame, he said that it hurt. @brgridiron  (AngieD_DrD/Twitter)",182,3921,298726,302647,carousel,FALSE
CompanyJ_3238,Andrew Luck isnt the first superstar to end his career early... @brgridiron Barry Sanders - 31 Calvin Johnson - 30 Patrick Willis - 30 Rob Gronkowski - 29 Andrew Luck - 29  Jim Brown - 29 Gale Sayers - 28,204,3274,253483,256757,carousel,FALSE
CompanyJ_3239,Griezmann went @kingjames after scoring twice in his Barca home debut    (via @brfootball),90,1328,292168,293496,image,FALSE
CompanyJ_3240,Pops had enough of Patty Mills after he dropped 30 PTS in Australias win over Team USA  (via @olgunuluc),104,876,221642,222518,video,FALSE
CompanyJ_3241,Crowd in San Diego thought they were getting 'Sweet Caroline  (via @padres),75,2540,237713,240253,video,FALSE
CompanyJ_3242,Aaron Gordon and Dennis Smith Jr. decided to start their own dunk contest today  (via ManVsParty/Twitter),105,686,306142,306828,carousel,FALSE
CompanyJ_3243,"Arm strength   Accuracy   Wow. (via @ev_eis0812, @addisoncoquillard)",68,868,180152,181020,video,FALSE
CompanyJ_3244,BROWNS 3:16  Baker to Stone Cold is a dangerous duo (via @clevelandbrowns | @brgridiron) #straightupsteveaustin,111,1053,164696,165749,video,TRUE
CompanyJ_3245,Beard wants the step-back to become part of his legacy ,55,2255,237336,239591,carousel,FALSE
CompanyJ_3246,BICYCLE KICK FROM THE EDGE OF THE BOX  (via @esporteinterativo),63,1315,200192,201507,video,FALSE
CompanyJ_3247,"Boogie married longtime girlfriend Morgan Lang over the weekend  ( @dmitry_shumanev,  @matt_barnes9)",100,3961,457342,461303,carousel,FALSE
CompanyJ_3248,Mayweather vs. McGregor was two years ago today   Mayweather won by TKO in the 10th  Mayweather took home $275M  McGregor took home $85M,136,1634,275161,276795,carousel,FALSE
CompanyJ_3249,DSJ put on a show and went off for 50 at the Crawsover  (via @br_hoops),71,677,105051,105728,video,FALSE
CompanyJ_3250,Gruden tried to chase his QBs down in this drill  @brgridiron,61,1700,357611,359311,carousel,FALSE
CompanyJ_3251,Serena Williams defeats Maria Sharapova in the first round of the US Open  Serena moves to 20-2 all-time vs. Sharapova in head-to-head matches ,143,1097,144644,145741,image,FALSE
CompanyJ_3252,"James Harden turns 30 today.  Hes coming off one of the greatest scoring seasons ever.  36.1 PPG  Leader in FGs, 3s, PTs, FTs  28 40-point games  Nine 50-point games  Two 60-point games  Scoring champ by 8.1 PPG  Highest PPG ever besides MJ and Wilt",249,2504,393200,395704,carousel,FALSE
CompanyJ_3253,"There was a low chance Ryan Shazier would ever walk again after his injury. Now, hes not only walking, but throwing and catching the football.  Powerful  (via @turrondavenport |  @brgridiron)",191,2004,329710,331714,carousel,FALSE
CompanyJ_3254,NBA stars were turning out highlight reels at pickup runs all summer ,69,634,124166,124800,video,FALSE
CompanyJ_3255,Coach at Lyon College had cancer so the whole team shaved their heads with him. Powerful  (via @themikejun),107,1987,277908,279895,video,FALSE
CompanyJ_3256,"USWNT star Carli Lloyd is seriously considering pursuing a career as an NFL kicker, per Martin Rogers / @foxsports  Hit 55-yard FG at Eagles practice Several NFL teams have been in touch  One team offered her a preseason spot (via @brgridiron)",243,10810,367396,378206,carousel,FALSE
CompanyJ_3257,#NAME?,69,1700,295970,297670,image,FALSE
CompanyJ_3258,TMZ leaks audio of DeMarcus Cousins allegedly threatening to shoot ex-GF for not letting their son attend his wedding,117,12822,529279,542101,image,FALSE
CompanyJ_3259,It's just business for AB. @brgridiron,38,10465,318283,328748,image,FALSE
CompanyJ_3260,COMEBACK COCO  The 15-year-old takes care of business in the opening round to move on in the US Open ,101,719,136412,137131,carousel,FALSE
CompanyJ_3261,Pete Alonso's already setting records as a rookie ,50,839,123779,124618,image,FALSE
CompanyJ_3262,100 for 99.  Aaron Judge is the third-fastest player to reach 100 home runs in MLB history  (via @mlb),102,1015,186542,187557,carousel,FALSE
CompanyJ_3263, (via @patrickbetdavid),23,2405,356784,359189,carousel,FALSE
CompanyJ_3264,"Saquon says Brady challenged him when they met for the first time this summer @brgridiron  Its great to do it for one season, but can you do it for five? Can you do it for 10? Im standing thereready to run through a brick wall. (via Ryan Dunleavy | @njdotcom)",259,1545,348413,349958,image,FALSE
CompanyJ_3265,Jazz and Cavs are bringing back some vintage heat this season ,62,3142,480084,483226,carousel,FALSE
CompanyJ_3266,Dwight caught a stray in the Kobe vs. Shaq debate ,50,1908,281992,283900,carousel,FALSE
CompanyJ_3267,Texans running two-on-two games on garbage cans in the locker room @brgridiron  (via @jjwatt),93,1243,214258,215501,video,FALSE
CompanyJ_3268,"""It's the hardest decision of my life..."" Andrew Luck's NFL career was a rollercoaster of events (h/t @brgridiron)",114,297,45956,46253,carousel,FALSE
CompanyJ_3269,"Bold prediction from @killatrav: Chiefs are gonna pass the ball A LOT this season  (via @haroldrkuntz3, @fox4kc | h/t @brgridiron)",130,1286,252626,253912,video,FALSE
CompanyJ_3270,#NAME?,92,1793,194736,196529,video,FALSE
CompanyJ_3271,"Jaguars DC Todd Wash says Jalen Ramsey will shadow Tyreek Hill in Week 1  Last year, Ramsey called Hill a return specialist (via @mrbjack, h/t @brgridiron)",155,4519,294610,299129,carousel,FALSE
CompanyJ_3272,@brgridiron *NSFW*,18,3313,230687,234000,video,FALSE
CompanyJ_3273,"Barcelona and PSG are close to agreeing a deal for Neymar, per @gianlucadimarzio (h/t @brfootball)",98,1903,244888,246791,image,FALSE
CompanyJ_3274,#NAME?,56,2869,322439,325308,video,FALSE
CompanyJ_3275,@patrickmahomes used to be scared of dogs - now hes got two that are 70+ lbs.,77,1188,115446,116634,video,FALSE
CompanyJ_3276,"Two years later, @jjwatts Hurricane Harvey relief fund is still changing lives  @brgridiron  $40M+ raised  239M meals served  1,183 homes rebuilt  971 childcare centers rebuilt (108,731 kids)",191,1043,206989,208032,image,FALSE
CompanyJ_3277,#NAME?,63,914,114610,115524,video,FALSE
CompanyJ_3278,"KD and Kyrie are ""pushing"" Nets to sign Melo  Brooklyn remains interested in potentially signing him, per @thefrankisola",120,6310,524070,530380,image,FALSE
CompanyJ_3279,"Ronaldo on his and Messi's rivalry: ""We shared this stage for 15 years, me and him. ... It's good to be part of the history of football."" ",138,4196,621250,625446,carousel,FALSE
CompanyJ_3280,Cant touch MJ  (via @brkicks),29,1989,197465,199454,image,FALSE
CompanyJ_3281,"An arrest warrant has been issued for DeMarcus Cousins on a domestic violence charge, per @byajperez",100,16017,532501,548518,image,FALSE
CompanyJ_3282,These #UCL matchups are going to be GOOD  (via @brfootball),59,533,96449,96982,carousel,TRUE
CompanyJ_3283,Zo had some words for the Lakers in his new single ,51,10767,463749,474516,image,FALSE
CompanyJ_3284,COCO GAUFF MOVES ON IN THE #USOpen  CoCo vs. Naomi Osaka next ,62,1078,176608,177686,image,TRUE
CompanyJ_3285,Kenyon Martin Jr. will attend IMG for a post-grad year and enter the NBA draft next spring (via @br_hoops),106,839,127927,128766,video,FALSE
CompanyJ_3286, (via @shaq),12,2052,366890,368942,image,FALSE
CompanyJ_3287,Minnesota WR Rashod Bateman had an OBJ-like TD catch ,53,2838,410953,413791,carousel,FALSE
CompanyJ_3288,ASUs Eno Benjamin TOOK FLIGHT ,30,669,199691,200360,carousel,FALSE
CompanyJ_3289,Defending champs are bringing these jerseys back next season ,61,3656,418076,421732,carousel,FALSE
CompanyJ_3290,Melo teaching Randle some moves in the gym  (via @tylerrelph10),63,1726,177788,179514,video,FALSE
CompanyJ_3291,Pop playing Heads Up! is pure comedy  (via @turner_myles),57,714,194369,195083,video,FALSE
CompanyJ_3292,Kobe wasn't looking for any games off ,38,4033,351348,355381,image,FALSE
CompanyJ_3293,Wisconsin RB Jonathan Taylor hit the ground running in their season opener:  183 total yards  4 total TD's  Supreme mouthpiece  Heisman endorsement from Mahomes  Set the bar high in Week One,190,1760,306196,307956,carousel,FALSE
CompanyJ_3294,"Eric Gordon and Rockets agree to 4-year, $76M max contract extension, per @shamsnba",83,2988,390305,393293,image,FALSE
CompanyJ_3295,"CFB Saturdays are back, and the mascots are ready!",50,459,116958,117417,image,FALSE
CompanyJ_3296,"The Bills are releasing RB LeSean McCoy, per @adamschefter.",59,4973,272290,277263,image,FALSE
CompanyJ_3297,The road to the College Football Playoff starts now. Who can run the table?,75,1821,222676,224497,video,FALSE
CompanyJ_3298,UGA has the most dedicated strength training in college sports,62,582,121398,121980,video,FALSE
CompanyJ_3299,"Seahawks and Texans have agreed to trade parameters on Jadeveon Clowney based on Clowney and other players passing physicals, per @jayglazer  @brgridiron",153,1718,227612,229330,carousel,FALSE
CompanyJ_3300,@NevadaFootball freshman kicker Brandon Talton hit the game-winner from 56 and got a scholarship postgame. Life-changing night  (SWIPE),135,820,270647,271467,carousel,FALSE
CompanyJ_3301,The Heisman Race is set to be a special one this season ,56,2625,219740,222365,image,FALSE
CompanyJ_3302,The Crimson Tide suffered a devastating championship loss last year. Now theyre looking for redemption ,103,698,124557,125255,video,FALSE
CompanyJ_3303,"Jadeveon Clowney to the Seahawks  Seattle acquires former Texans star for a 3rd-round pick, LB Jacob Martin and pass-rusher Barkevious Mingo, per @aaronwilson7128 ( @brgridiron)",177,2057,258637,260694,image,FALSE
CompanyJ_3304,16-year-old Ansu Fati scored his first goal for Barcelona in only his second appearance  (via @brfootball),106,979,209573,210552,image,FALSE
CompanyJ_3305,"Team USAs quest for gold starts tomorrow  Name some of the past teams coldest moments?""  @coorslight",100,572,110141,110713,video,FALSE
CompanyJ_3306,72-0 ,5,5859,538443,544302,image,FALSE
CompanyJ_3307,"Justin Fields broke records in his OSU in first start, 5 TDs most by QB in debut ",81,1961,309120,311081,carousel,FALSE
CompanyJ_3308,Seahawks GM John Schneider after pulling off a trade that Madden wouldnt even consider  SWIPE  @brgridiron,106,2238,330628,332866,carousel,FALSE
CompanyJ_3309,"The Browns are waiving Damon Sheehy-Guiseppi, the undrafted WR who talked his way into a tryout and slept outside a 24-hour gym before it.  Shoutout to Damon for chasing his dream  @brgridiron",192,8163,537221,545384,image,FALSE
CompanyJ_3310,Potential Heisman candidate Justin Herbert is throwing dimes all 2019. ,71,439,54956,55395,video,FALSE
CompanyJ_3311,"Dolphins are trading LT Laremy Tunsil and WR Kenny Stills to Texans for two first-round picks and a second-round pick, per @rapsheet, @mike_garafolo ( @brgridiron)",163,2238,222088,224326,image,FALSE
CompanyJ_3312,WHAT A GRAB  ( @nhtsagov),25,530,115296,115826,video,FALSE
CompanyJ_3313,"Last time Auburn played Oregon, at the 2011 BCS National Championship Game, Bo Nix was a 10-year-old fan  Now he's a true freshman QB starting for the Tigers tonight ",166,1149,313065,314214,image,FALSE
CompanyJ_3314,"Tua making his Heisman case early  26-31 passing 336 yards 4 TDs  Tide rolls over Duke, 42-3 ",93,2051,261026,263077,image,FALSE
CompanyJ_3315,"Almost 10 years since their National Championship game, Ducks lose another close one to the Tigers...",101,1544,155926,157470,video,FALSE
CompanyJ_3316,Bo Nix knows comeback victories  ( @NHTSAgov),45,686,123647,124333,video,FALSE
CompanyJ_3317,"LeSean McCoy and Chiefs agree to 1-year, $4M deal, per @adamschefter, h/t @brgridiron",85,1726,223482,225208,image,FALSE
CompanyJ_3318,#NAME?,37,1510,227793,229303,video,FALSE
CompanyJ_3319,Bare hand + beer hand = fan catch of the year candidate  (via @mlbcut4),71,1377,194117,195494,video,FALSE
CompanyJ_3320,JUSTIN VERLANDER NO-HITTER   Astros ace tosses his third career no-no to become only the 6th pitcher in MLB history with at least three,135,1241,220153,221394,image,FALSE
CompanyJ_3321,Iso Joe for the championship   Triplets win the BIG3 Championship behind Joe Johnson and coach Lisa Leslie (via @thebig3),121,1701,416852,418553,carousel,FALSE
CompanyJ_3322,Jalen Hurts put on a CLINIC in his Oklahoma debut   332 passing yards 176 rushing yards 6 TDs Sets school record for most yards in debut (508),142,1706,342739,344445,carousel,FALSE
CompanyJ_3323,From one No. 1 to the next  Oklahoma is in good hands with Jalen Hurts ,71,1140,330688,331828,image,FALSE
CompanyJ_3324,#NAME?,84,2070,249454,251524,video,FALSE
CompanyJ_3325,Melo to Brooklyn? ,18,1991,298311,300302,image,FALSE
CompanyJ_3326,"Gilbert Arenas says MJ told Kobe after a Wizards/Lakers game that he could wear the shoes but ""never fill them.""  Kobe got so mad that he didnt speak to teammates for two weeks.  When LA played the Wizards again, Mamba dropped 55.  (via The No Chill Podcast, @balldontstop, @no.chill.gil)",288,4862,600808,605670,carousel,FALSE
CompanyJ_3327,50 days until the new NBA season ,33,8734,745349,754083,carousel,FALSE
CompanyJ_3328,Tried to get fancy and it backfired big time   (via @danieljay1),64,1682,186730,188412,video,FALSE
CompanyJ_3329,This Alex Caruso mix goes hard  (via @lakers),45,4925,402460,407385,video,FALSE
CompanyJ_3330,The transfer window has officially shut!  Following the Neymar Saga all transfer window... (via @brfootball),108,972,189273,190245,image,FALSE
CompanyJ_3331,Browns LB Christian Kirksey showing love to Nipsey with his visor @brgridiron  (via @christiankirksey),102,4598,497953,502551,image,FALSE
CompanyJ_3332,Gunner Olszewski could be the Patriots' latest diamond in the rough @brgridiron ,80,1790,262707,264497,carousel,FALSE
CompanyJ_3333,"Same talent, new teams  (h/t @brfootball)",41,3544,379797,383341,image,FALSE
CompanyJ_3334,#NAME?,36,2049,230473,232522,image,FALSE
CompanyJ_3335,#NAME?,122,1367,326763,328130,carousel,FALSE
CompanyJ_3336,Smart money on Mahomes again?  @br_betting,42,1545,79368,80913,carousel,FALSE
CompanyJ_3337,"Lane Kiffins FAU backfield will feature Frank Gore Jr., son of the five-time Pro Bowler, in 2020",96,508,110314,110822,video,FALSE
CompanyJ_3338,"Jacoby Brissett doesnt have an agent. He negotiated his new two-year, $30M extension by himself.  Brissett: I dont want someone bulls--tting on my behalf. @brgridiron",166,5891,526395,532286,image,FALSE
CompanyJ_3339," #GridironHeights Season 4 Premiere  AB, Andrew Luck and Zeke hijack the wild offseason  @brgridiron",100,616,93816,94432,video,TRUE
CompanyJ_3340,Three Stripes squad looking like a super team after @ninja signed  (via @brkicks),81,2591,242681,245272,carousel,FALSE
CompanyJ_3341,"Breaking: ZEKE GOT PAID Cowboys sign Ezekiel Elliott to a six-year, $90M extension with roughly half guaranteed. Highest-paid RB in the NFL, per @RapSheet and @janeashleyslater  @brgridiron",189,5239,439521,444760,image,FALSE
CompanyJ_3342,"Zeke just surpassed Gurley as the highest-paid RB in NFL history  @brgridiron    $90M in new money  $50M guaranteed  $103M over eight years  $15M yearly (via @rapsheet, @janeashleyslater)",187,4319,358058,362377,image,FALSE
CompanyJ_3343,The Raiders fined AB and he was not happy  When your own team wants to hate... SWIPE@brgridiron,95,12200,399799,411999,carousel,FALSE
CompanyJ_3344,"Zeke signed the biggest RB deal ever today ($90M), and these three guys are thrilled about it  @brgridiron",106,1990,246712,248702,carousel,FALSE
CompanyJ_3345,THIS DUNK IS WILD (via @abscbnsports),37,3791,313438,317229,video,FALSE
CompanyJ_3346,Shareef and Bronny will be in the league in no time  @br_hoops,62,1191,259727,260918,carousel,FALSE
CompanyJ_3347,Lonzo says his manager had to carry extra ZO2s because theyd rip every quarter @brkicks  (via @lighthartedpodcast),114,2657,272471,275128,video,FALSE
CompanyJ_3348,"""That boy look like a Power Ranger""  Raiders were clowning on ABs new helmet *NSFW*   (@brgridiron | @hardknockshbo)",116,3806,429249,433055,video,FALSE
CompanyJ_3349, Hurts  Eason  Fields  Transfer QBs put up Heisman numbers in their new homes,77,458,88189,88647,video,FALSE
CompanyJ_3350,Dwight ready to maximize 2nd chance opportunity with the Lakers  (via @lakers),78,11232,335826,347058,video,FALSE
CompanyJ_3351,Deion Sanders is the only athlete ever to score an NFL touchdown and hit an MLB home run in the same week ,106,2901,465530,468431,image,FALSE
CompanyJ_3352,#NAME?,128,316,43140,43456,video,FALSE
CompanyJ_3353,"A Lisa Leslie statue is being considered as part of a Sparks negotiation for a new lease at Staples Center, per @arashmarkazi  It would be the first made on Star Plaza honoring a female athlete",193,3306,232170,235476,carousel,FALSE
CompanyJ_3354,"KD, week 12 update   @iamomeez",30,1291,293668,294959,carousel,FALSE
CompanyJ_3355,"Antonio Brown and Raiders GM Mike Mayock got into it on Wednesday and the team is planning to suspend AB, per @adamschefter ( @brgridiron)",138,10386,368681,379067,image,FALSE
CompanyJ_3356,"Antonio Brown and Raiders GM Mike Mayock did not get physical, but AB told Mayock he would hit him in the face.  Then he punted a ball and said, Fine me for that @brgridiron  (via @RapSheet,  @brgridiron)",204,17357,477688,495045,image,FALSE
CompanyJ_3357,"NFL season is here, and bets are rushing in before kickoff  These lineups could wind up being big wins in Week 1",112,90,23504,23594,video,FALSE
CompanyJ_3358,"Tonight, the climb begins  @brgridiron",38,294,47344,47638,video,FALSE
CompanyJ_3359,"Raiders are not planning to have WR Antonio Brown for Week 1, unclear if it's a suspension or if AB will be inactive, per @rapsheet",131,1942,206363,208305,image,FALSE
CompanyJ_3360,Nike will name a new sports research lab building after @kingjames  @brkicks Swipe ,83,1278,238179,239457,carousel,FALSE
CompanyJ_3361,Packers march into Soldier Field and win their season opener 10-3  @brgridiron,78,3627,329385,333012,image,FALSE
CompanyJ_3362,"Davante Adams didnt realize he had 3 players covering him  (via @thecheckdown, h/t @brgridiron)",95,1587,201938,203525,video,FALSE
CompanyJ_3363, (@brgridiron),14,5794,378077,383871,image,FALSE
CompanyJ_3364,"Falcons WR @mohamedsanu has a cannon, but his throw rating in Madden is only a 72  He launched balls in front of a ratings adjustor to fix that",143,362,50379,50741,video,FALSE
CompanyJ_3365,ADs impression of Bron on Taco Tuesday is on point  (via @nba2k #2kday),71,1006,165072,166078,video,TRUE
CompanyJ_3366,"Casually walks past LeBron, no big deal  (via @uninterrupted)",61,10942,641722,652664,video,FALSE
CompanyJ_3367,"Antonio Brown will play Monday night, per The Athletics Vic Tafur  @brgridiron",78,5985,302210,308195,image,FALSE
CompanyJ_3368,Antonio Browns heel turn late last year caught a lot of teammates by surprise.  @brgridiron,91,2621,273773,276394,image,FALSE
CompanyJ_3369,@dustinpoirier is a man on a mission at UFC 242 ,48,680,123567,124247,carousel,FALSE
CompanyJ_3370,Mexico picks up another W in the USA  (via @brfootball),55,1802,183160,184962,image,FALSE
CompanyJ_3371,@mikey gotta chill  (h/t @br_hoops),35,1765,229845,231610,video,FALSE
CompanyJ_3372,"Raiders voided Antonio Browns $29.125M guaranteed money in his deal after fining him $215,073.53 for conduct detrimental to the team, per @adamschefter",151,8504,417755,426259,image,FALSE
CompanyJ_3373,"Julio Jones, Falcons finalizing a multi-year extension that will make him NFLs highest-paid receiver, per @tompelissero  @brgridiron",132,2992,365374,368366,image,FALSE
CompanyJ_3374,"Nate Diaz vs. Jorge Masvidal will headline UFC 244 in New York City on November 2, per @danawhite  Get your popcorn ready ",122,1719,233082,234801,image,FALSE
CompanyJ_3375,BREAKING: Raiders have released Antonio Brown @brgridiron,57,30874,655922,686796,image,FALSE
CompanyJ_3376,"ABs time in Oakland:   Cryotherapy frostbite  Helmet grievance  Threatened retirement  All-in or all-out  Posts fine on IG  Gets into it with GM  Apologizes, no suspension  Posts Gruden phone convo  Guarantees voided  Asks for release  Cut  Wild  @brgridiron",258,6231,433246,439477,image,FALSE
CompanyJ_3377,Gruden is finished with the AB saga  @brgridiron,48,2019,226233,228252,video,FALSE
CompanyJ_3378,Zaire is everybody mood with 2K out now but @dwyanewade still got daddy duties ,79,467,198073,198540,carousel,FALSE
CompanyJ_3379,No. 1 Clemson Tigers face their first test of the season vs. No. 12 Texas A&M Aggies ,85,616,170151,170767,image,FALSE
CompanyJ_3380,"@zionwilliamson threw down in the Air Jordan 34 in Harlem, New York.  (via @brkicks)",84,1117,217121,218238,video,FALSE
CompanyJ_3381,AND STILL  Khabib Nurmagomedov beats Dustin Poirier by submission in Round 3 to retain the UFC lightweight championship   28-0 #UFC242,134,3517,303247,306764,image,TRUE
CompanyJ_3382,"Antonio Brown close to signing deal with the Patriots, per @master_tesfatsion",77,11555,579954,591509,image,FALSE
CompanyJ_3383,"Breaking: Antonio Brown has agreed to terms with the Patriots, per @master_tesfatsion  @brgridiron",98,21906,670622,692528,image,FALSE
CompanyJ_3384,Belichick does it again... (@brgridiron),40,2645,359127,361772,image,FALSE
CompanyJ_3385,"AB gets the last laugh  Brown and Pats reach agreement on 1-year deal worth up to $15M ($9M signing bonus), per @adamschefter | h/t @brgridiron",143,4614,407018,411632,image,FALSE
CompanyJ_3386,@ab was on cloud nine after the Raiders released him  (h/t @ale.sticktalk) @brgridiron,86,15853,607258,623111,video,FALSE
CompanyJ_3387,The showdown of the week is in Austin.  Who ya got?,51,334,48045,48379,video,FALSE
CompanyJ_3388,AB and Brady = Prestige Worldwide  @brgridiron,46,2989,264753,267742,video,FALSE
CompanyJ_3389,History repeats itself  @brgridiron,35,5155,465689,470844,image,FALSE
CompanyJ_3390,Antonio Brown Josh Gordon Julian Edelman Demaryius Thomas  Pats wide receiver corps gonna be scary  (via @brgridiron),117,8847,535066,543913,image,FALSE
CompanyJ_3391,Joe Burrow went OFF in No. 6 LSUs win over No. 9 Texas  Swipe  Longhorns fans werent happy,90,988,185764,186752,carousel,FALSE
CompanyJ_3392,WEEK 1 IS HERE  @brgridiron,27,912,275420,276332,image,FALSE
CompanyJ_3393,Zion had NYC in awe  @game_stopper,34,966,242507,243473,carousel,FALSE
CompanyJ_3394,The @OBJ era begins in Cleveland today. About to be dangerous  (via @brgridiron),80,1572,200421,201993,video,FALSE
CompanyJ_3395,"Never change, Freddie  (via @mlbcut4)",37,2020,403653,405673,video,FALSE
CompanyJ_3396,Happy to have all these guys back in Week 1  @brgridiron,56,288,49722,50010,video,FALSE
CompanyJ_3397,"Vernon Davis is 35 and still doing this (via @nfl, h/t @brgridiron)",67,1173,251168,252341,carousel,FALSE
CompanyJ_3398,D-Jax is back  51 yards. Hes home. (Via @thecheckdown),54,1096,254464,255560,carousel,FALSE
CompanyJ_3399,Vernon Davis grandfather passed away yesterday. The veteran TE broke down in tears after his epic touchdown to begin the game.  Powerful  @brgridiron,149,1441,466229,467670,carousel,FALSE
CompanyJ_3400,Odell playing with a watch worth $350k  @brgridiron,51,11135,745034,756169,carousel,FALSE
CompanyJ_3401,#NAME?,158,448,157644,158092,image,FALSE
CompanyJ_3402,All Lamar today  @brgridiron  5 TD 17/20 324 yards 59-10 W Most points in franchise history,91,3669,538684,542353,image,FALSE
CompanyJ_3403,Clevelands season starts with a dud. Titans won by 30  @brgridiron,66,1322,164309,165631,video,FALSE
CompanyJ_3404,Lamar heard all the talk  5 passing TDs today @brgridiron,57,1792,319858,321650,image,FALSE
CompanyJ_3405,Titans werent buying into all the Browns hype  @brgridiron,58,1186,191102,192288,image,FALSE
CompanyJ_3406,Seahawks rookie DK Metcalf rocking a pacifier mouthpiece in his NFL debut  @brgridiron,86,2305,392851,395156,carousel,FALSE
CompanyJ_3407,"Dak and the Cowboys wrangled the Giants in Dallas, winning 35-17 @brgridiron  25-32 passing  405 yards  4 TD  158.3 passer rating",129,2290,281194,283484,image,FALSE
CompanyJ_3408,"Multiple Dolphins players called their agents to request trades after Miami's 59-10 loss, per @profootballtalk ( @brgridiron)",125,13326,514700,528026,image,FALSE
CompanyJ_3409,"Josh Gordon would not be denied on his way to this TD  (via @nfl, h/t @brgridiron)",82,2019,397634,399653,carousel,FALSE
CompanyJ_3410,Time hasn't slowed Brady down in year 20  @brgridiron  24-36 passing 341 yards 3 TD  Pats cruise to 33-3 win over Steelers,122,2538,399146,401684,image,FALSE
CompanyJ_3411,#NAME?,38,3489,540821,544310,image,FALSE
CompanyJ_3412,D-Jax will warm up in cleats honoring Nipsey Hussle every game and auction them off. Proceeds go to Nipseys family. Thats real    (@brkicks | @brgridiron),154,1026,263303,264329,carousel,FALSE
CompanyJ_3413,This angle of Colts safety Malik Hookers one-handed pick  @brgridiron (via @james_rivera66),91,1059,291989,293048,video,FALSE
CompanyJ_3414,Brows coming for DPOY ,22,3347,499947,503294,image,FALSE
CompanyJ_3415,"ABs departure wasnt bad for everybody in Oakland. @hardknockshbo star Keelan Doss is backand a whole lot richer  @brgridiron   Waived on cut-down day Joined Jags practice squad Returned to Raiders after AB left $300K signing bonus $495K fully guaranteed $795,000 and an active roster spot  (via @mike_garafolo)",310,1902,342116,344018,carousel,FALSE
CompanyJ_3416,How Messi and Ronaldos FIFA ratings have compared over the years   @brfootball @brgaming,88,1267,155882,157149,carousel,FALSE
CompanyJ_3417,"The NBA is banning ninja-style headwear this season, according to @wojespn",74,23242,571794,595036,carousel,FALSE
CompanyJ_3418,#NAME?,164,5643,429973,435616,image,FALSE
CompanyJ_3419,Gotta turn off the game if this happens  @brgaming (via @iamlozadamiguel),73,8891,431441,440332,video,FALSE
CompanyJ_3420,Pelicans in the house for Saints vs. Texans  @brgridiron (via @saints),70,1216,391092,392308,carousel,FALSE
CompanyJ_3421,June: David Ortiz was shot in the Dominican Republic  September: Big Papi returns to Boston to toss the first pitch at Fenway  (via @joon),138,974,253932,254906,carousel,FALSE
CompanyJ_3422,"WILL FULLER, HOW DID YOU DO THAT? (via @nfl | h/t @brgridiron)",62,1613,241653,243266,video,FALSE
CompanyJ_3423,Stone Cold is out here delivering perfect Stunners in 2019  (via @jeffjsays),76,4946,319973,324919,video,FALSE
CompanyJ_3424,DeAndre Hopkins went and SUPLEXED Marcus Williams after his interception  @brgridiron,85,2227,351155,353382,carousel,FALSE
CompanyJ_3425,"Raiders fans started a ""F--k AB"" chant in Oakland  @brgridiron *NSFW* (via @mikesteveritter)",92,5241,294904,300145,video,FALSE
CompanyJ_3426,Alvin Kamara is wearing custom VVS diamond grill made by Houston jeweler Johnny Dang  (via @master_tesfatsion | @brgridiron),124,3439,464691,468130,carousel,FALSE
CompanyJ_3427,"@alvinkamara was supernatural tonight vs. Houston  97 rushing yards  72 receiving yards  169 yards from scrimmage  Saints beat Texans on a game-winning FG, 30-28 (@brgridiron)",175,1667,325382,327049,image,FALSE
CompanyJ_3428,Wil Lutz 58-yarder for the WIN  @brgridiron  Saints put together the game-winning drive with 37 seconds left (via @nfl),119,1363,182968,184331,video,FALSE
CompanyJ_3429,#BigLegLutz (via @brgridiron),29,1020,213423,214443,image,TRUE
CompanyJ_3430,Drew Brees is at his best with the game on the line  (@brgridiron),66,1570,214876,216446,image,FALSE
CompanyJ_3431,Chucky coached the Raiders to a beatdown win vs. the Broncos  (via @brgridiron),79,909,134601,135510,video,FALSE
CompanyJ_3432,The next Manning QB is here. 14-year-old Arch is next up  (via @brgridiron),75,1341,204454,205795,video,FALSE
CompanyJ_3433,#NAME?,36,3676,289011,292687,image,FALSE
CompanyJ_3434,"Jerry Rice thinks AB was plotting to get to the Patriots all along since the Steelers wouldnt trade him there  The NFL wont investigate his chaotic departure from the Raiders  @brgridiron  (via @957thegame, @peter.king8)",220,2786,360810,363596,carousel,FALSE
CompanyJ_3435,"""Get the right jersey, son""  Cowboys DE DeMarcus Lawrence signs for Dallas fans only (via @1freedrug)    @brgridiron",116,20089,455300,475389,video,FALSE
CompanyJ_3436,The dummy nutmeg from Suarez ,29,769,127842,128611,video,FALSE
CompanyJ_3437,Michael Jordan announces hell donate $1M to hurricane relief in the Bahamas ,76,6480,562860,569340,image,FALSE
CompanyJ_3438,Quenton Nelson flattened him  @brgridiron (via @colts),54,2231,161081,163312,video,FALSE
CompanyJ_3439,The Browns thought they could take the title of Americas Team  #GridironHeights,79,1300,158066,159366,video,TRUE
CompanyJ_3440,"Odell reportedly broke an NFL rule prohibiting hard objects by wearing a $200K Richard Mille watch against the Titans. OBJ says its only a big deal because its him, and he plans to wear it again @brgridiron   (via @rapsheet, @marykaycabot)",239,8987,545816,554803,carousel,FALSE
CompanyJ_3441,"Antonio Brown accused of sexually assaulting and raping a woman who attended college with him, per Ben Shpigel of the @nytimes.",127,41768,549641,591409,image,FALSE
CompanyJ_3442,"Reigning NL MVP Christian Yelich suffered fractured knee cap and is out for the season, team announces",102,4389,317270,321659,image,FALSE
CompanyJ_3443,Fresh Prince of Bel-Air debuted today 29 years ago. Had some of the best athlete cameos:  Ken Griffey Jr.  Kareem Abdul-Jabbar  Evander Holyfield  Bo Jackson  Isiah Thomas  A certified classic.,193,867,288321,289188,carousel,FALSE
CompanyJ_3444,"Team USA goes down  France defeats America, 89-79, to advance to the World Cup semifinals.",90,13802,492080,505882,image,FALSE
CompanyJ_3445,"A decade ago today, Michael Jordan delivered his GOAT Hall of Fame speech.   Rebuffed the media saying Magic and Bird were better  Rubbed salt in Bryon Russell's '98 Game 6 wounds   Said HS coach ""made a mistake"" picking Leroy Smith over him...with Smith in the crowd",267,2716,490491,493207,image,FALSE
CompanyJ_3446,Messis son practicing celebrating like dad  (via @antonelaroccuzzo),67,425,91327,91752,video,FALSE
CompanyJ_3447,NFL owner @dwyanewade?  @brgridiron,35,1776,239192,240968,image,FALSE
CompanyJ_3448,"The world changed on Sept. 11, 2001. Former @azcardinals star Pat Tillman, who was later killed in Afghanistan, shared his thoughts. (SWIPE)  R.I.P.  @brgridiron",161,3298,484280,487578,carousel,FALSE
CompanyJ_3449,"California Senate unanimously passed a bill that would allow college athletes to profit from their names and likenesses, per @latimes",133,3326,246720,250046,image,FALSE
CompanyJ_3450,"LeBron James' trademark application for ""Taco Tuesday"" has been refused by the U.S. Patent & Trademark Office, per @joshgerbenshow (via @kingjames)",147,8162,492184,500346,carousel,FALSE
CompanyJ_3451,"Their PE teacher tore his hamstring and ACL while racing a student, so they gifted him brand new Jordans and his reaction was priceless  (via @maxxmontague | @brkicks)",167,1450,179075,180525,video,FALSE
CompanyJ_3452,The Patriots Nike Air Force 1 comes with Super Bowl LIII confetti  @brkicks X @brgridiron --- (via @josh__rosen),112,4304,307645,311949,carousel,FALSE
CompanyJ_3453,35 years ago today: The Bulls signed No. 3 draft pick Michael Jordan.  His rookie season: - 28.2 PTS | 6.5 REB | 5.9 AST - Rookie of the Year - All-Rookie team,159,3036,348131,351167,carousel,FALSE
CompanyJ_3454,"Zlatan stays completely unbothered  (via @christie_welsh, h/t @brfootball)",74,1895,251791,253686,video,FALSE
CompanyJ_3455,Going all in on the Ravens this week? ,38,194,38849,39043,video,FALSE
CompanyJ_3456,@patrickmahomes best friend @nicshimonek delivers a custom Yeezy 700 from @theshoesurgeon,89,247,39035,39282,video,FALSE
CompanyJ_3457,Gronk would want his kids to know about his experience before they play football (@brgridiron),94,2807,383247,386054,image,FALSE
CompanyJ_3458,When Ronaldo hit a ROCKET from almost 40 yards out (@brfootball),64,964,126410,127374,video,FALSE
CompanyJ_3459,Is NBA 2K11 the greatest from the franchise? #nationalvideogameday,66,11523,595088,606611,image,TRUE
CompanyJ_3460,"@deandrehopkins was SCARY in high school  @brgridiron (via @gundi21, h/t @maxpreps)",83,1424,266445,267869,video,FALSE
CompanyJ_3461,Warren Sapp didnt hold back on OBJ  @brgridiron,47,5843,418002,423845,image,FALSE
CompanyJ_3462,Bucs stop Christian McCaffrey on a WILD game-winning 4th & 1 goal line stop  (@brgridiron),90,2481,271235,273716,carousel,FALSE
CompanyJ_3463,Kobe once skipped basketball for dance too... ,46,1156,268371,269527,carousel,FALSE
CompanyJ_3464,Sean McVay beat out Calvin Johnson for offensive player of the year in high school with plays like these ,105,140,41795,41935,video,FALSE
CompanyJ_3465,Shaun Livingston announced his retirement after 15 years in the league,70,2891,422210,425101,carousel,FALSE
CompanyJ_3466,"Raider RB Josh Jacobs shared a story on Nick Sabans go-to jokes while he was at Alabama: I caught like five passes in a row, and he was like. Hey Josh, if you wanna hold all the balls, hold deez (Via @danpatrickshow, H/T @brgridiron)",233,4672,493880,498552,image,FALSE
CompanyJ_3467,Canelo Alvarez (52-1-2) is moving up two weight classes to make his light-heavyweight debut on Nov. 2 at the MGM Grand vs. Sergey Kovalev (34-3-1) ,147,1929,171047,172976,image,FALSE
CompanyJ_3468,Zion really broke the golf club...  (via @pelicansnba),54,4264,314313,318577,video,FALSE
CompanyJ_3469,"He took his sneakers off to challenge the cop to a push-up challenge... all to lose  (via @ohnoitsdapopo, h/t @brkicks)",119,1075,184842,185917,video,FALSE
CompanyJ_3470,Donovan McNabbs precision and versatility should make him a  for the #PFHOF,75,560,37158,37718,video,TRUE
CompanyJ_3471,Messi sat the defender down  (via @brfootball),46,979,133917,134896,video,FALSE
CompanyJ_3472,"If you give a good pup a french fry, you're gonna have to give a good pup all the french fries  (via @mlbcut4)",110,958,154054,155012,video,FALSE
CompanyJ_3473,In this photo:  91 home runs  217 RBIs  Rookie of the Year  Future Rookie of the Year  Two future MVPs?,103,973,157734,158707,image,FALSE
CompanyJ_3474,"@tclarke, the No. 3 prospect in 2021, is reclassifying and committing to @KentuckyMBB for the 2020 season. BBN is getting a potential superstar  @br_hoops",154,790,170968,171758,carousel,FALSE
CompanyJ_3475,"Georgia fans held a 'pink out' to honor Wendy Anderson, Arkansas State coach Blake Anderson's late wife, who died of cancer  (via @dawgnation)",142,531,170269,170800,carousel,FALSE
CompanyJ_3476,"Last week, Cowboys DE DeMarcus Lawrence went viral for denying a young Giants fans autograph request and telling him to get the right jersey, son. Saquon reached out and invited the kids family to a game in November, is flying them out and giving them VIP treatment at MetLife, per @tmz_tv.  REAL. ( @1freedrug | @brgridiron)",325,10033,645807,655840,carousel,FALSE
CompanyJ_3477,J.K. Dobbins turned on Gamebreaker for this run ,48,794,207232,208026,carousel,FALSE
CompanyJ_3478,MISSISSIPPI STATE QB WENT FLYING ,33,6570,443030,449600,video,FALSE
CompanyJ_3479,16-year-old Ansu Fati scores AND assists just 7 minutes into his first Barcelona start  (via @brfootball),105,733,186481,187214,image,FALSE
CompanyJ_3480,Najee Harris is a CHEAT CODE ,29,2046,350317,352363,carousel,FALSE
CompanyJ_3481,HE WENT BEAST MODE ,19,2617,322657,325274,video,FALSE
CompanyJ_3482,Garrett Shrader was out ,24,2599,348814,351413,video,FALSE
CompanyJ_3483,"Julio Jones has been rocking Waffle House cleats. Its an old nickname but he says he got it because hes always open 24/7  @brgridiron, @brkicks (via @kelseylynneconway)",168,3036,427726,430762,image,FALSE
CompanyJ_3484,A's pitcher Mike Fiers decided to add a curve to his beard ,59,5606,371499,377105,carousel,FALSE
CompanyJ_3485,"Jalen Hurts continues his run at the Heisman   15-20 passing, 289 Yards, 3 TDs 14 carries, 150 yards, TD Oklahoma rolls past UCLA, 48-14",136,2156,384468,386624,carousel,FALSE
CompanyJ_3486,Tyson Fury defeats Otto Wallin via unanimous decision ,54,483,135640,136123,carousel,FALSE
CompanyJ_3487,Today we get a look at the future. Who you taking?  @brgridiron,63,2045,218454,220499,image,FALSE
CompanyJ_3488,What does @sterlingshepard do in his free time? He hits the links   Watch his golf game get put to the test in his @levis Advanced Stretch Jeans ,145,119,31356,31475,video,FALSE
CompanyJ_3489,Saints/Rams rematch today. We know what happened last time. But what if... @brgridiron,86,2550,254038,256588,video,FALSE
CompanyJ_3490,"Stefon Diggs with the Imma head out SpongeBob kicks   @brkicks X @brgridiron --- (via @MACHE275, @Vikings)",106,5267,706720,711987,image,FALSE
CompanyJ_3491,The legend of Adrian Peterson grows. Today he passed Jim Brown on the all-time rushing TD list. @brgridiron,107,659,149677,150336,image,FALSE
CompanyJ_3492,Titans OL David Quessenberry missed three seasons after 2014 due to cancer. He returned in 2017 but got waived last fall. Today he caught a TD from Marcus Mariota  @brgridiron   (@nfl),184,658,210592,211250,carousel,FALSE
CompanyJ_3493,Antonio Brown catches his first touchdown as a Patriot. 20-yard pass from Brady. (via @nfl),91,2378,314032,316410,carousel,FALSE
CompanyJ_3494,Lamar Jacksons first two games this season:  41/57  596 yards  7 passing TD  127 rushing yards  0 turnovers  0 snaps at WR  2-0  Its quiet for a lot of critics right now.  @brgridiron,183,4280,503649,507929,image,FALSE
CompanyJ_3495,@kelseyplum10 with the one-legged three point buzzer beater   James Harden couldn't believe it  (via @LVAces) (h/t @wearejayla),127,2663,229876,232539,video,FALSE
CompanyJ_3496,Cooper Kupp. INCREDIBLE. @brgridiron (via @nfl),47,971,104513,105484,video,FALSE
CompanyJ_3497,THAT WAS WILD. @dearicamarie for the win in an elimination game  (via @lvaces) (h/t @wearejayla),96,3613,223228,226841,video,FALSE
CompanyJ_3498,"Patrick Mahomes put on a show @brgridiron  30-44 passing  443 yards  4 TDs  Chiefs scored 28 unanswered to beat Raiders, 28-10",126,814,204483,205297,image,FALSE
CompanyJ_3499,Lamar vs. Mahomes is about to have next week going crazy  @brgridiron,69,4136,473881,478017,image,FALSE
CompanyJ_3500,Julio makes history  @brgridiron,32,826,203427,204253,image,FALSE
CompanyJ_3501,The Falcons had so much fun tonight  @brgridiron,48,2707,248882,251589,video,FALSE
CompanyJ_3502,"Drew Brees is likely out six weeks with a torn ligament in his thumb, per @RapSheet. Hell need surgery.",103,2735,219171,221906,image,FALSE
CompanyJ_3503,"Patriots WR Antonio Brown was accused of sexual misconduct by a second woman, according to Robert Klemko of @themmqb.",117,15152,476678,491830,image,FALSE
CompanyJ_3504,"Tomorrow, the Champions League returns   @brfootball",52,642,83086,83728,image,FALSE
CompanyJ_3505,Big Ben is out for the year. Steelers QB needs surgery on his elbow and will be placed on IR.,93,3431,229161,232592,image,FALSE
CompanyJ_3506,Shaun Alexander scored 15 TDs in five consecutive seasons. The former MVP was the definition of a workhorse. @profootballhof bound?  @ford  #PFHOF20,148,487,30934,31421,video,TRUE
CompanyJ_3507,Back-heel flick assist was wild  (via @brfootball),50,346,70018,70364,video,FALSE
CompanyJ_3508,D-Rose joins the ranks  @brkicks,32,1404,201946,203350,carousel,FALSE
CompanyJ_3509,"Jaguars CB Jalen Ramsey has requested a trade from Jacksonville  @brgridiron, per @adamschefter",95,42078,666161,708239,image,FALSE
CompanyJ_3510,RJ is already a Knicks legend ,30,3606,428712,432318,image,FALSE
CompanyJ_3511,OBJ back with the Richard Mille.  Only 10 made.  Worth $2.02 million  @brgridiron (h/t @master_tesfatsion),106,6723,555699,562422,image,FALSE
CompanyJ_3512,YOU KNEW OBJ WOULD DO THIS IN NEW YORK @brgridiron (via @thecheckdown),70,3199,434422,437621,video,FALSE
CompanyJ_3513,"Dolphins trade DB Minkah Fitzpatrick to Steelers for 2020 first-round pick, per @adamschefter",93,3491,350125,353616,image,FALSE
CompanyJ_3514,OBJ burned them for 89 yards. First TD as a Brown.  @brgridiron (via @nfl),74,2661,515291,517952,carousel,FALSE
CompanyJ_3515,The best of the best. The Champions League is BACK  (via @brfootball),69,472,62351,62823,video,FALSE
CompanyJ_3516,@bronny getting bouncier  (h/t @br_hoops),41,1005,154826,155831,video,FALSE
CompanyJ_3517,New era. Giants have named rookie QB Daniel Jones their starter.  @brgridiron,77,4527,431615,436142,image,FALSE
CompanyJ_3518,#NAME?,74,1188,229153,230341,carousel,FALSE
CompanyJ_3519,Daniel Jones time in NY. Giants fans have been ready  @brgridiron,65,1888,260963,262851,video,FALSE
CompanyJ_3520,Beard and Brodie coming for it ,31,2835,347306,350141,image,FALSE
CompanyJ_3521,Whyd he smack him like that?  @brfootball,41,2767,217247,220014,video,FALSE
CompanyJ_3522,Not easy being a QB the last few weeks  @brgridiron   Luck: Retired  Eli: Benched  Darnold: Mono  Foles: Broken collarbone  Brees: Torn thumb ligament  Cam: No timeline on foot injury  Ben: Season-ending elbow injury,216,2970,241074,244044,carousel,FALSE
CompanyJ_3523,Thursday Night Football? Somebody has to do it  #GridironHeights,64,954,145760,146714,video,TRUE
CompanyJ_3524,He really said I got this before skying the penalty  (via @brfootball),70,3252,218244,221496,video,FALSE
CompanyJ_3525,Does Chad Johnson Deserve Your 2020 Pro Football Hall of Fame Vote?  @profootballhof #pfhof20  From B/R X @ford,111,638,32762,33400,video,TRUE
CompanyJ_3526,"We need this, @kingjames. The Marathon Continues.  @brkicks",59,1701,204600,206301,carousel,FALSE
CompanyJ_3527,Ric Flair Drip   Offset pulled up to WWE SmackDown looking like the Nature Boy,78,1574,305001,306575,image,FALSE
CompanyJ_3528,"Just two weeks after getting traded to the Texans, Kenny Stills is already working with Houston police to start programs that build trust between officers and young people  @brgridiron   (via Mark Berman of @fox26houston)",221,3032,483579,486611,carousel,FALSE
CompanyJ_3529,One of the most feared defenders of all time  Is Troy Polamalu @profootballhof bound? #PFHOF20  From B/R X @ford,112,893,52375,53268,video,TRUE
CompanyJ_3530,This fan predicted @objs career-long touchdown and then let Jets fans hear about it @brgridiron    *NSFW* (via @kyelow4l),121,3331,629795,633126,video,FALSE
CompanyJ_3531,The first touch and turn from 18-year-old American Sergino Dest  @brfootball,76,1020,135453,136473,video,FALSE
CompanyJ_3532,"If you dont pass to Ronaldo, you better score ",46,975,137424,138399,video,FALSE
CompanyJ_3533,Neymar and Mbappe loving the PSG win  @brfootball,49,430,164250,164680,carousel,FALSE
CompanyJ_3534,"14-year-old Calder Hodge's legs were amputated at age two because of a rare disorder  Now, he has dreams of becoming the NFL's first double-amputee QB ",151,1799,150976,152775,video,FALSE
CompanyJ_3535,He juked out Steph Curry with his own signature move   7-footer Chet Holmgren is only a junior in high school and might be the next unicorn  (via @br_hoops),156,990,144138,145128,video,FALSE
CompanyJ_3536,"A scout who has watched @obj since college told B/Rs Mike Freeman that Odell is the ""best pure athlete in the history of the NFL, and maybe in sports history.""  @brgridiron",172,12703,584330,597033,carousel,FALSE
CompanyJ_3537,EDD  MVP. Unreal numbers:  - 19.5 PPG | 8.2 REB | 2.2 AST - 97.4 FT % (114-of-117) - 1st WNBA player with 50/40/90 - 1st to win MVP on two different teams,154,2201,120016,122217,image,FALSE
CompanyJ_3538,Still thinking about the fact @ozzie really did this  (via @mlbcut4),68,2353,325563,327916,video,FALSE
CompanyJ_3539,It only took eight years for Patrick Willis to join the @profootballhof conversation. Does the former Niners LB get your vote? #PFHOF20  From B/R X @ford,153,617,38630,39247,video,TRUE
CompanyJ_3540,Nike has cut ties with Antonio Brown (@brkicks),47,7500,341227,348727,image,FALSE
CompanyJ_3541,"AP really said hed truck someone in the front office  Remember, Washington benched him Week 1 @brgridiron - - - (via @darrenmhaynes)",132,985,258478,259463,video,FALSE
CompanyJ_3542,Larry Fitz has topped 100 yards in two straight games. Time to roll with him in fantasy again ,94,271,47514,47785,video,FALSE
CompanyJ_3543,No. 7 on the hat finally on the chest  First look at KD in the Nets threads  @brooklynnets,90,3016,467311,470327,image,FALSE
CompanyJ_3544,DeAndre Hopkins took 10 kids from the local Boys and Girls Club on a shopping spree with $200 gift cards each. He said hell never get tired of it @brgridiron  (via Mark Berman of @fox26houston),193,3243,513017,516260,carousel,FALSE
CompanyJ_3545,Tua Tagovailoa Is leading the way to the Heisman trophy this year (@localtoyotadealers),87,1265,140256,141521,video,FALSE
CompanyJ_3546,Jalen Ramseys time with the Jaguars is just about over  @brgridiron,67,1448,188351,189799,image,FALSE
CompanyJ_3547,Gardner Minshews dad is JACKED  @brgridiron,43,1981,330656,332637,image,FALSE
CompanyJ_3548,"Minshew Mania: A True Underdog Story  Gardner Minshew leads the Jags to their first win of the season, 20-7 over the Titans! (@brgridiron)",138,2314,414150,416464,image,FALSE
CompanyJ_3549,"Conor McGregor preparing for return to UFC action early next year, could fight Nate Diaz or Jorge Masvidal, per @tmz_tv",119,3007,235424,238431,carousel,FALSE
CompanyJ_3550,Bale really wasnt trying to hold the banner  @brfootball (h/t @esporteinterativo),81,1512,197171,198683,video,FALSE
CompanyJ_3551,The Beard been working on a lethal signature move ,50,1854,185736,187590,video,FALSE
CompanyJ_3552,"Darek Formella was informed that his father passed away three hours before kickoff. He kept the news to himself and played anyway.  In the 81st minute, he scored the winning goal for @sacrepublicfc. His reaction speaks for itself. ",231,1218,257611,258829,video,FALSE
CompanyJ_3553,"Calvin Johnson says he smoked weed after every game to avoid the rampant abuse of opioids in the league, per rosenberg_mike/TW, H/T @brgridiron",143,9780,722236,732016,image,FALSE
CompanyJ_3554,Ravens TE Mark Andrews is a legend already  @brgridiron,55,1683,249983,251666,carousel,FALSE
CompanyJ_3555,Breaking: Patriots have cut Antonio Brown,41,29220,700621,729841,image,FALSE
CompanyJ_3556,Antonio Brown's timeline of events.,35,6491,422978,429469,image,FALSE
CompanyJ_3557,Russ and Harden training to be the best 1-2 combo in the league  (via @ufcpi @officialeg10),91,1431,134189,135620,video,FALSE
CompanyJ_3558,"Rage quitting would be justified here  (via u/Paxopoxo/Reddit, h/t @brgaming)",77,1294,164780,166074,video,FALSE
CompanyJ_3559,"Texans rookie CB Lonnie Johnson Jr. will pay for the funeral of 14-year-old Curtis Walton Jr., who played football in his hometown of Gary, Indiana  (via @aaronwilson7128, h/t @brgridiron)",188,983,317918,318901,carousel,FALSE
CompanyJ_3560,Drake in the lab perfecting his jumper  (via @lethalshooter),60,3844,208097,211941,video,FALSE
CompanyJ_3561,"Bo Nix is as electric as Cam Newton at QB, and hes starting for Auburn as a true freshman ",90,1153,159548,160701,video,FALSE
CompanyJ_3562,The Bulldogs have dominated the competition so far and are looking to do the same vs. the Fighting Irish tonight ,113,365,63847,64212,video,FALSE
CompanyJ_3563,"Jonathan Taylor with another Supreme piece. This week, the LV edition. ",71,977,277169,278146,image,FALSE
CompanyJ_3564,"Jonathan Taylor made a STATEMENT against Michigan:  23 carries for 203 yards  2 rushing TDs  8.8 YPC average  Wisconsin handles Michigan, 35-14",143,720,191950,192670,carousel,FALSE
CompanyJ_3565,TD celebrations getting out of hand ,36,3375,288071,291446,video,FALSE
CompanyJ_3566,Turned this lineman into flapjacks ,35,1800,258427,260227,video,FALSE
CompanyJ_3567,Ja'Marr Chase channeled @obj against Vanderbilt  (via @brgridiron),66,411,146268,146679,image,FALSE
CompanyJ_3568,The showdown of the week is in Athens.  Who ya got? ,52,786,168210,168996,image,FALSE
CompanyJ_3569,Pitt pulled out the Philly Special to hand No. 15 UCF their first regular season loss since 2016 and the crowd LOVED it  (via @john.funkhouser13),145,866,229806,230672,video,FALSE
CompanyJ_3570,LSU guard flattened him ,24,671,162778,163449,video,FALSE
CompanyJ_3571,"D'Andre Swift and Georgia soared above Notre Dame. Bulldogs beat the Irish, 23-17 ",82,1123,252034,253157,carousel,FALSE
CompanyJ_3572,Gardner Minshew busted out the short jorts in his return to Washington State  @brgridiron,89,1584,276218,277802,image,FALSE
CompanyJ_3573,"UCLA comes back from down 49-17 to beat No. 19 Washington State, 67-63   Game had 130 points and 1,377 yards. Instant classic.",126,1424,305470,306894,carousel,FALSE
CompanyJ_3574,Antonio Brown appears to retire from the NFL after @RapSheets report that Patriots owner Robert Kraft was behind his release.,125,6223,302675,308898,image,FALSE
CompanyJ_3575,Lamar vs. Mahomes today. GET HYPED  @brgridiron,47,373,65478,65851,video,FALSE
CompanyJ_3576,Only right Diggs broke out the Chucky cleats for Raiders/Vikings today    @brkicks | @brgridiron   (via @mache275),114,985,243647,244632,carousel,FALSE
CompanyJ_3577,Lamar is a video game character in real life  @brgridiron (via @thecheckdown),77,1169,172150,173319,video,FALSE
CompanyJ_3578,This DeMarcus Robinson touchdown grab was RIDICULOUS. Chiefs offense is unfair  @brgridiron,91,674,234221,234895,carousel,FALSE
CompanyJ_3579,Josh Gordon has to be kidding. WOW @brgridiron  (via @nfl),58,1532,226656,228188,video,FALSE
CompanyJ_3580,Mahomes came to BALL in his showdown with Lamar   27/37 374 yards 3 TDs W  (via @brgridiron),92,1637,389394,391031,image,FALSE
CompanyJ_3581,Patriots have been terrifyingly good.  @brgridiron,50,4763,296476,301239,image,FALSE
CompanyJ_3582,DANIEL JONES = COMEBACK KID @brgridiron (via @nfl),50,1979,294325,296304,video,FALSE
CompanyJ_3583,Giants are loving Daniel Jones after his debut win @brgridiron,62,2947,245169,248116,video,FALSE
CompanyJ_3584,"Never change, OBJ  (via @thecheckdown)",38,3446,481274,484720,video,FALSE
CompanyJ_3585,"Frank Gore scored the game-winning TD and the first person he wanted to celebrate with was his son  (via @jonscotttv, h/t @brgridiron)",134,2749,438158,440907,video,FALSE
CompanyJ_3586,"Bills superfan Pancho Billa passed away in May, but his son Gino is carrying on his legacy in his absence  (via @thadbrown7, @news8_wroc) @brgridiron",149,1968,295382,297350,video,FALSE
CompanyJ_3587,"KD back this season?  The feeling within the league is trending toward Durant potentially returning from his torn Achilles at some point during 2019-20, per Brian Lewis of the @nypost.",184,6129,418855,424984,image,FALSE
CompanyJ_3588,Keenan Allen broke out the @teamswish celebration after hooking up JR with a touchdown ball  @brgridiron,104,2038,430495,432533,video,FALSE
CompanyJ_3589,"Must have the highest shot power in the game @brgaming  (via PSN/dass1494, h/t @brfootball)",91,4064,267535,271599,video,FALSE
CompanyJ_3590,ROUGH  @br_betting,18,2288,229923,232211,image,FALSE
CompanyJ_3591,Leo Messi and Megan Rapinoe win #TheBest mens and womens players  (via @brfootball),83,688,74118,74806,carousel,TRUE
CompanyJ_3592,Coby Whites best hair day happened to land on the same day his lifelong dream came true: draft night ,101,515,103235,103750,video,FALSE
CompanyJ_3593,"If Washington wins on MNF, this 89 parlay turns into nearly $500K  @br_betting (via reallifedannytanner/Reddit)",111,6665,336973,343638,carousel,FALSE
CompanyJ_3594,"Respect, @shareefoneal  (via @br_hoops)",39,1135,452760,453895,image,FALSE
CompanyJ_3595,He's really stirring the Gatorade with a sleeve of cups  @brgridiron (via @thecheckdown),88,4274,319345,323619,video,FALSE
CompanyJ_3596,Vernon Davis accidentally pressed the wrong button  (via @nfl),62,2653,312529,315182,video,FALSE
CompanyJ_3597,"Khalil Mack went off   3 tackles 2 sacks 2 forced fumbles  Chicago routs Washington, 31-15  @brgridiron",103,1600,303159,304759,video,FALSE
CompanyJ_3598,This Philly fan said he was catching babies from a burning building unlike Agholor. Now the Eagles WR is trying to track him down and invite him to a game as a thanks for being a hero in the community  @brgridiron   (via @nbcphiladelphia),238,4103,538546,542649,carousel,FALSE
CompanyJ_3599,A year ago today: the laugh  (via @tsn_official),48,6823,551328,558151,video,FALSE
CompanyJ_3600,"This QB depth chart was unreal. Brady (3-0), Jimmy G (3-0) and Brissett (2-1) are a combined 8-1 this year  @brgridiron",119,2527,494231,496758,carousel,FALSE
CompanyJ_3601,UNBELIEVABLE THROW. Mookie from the corner.  (via @mlb),55,1459,210496,211955,video,FALSE
CompanyJ_3602,"NBA exec on LaMelos play in NBL: If he keeps this up, I dont see any way he isnt in the conversation for the No. 1 overall pick, per @draftexpress  @br_hoops",157,3921,503401,507322,image,FALSE
CompanyJ_3603,Kevin Durant expected to miss entire 2019-20 season according to GM Sean Marks,78,4989,387288,392277,image,FALSE
CompanyJ_3604,"""WHAT'S IN THE BOX?!""  Starters are going down based on the seven deadly QB sins #GridironHeights",97,930,115528,116458,video,TRUE
CompanyJ_3605,Bron has something special prepped for media day  (@brkicks),60,2236,297943,300179,image,FALSE
CompanyJ_3606,Lakers came through for Mystics vs. Aces ,41,1093,277919,279012,carousel,FALSE
CompanyJ_3607,The team was so hype for him after he scored  (via @gokhanmuslera),66,1074,212544,213618,video,FALSE
CompanyJ_3608,"On this day in 2000, Vince Carter did this   Over 7'2"" Frederic Weis.  During an Olympic game.",94,921,225909,226830,carousel,FALSE
CompanyJ_3609,Still Warriors vs. the world ,29,3770,293347,297117,image,FALSE
CompanyJ_3610,"On this day in 2001, Michael Jordan made the announcement he would come out of retirement again",95,1084,284150,285234,image,FALSE
CompanyJ_3611,"Teddy Bridgewater got his first W as a starter since overcoming a career-threatening leg injury in 2016. He held back tears in a speech, telling the Saints to never take the game for granted @brgridiron   (via @nflfilms)",220,2682,515152,517834,carousel,FALSE
CompanyJ_3612,#NAME?,70,3155,510983,514138,image,FALSE
CompanyJ_3613,@brkicks Unboxed: Nike LeBron 17 in three upcoming colorways @kingjames,71,410,47045,47455,video,FALSE
CompanyJ_3614,"Melvin Gordon will end his holdout and report to the Chargers tomorrow, per @rapsheet  He won't play this week, but plans to be back on the field with teammates (@brgridiron)",174,2230,227311,229541,image,FALSE
CompanyJ_3615,Alabama WRs apparently play mid-game rock-paper-scissors to decide who is going to run the TD route. Unbelievable.  (via @come_thru_its_whit),141,1120,255371,256491,carousel,FALSE
CompanyJ_3616,This fan was GOING OFF on @ochocinco after beating him in FIFA. Chad Johnson was speechless  *NSFW* (via @br_betting),117,1169,197705,198874,video,FALSE
CompanyJ_3617,"Patrick Mahomes could receive contract extension ""in excess of $200 million"" this offseason, per @adamschefter   At 24 years old, would make him highest-paid player in NFL history @brgridiron",191,4067,443981,448048,image,FALSE
CompanyJ_3618,"Pat Mahomes becomes fastest player to reach 99 rating in Madden  @brgridiron (via NFLOutsiderRig/TW, h/t @brgaming)",115,3030,313086,316116,video,FALSE
CompanyJ_3619,@keenan13allen's reaction to Melvin Gordon being back  *NSFW* @brgridiron,73,2406,419137,421543,video,FALSE
CompanyJ_3620,Never seen a finish like this before  (via @luarirup) (@brfootball | @brgaming),79,2337,221909,224246,video,FALSE
CompanyJ_3621,"Old faces, new arrivals, more drama  The Champions Season 3 drops Monday at 5 p.m. ET ",86,171,24244,24415,video,FALSE
CompanyJ_3622,#NAME?,71,332,76512,76844,video,FALSE
CompanyJ_3623,AB vs. Eric Weddle on Twitter today (SWIPE) @brgridiron,55,16177,515503,531680,carousel,FALSE
CompanyJ_3624,Klaw x Mamba  Championship mentality  @mambasportsacademy,57,5084,565217,570301,image,FALSE
CompanyJ_3625,James Conner has been a fantasy dud. That changes this week vs. Cincy ,70,427,43505,43932,video,FALSE
CompanyJ_3626,... Pointed right to the flag (via @thecheckdown),49,3588,421299,424887,video,FALSE
CompanyJ_3627,EAGLES BEAT GREEN BAY.  Picked off Aaron Rodgers with game on the line  Wentz: 3 TD  Howard: 3 TD  (via @brgridiron),116,2467,304539,307006,image,FALSE
CompanyJ_3628,Eagles beat the Packers but Davante Adams went for a smooth 180 yards. Time for some reinforcements in Philly?   @brgridiron,124,2729,273070,275799,carousel,FALSE
CompanyJ_3629,"Tom Brady disagrees with Robert Krafts decision to cut Antonio Brown loose, per Tom E. Curran of @nbcsboston",108,3827,424618,428445,image,FALSE
CompanyJ_3630,Seattle poured its heart out for King Felix ,44,848,230883,231731,carousel,FALSE
CompanyJ_3631,Jets rookie @thequinnenwilliams was so comfortable in his Oprah outfit he started FaceTiming people and singing Whitney Houston ,128,89,20378,20467,video,FALSE
CompanyJ_3632,King of Brooklyn  @yesnetwork,29,3449,317603,321052,video,FALSE
CompanyJ_3633,Kyrie keeping it a buck ,24,1721,253086,254807,image,FALSE
CompanyJ_3634,"They really thought wed be Knicks - KD and Kyrie, probably  (@brkicks)",70,7704,612358,620062,video,FALSE
CompanyJ_3635,H-Town  (via @houstonrockets),29,3261,512245,515506,image,FALSE
CompanyJ_3636,Media day is here  Rockets closet about to be a show  @brkicks,62,675,240785,241460,carousel,FALSE
CompanyJ_3637,Whyd he scream like that?  (via @ufc),37,4958,484456,489414,video,FALSE
CompanyJ_3638,Kobe had Harden next since 2011 ,32,3146,374711,377857,image,FALSE
CompanyJ_3639,Hollywood ,10,1510,386006,387516,carousel,FALSE
CompanyJ_3640,Baker calling out AB in his latest post  @brgridiron,52,4096,473731,477827,carousel,FALSE
CompanyJ_3641,Bron got jokes  (@br_hoops),27,604,271956,272560,image,FALSE
CompanyJ_3642,Brodie and Beard are coming for the rest of the league ,55,2387,302239,304626,image,FALSE
CompanyJ_3643,Brooklyn's Blueprint  (via @nba),32,1870,289588,291458,image,FALSE
CompanyJ_3644,Russ and Harden arrivals about to be must-see TV  (@brkicks),60,379,81980,82359,image,FALSE
CompanyJ_3645,Roy Williams was getting down at UNC  (via @goheels),52,2308,274674,276982,video,FALSE
CompanyJ_3646,Dont get it twisted with Lamar at QB  @brgridiron,49,1180,242220,243400,image,FALSE
CompanyJ_3647,Year 17 YES SIR!  @nba,22,2809,444690,447499,video,FALSE
CompanyJ_3648,"Bunt double, no errors. Bruh.  (via @mlb)",41,1126,190604,191730,video,FALSE
CompanyJ_3649,#NAME?,57,1813,361829,363642,video,FALSE
CompanyJ_3650,Jalen Hurts 308 passing yards is a career-high for a half. Last years Heisman winner never had a 300-yard passing half in college.,130,1466,365009,366475,image,FALSE
CompanyJ_3651,"Jalen Hurts put on a clinic against Texas Tech:  17/24 for 415 yards, 3 TDs, 1 INT  9 carries for 70 yards, 1 TD  Dropped a career-high 308 passing yards in 1st half in eventual 55-16 win",187,1534,260568,262102,carousel,FALSE
CompanyJ_3652,#NAME?,52,2614,298921,301535,video,FALSE
CompanyJ_3653,DeVonta Smith had an unforgettable day for Bama:  11 catches for 274 yards  5 TDs (single-game school record)  Passed Amari Cooper for most receiving yards in single game at Bama  WILD.,185,1052,258486,259538,carousel,FALSE
CompanyJ_3654,Zion got his own banner in New Orleans  (via @pelicansnba),58,2248,461483,463731,image,FALSE
CompanyJ_3655,Pete Alonso is the new rookie HR king  Did not get drafted when he finished HS in 2013  64th pick in 2016 by Mets  Rookie record for most RBIs before All-Star break  2019 HR Derby Champion  53 HRs and counting  No ceiling on his potential (via @fisher),252,836,199007,199843,carousel,FALSE
CompanyJ_3656,Holding off a comeback? That's cold.  Catching the ball as well as you throw it? Ice cold   From B/R X @coorslight,114,262,87688,87950,video,FALSE
CompanyJ_3657,"Another 4 TD performance for Justin Fields. Ohio State dominates Nebraska, 48-7 ",80,1337,272294,273631,carousel,FALSE
CompanyJ_3658,Errol Spence Jr. comes out on top   Spence edges out Shawn Porter by split decision to keep undefeated record alive at 26-0  What a fight.  #SpencePorter,153,1027,207795,208822,carousel,TRUE
CompanyJ_3659,"New shoe. New go-to move. After a busy offseason, James Harden is ready to get the preseason started tomorrow ",110,423,97449,97872,video,FALSE
CompanyJ_3660,KD turns 31 today. Absolute bucket from the jump.  ROY MVP 2x NBA champ 2x Finals MVP 10x All-Star 4x scoring champ No. 6 in PPG Never averaged under 20 PPG Youngest to join 50-40-90 club Youngest scoring title ever (21 | 30.1 PPG),231,3318,423350,426668,carousel,FALSE
CompanyJ_3661,This absolute  from OBJ deserved a catch (via @NFL),51,2691,305789,308480,video,FALSE
CompanyJ_3662,"Frank Gore joins Emmitt Smith, Walter Payton and Barry Sanders as the only RBs to ever rush for 15K yards. All-time career. @brgridiron",135,3067,421482,424549,image,FALSE
CompanyJ_3663,Lamar stopped on a DIME (via @nfl)  @brgridiron,47,1269,176423,177692,video,FALSE
CompanyJ_3664,NICK CHUBB SAID SEE YA  88 yards for his THIRD TD of the day (via @NFL),71,1906,245995,247901,video,FALSE
CompanyJ_3665,Can't stop watching this Christian McCaffrey catch @brgridiron  (via @NFL),74,865,185289,186154,video,FALSE
CompanyJ_3666,Beard is changing the game.,27,2862,247848,250710,image,FALSE
CompanyJ_3667,Kawhi was shown on the video board at the Rams game in Los Angeles... and got booed  (via @renato_mazariegos),109,4959,329486,334445,video,FALSE
CompanyJ_3668,Whole lotta buckets in LA ,26,2257,334314,336571,carousel,FALSE
CompanyJ_3669,"California governor Gavin Newsom signs bill that will allow California college athletes to profit off their name, likeness and image. Newsom signed it on @hbos #TheShop with @kingjames.",185,2244,231909,234153,video,TRUE
CompanyJ_3670,"Vontaze Burfict is suspended for the rest of the season. Following his head-to-head hit on Colts TE Jack Doyle Sunday, the league is banning him for repeated violations of unnecessary roughness rules.  @brgridiron",213,6202,335631,341833,image,FALSE
CompanyJ_3671,Youre supposed to jump  Chest bumps with Tacko are a little different (via @celtics),84,2193,410912,413105,video,FALSE
CompanyJ_3672,Zion grew up creating himself in 2K. He's still amazed he doesn't have to anymore  @brgaming,92,770,237781,238551,image,FALSE
CompanyJ_3673,Bens ready to launch ,21,5389,333700,339089,image,FALSE
CompanyJ_3674,"FINALLY, THE ROCK HAS COME BACK.  The Peoples Champ says hes returning to the WWE this Friday for SmackDowns Fox debut.",119,2387,282907,285294,carousel,FALSE
CompanyJ_3675,LeBron knows the impact of California's new Fair Pay to Play act,64,2204,319979,322183,image,FALSE
CompanyJ_3676,Beard debuting his new move in preseason...,43,3480,260425,263905,video,FALSE
CompanyJ_3677,The only thing people can agree on when it comes to the David Ortiz shooting? There are not enough answers,106,278,71872,72150,video,FALSE
CompanyJ_3678,Wait for a surprise... (via @joelembiid),40,1557,202448,204005,video,FALSE
CompanyJ_3679,"Mistaken identity? Love triangle? A cover-up? David Ortiz was shot almost four months ago, and there are still a lot of questions. B/R went to the Dominican Republic to investigate the shooting of the Red Sox icon",213,473,98793,99266,image,FALSE
CompanyJ_3680,Shaq dropped a diss track on Dame yesterday. @damianlillard went off in his response  (SWIPE),93,7351,492091,499442,carousel,FALSE
CompanyJ_3681,He really hit the Ronaldo celebration vs. Real Madrid. The disrespect  (@brfootball),84,866,152015,152881,video,FALSE
CompanyJ_3682,Throw of the year? Stafford really put it through FOUR defenders @brgridiron  (via @thecheckdown),97,2252,248625,250877,video,FALSE
CompanyJ_3683,Kyler sneaks in. Matty Ice and Kirk struggle. Lamar and Russ thrive.   This years quarter-season carnival is here  #GridironHeights,131,925,132188,133113,video,TRUE
CompanyJ_3684,"Scored 4, wanted the match ball...but his teammate kicked it into the stands instead  @brfootball",97,531,134083,134614,video,FALSE
CompanyJ_3685,What $3.5 million on the Astros to win the World Series looks like  (via DKSportsbook/Twitter | h/t @br_betting),112,6185,386610,392795,carousel,FALSE
CompanyJ_3686,Mahomes on the sideline before leading a game-winning drive. Cant teach this. @brgridiron (via @chiefs),103,2929,390458,393387,video,FALSE
CompanyJ_3687,"The Heats first practice started at 10 a.m. on Tuesday. Jimmy Butler clocked in at 3:30 a.m.  ""Just a little extra work while yall in your third dream.""  (via Ira Winderman of the @sunsentinel)",193,6820,585927,592747,image,FALSE
CompanyJ_3688,Controller about to get put through a wall @brgaming  (via @daxanderman24),74,8312,467556,475868,video,FALSE
CompanyJ_3689,"Kyle Kuzma signed five-year deal with Puma, becomes face of company, per @shamsnba  @brkicks",92,2089,226370,228459,image,FALSE
CompanyJ_3690,California is paving the way for college athletes to get paid ,62,1094,97365,98459,video,FALSE
CompanyJ_3691,2021 Texas commit made the OBJ catch in OBJ's exact spot  (via @hudl),69,1154,204477,205631,video,FALSE
CompanyJ_3692,Van Dijk got crossed  @brfootball,33,1256,104968,106224,video,FALSE
CompanyJ_3693,Messi to Suarez. Unstoppable.  @brfootball,42,443,75900,76343,video,FALSE
CompanyJ_3694,"Tom Brady says hes worn the same shoulder pads since his first season at Michigan, about 25 years ago @brgridiron   Once you find something you like, you kind of stick with it.  (via Tom E. Curran of @nbcsboston, @mikereisspatriots)",232,2015,322419,324434,carousel,FALSE
CompanyJ_3695,#NAME?,47,1035,245366,246401,image,FALSE
CompanyJ_3696,Lonzo to Zion alley. Get used to this  (via @pelicansnba),57,1366,169190,170556,video,FALSE
CompanyJ_3697,"A day to remember for Yandy Diaz and the Rays as they beat the As, 5-1 in AL Wild Card   Rays hit team playoff record 4 HRs  Diaz records first postseason leadoff HR in Rays history  Diaz goes from one HR combined in 2017 and 2018 seasons  two HRs today against As",264,451,88988,89439,carousel,FALSE
CompanyJ_3698,Joker throwing dimes all throughout training camp  (via @nba),61,1032,129935,130967,video,FALSE
CompanyJ_3699,Jon Moxley and Kenny Omega brought the house down during the first-ever episode of AEW Dynamite  (via @aewontnt),112,5178,189413,194591,video,FALSE
CompanyJ_3700,"Damn, Boban ",12,3109,321709,324818,carousel,FALSE
CompanyJ_3701,"Jameis comes with risk, but its time to take him seriously with Evans and Godwin dominating ",92,148,30747,30895,video,FALSE
CompanyJ_3702,"Broncos OLB Bradley Chubb tore his ACL on Sunday. He says he suffered the same injury exactly seven years ago, down to the day, in 2012 as a HS player @brgridiron --- It made me who I am today. I remember I was on the hospital bed not knowing if I was gonna get college offers. Look where I am now. I can only imagine what this injury is gonna do for me.    (@247sports)",370,692,260711,261403,image,FALSE
CompanyJ_3703,TMC  (via @brkicks),19,1034,157597,158631,image,FALSE
CompanyJ_3704,Can you figure out whats different between the first and second video? ,71,10033,249665,259698,carousel,FALSE
CompanyJ_3705,Saquon looking healthy already @brgridiron  (via @snytv),56,4191,271608,275799,video,FALSE
CompanyJ_3706,KP responds to RJ Barrett saying he wanted to posterize him  Knicks-Mavs play on Nov. 8  (via @fanaticsview),108,1675,314667,316342,carousel,FALSE
CompanyJ_3707,"11 years ago today, @candaceparker became the first WNBA player to win ROY and MVP in the same season  (via @WNBA)",114,2299,232602,234901,carousel,FALSE
CompanyJ_3708,"Kawhi, Kyrie and PG pulled up to Kobe's Mamba Sports Academy  (via @mambasportsacademy)",87,3339,371484,374823,video,FALSE
CompanyJ_3709,Tyler Lockett with no room to spare  @brgridiron  What a catch. (via @thecheckdown),83,731,136856,137587,video,FALSE
CompanyJ_3710,Criminally Smooth TD catch by Tyler Lockett  @brgridiron,56,2882,380500,383382,video,FALSE
CompanyJ_3711,Anthony Rendon went ALL OUT ,28,622,91422,92044,video,FALSE
CompanyJ_3712,Tedric Thompson with a miraculous INT (via @nfl),48,1273,204985,206258,video,FALSE
CompanyJ_3713,"Russell Wilson comes up huge for the Seahawks as they take down the Rams, 30-29 in a thriller! @brgridiron",106,2330,320646,322976,image,FALSE
CompanyJ_3714,We've seen some dunks that you might fear @travisscott,54,2032,364049,366081,video,FALSE
CompanyJ_3715,"Lefty, righty, lefty, righty  All money  @dubs_training",55,2817,245802,248619,video,FALSE
CompanyJ_3716,Hornets gifted @realcoleworld with a custom jersey  (via @hornets),66,1769,258371,260140,video,FALSE
CompanyJ_3717,"Like the mustache, the legend of Gardner Minshew is only growing.  (@brgridiron)",80,378,100906,101284,video,FALSE
CompanyJ_3718,LaMelo Ball got scouts rethinking the best player in the 2020 class  (@br_betting),82,1963,202654,204617,image,FALSE
CompanyJ_3719,Alabama's DeVonta Smith gives the Crimson Tide the most dangerous wide receiver trio in the nation  ( @localtoyotadealers),122,217,44846,45063,video,FALSE
CompanyJ_3720,Quavo mightve had the most ice for a first pitch in MLB history ,64,662,189292,189954,carousel,FALSE
CompanyJ_3721,This Clayton Kershaw play = ,28,957,142975,143932,video,FALSE
CompanyJ_3722,Bron and AD chemistry =  (via @lakers),38,1811,316837,318648,video,FALSE
CompanyJ_3723,"Nah, @dwyanewade and his daughter really are twins ",51,1352,339597,340949,image,FALSE
CompanyJ_3724,Mack Attack plays Raiders for first time since the trade  @brgridiron,69,1169,247186,248355,carousel,FALSE
CompanyJ_3725,Snoop has set a new standard for college basketball performances  (via @randywitherskc),87,3740,316047,319787,video,FALSE
CompanyJ_3726,Jonathan Taylors Heisman stock continues to rise  19 carries for 186 yards 5 TDs total Passed Melvin Gordon for 3rd on all-time Wisconsin rushing list,150,550,143848,144398,carousel,FALSE
CompanyJ_3727,Auburn and Florida got into it pregame  (via @gridironstuds),60,4796,426059,430855,video,FALSE
CompanyJ_3728,"OSU receiver had his defender confused, confused ",49,1354,244109,245463,video,FALSE
CompanyJ_3729,Players really punching their teammates after touchdowns now ,61,1202,188505,189707,video,FALSE
CompanyJ_3730,Kid was in absolute disbelief watching Simmons drain 3s  (via @nbcsphilly),74,2028,242413,244441,video,FALSE
CompanyJ_3731,DShawn Jamison with the INT of the year ,40,1713,285152,286865,video,FALSE
CompanyJ_3732,Florida iced the game on a 88-yard TD from Lamical Perine  Too cold   From B/R X @coorslight,92,356,77536,77892,video,FALSE
CompanyJ_3733,LeBron  AD  First of many buckets from that duo,47,1404,231898,233302,video,FALSE
CompanyJ_3734,Steph still gotta get used to the Chase Center ,47,2005,313190,315195,video,FALSE
CompanyJ_3735,"One game into the AD era in LA, things are going well ",54,1537,275780,277317,image,FALSE
CompanyJ_3736,Bronny getting tips from Uncle Flash  (via @maxisnicee),55,1042,449350,450392,video,FALSE
CompanyJ_3737,AND NEW!  Israel Adesanya knocks out Robert Whittaker to become the new UFC middleweight champion ,98,1123,206219,207342,carousel,FALSE
CompanyJ_3738,LaMelo didnt have to do him like that... TWICE @br_hoops  (via @nbl),68,8668,610817,619485,video,FALSE
CompanyJ_3739,Golden Tate with the Bron/Wade cleats for his @nygiants debut   @brkicks | @brgridiron,86,1010,296511,297521,carousel,FALSE
CompanyJ_3740,"We share the same name, but he has his own path. @bronny turns 15 today  @br_hoops",82,1217,346182,347399,carousel,FALSE
CompanyJ_3741,"The risk you take running on the field  (via @oregonfootball, @goducks)",71,3948,467942,471890,video,FALSE
CompanyJ_3742,Ref had to play it cool  @br_betting   (via @justinfrank__),59,1310,333575,334885,video,FALSE
CompanyJ_3743,CHRISTIAN MCCAFFREY CLEARED FOR TAKEOFF @brgridiron  (via @nfl),63,1337,267593,268930,video,FALSE
CompanyJ_3744,O U C H  @brgridiron (via @thecheckdown),40,1967,193587,195554,video,FALSE
CompanyJ_3745,"Prayers up for Mason Rudolph  Steelers QB was diagnosed with a concussion after taking a hit to the head vs. Baltimore. Teammates, including JuJu, immediately showed support. Hoping hes OK @brgridiron",200,2851,397005,399856,carousel,FALSE
CompanyJ_3746,Christian McCaffrey put on a SHOW today.  25 touches  237 total yards  3 total TD  Cheat code  @brgridiron,106,2274,320298,322572,image,FALSE
CompanyJ_3747,22 years. 815 appearances.  @timhow1 has officially played his final game  @brfootball,86,984,171471,172455,image,FALSE
CompanyJ_3748,AMARI COOPER. Tough. (via @NFL) @brgridiron,43,1080,132592,133672,video,FALSE
CompanyJ_3749,Cowboys fans getting their hopes up after starting 3-0 @brgridiron,66,8482,492241,500723,image,FALSE
CompanyJ_3750,Brees not playing but he still brings that fire pregame  @brgridiron (via @saints),82,1861,345234,347095,video,FALSE
CompanyJ_3751,Aaron Rodgers with four-straight wins in Dallas... @brgridiron,62,4355,305655,310010,video,FALSE
CompanyJ_3752,"Redskins fire head coach Jay Gruden, per @dangrazianoespn  @brgridiron",70,1892,195764,197656,image,FALSE
CompanyJ_3753,"Kyle Lowry and Raptors agree on a one-year, $31M extension, per @wojespn  Lowry won't be a free agent until July 2021",117,3001,343664,346665,image,FALSE
CompanyJ_3754,Kids an ELITE flopper  (via @natjack22) @brfootball,51,2980,193770,196750,video,FALSE
CompanyJ_3755,Seahawks rookie @dkm14 surprised his mom with a new car for her birthday and it brought her to tears. Respect  @brgridiron,122,792,207031,207823,carousel,FALSE
CompanyJ_3756,This Shaq/Dame battle... ,25,4628,399759,404387,carousel,FALSE
CompanyJ_3757,Lamar knocked over a photographer on Sunday after stiff-arming TJ Watt. He helped her up and then hugged her. This is the photo she took seconds before @brgridiron  (via @shelleylipton | @thecheckdown),201,2536,466914,469450,carousel,FALSE
CompanyJ_3758,"""We was catching em, unlike Agholor."" Hakim Laws went viral after he saved a family from a fire. Then Nelson Agholor brought the Philly legend to the Eagles-Jets game. Respect  @brgridiron",188,209,75405,75614,video,FALSE
CompanyJ_3759,NBA ZION IS HERE.,17,11268,836428,847696,video,FALSE
CompanyJ_3760,Lonzo defense  Zion dunk ,25,4445,602747,607192,video,FALSE
CompanyJ_3761,Yadi with the batflip of the year after the Cardinals walk-off ,63,746,130326,131072,video,FALSE
CompanyJ_3762,Trae just nutmegged JJ in preseason. Disrespect ,48,4436,521266,525702,video,FALSE
CompanyJ_3763,Streetball.  Marcus Morris got ejected for purposely hitting Justin Anderson in the head with the ball ,103,29146,910070,939216,video,FALSE
CompanyJ_3764,42-year-old Vince Carter dishing no-look passes to 20-year-old Cam Reddish ,75,2118,435895,438013,video,FALSE
CompanyJ_3765,Baker Mayfield planted the Oklahoma flag in Ohio State's field two years ago... OSUs Nick Bosa waved and planted a flag after hitting Baker tonight.  Waited for his revenge  @brgridiron (Via @thecheckdown),205,4017,529100,533117,video,FALSE
CompanyJ_3766,Zion already lighting up the league ,36,1357,220588,221945,video,FALSE
CompanyJ_3767,Gucci Garoppolo & the Niners move to 4-0  @brgridiron,53,4480,538773,543253,image,FALSE
CompanyJ_3768,"YANKEES MOVE ON TO THE ALCS.  5-1 win, 3-0 series sweep.",56,1320,216927,218247,image,FALSE
CompanyJ_3769,Only two quarterbacks in the NFL remain undefeated (combined 9-0). Wasnt long ago they were in the same QB room @brgridiron,123,1838,323564,325402,carousel,FALSE
CompanyJ_3770,KD keeping it real about NY,27,4581,297764,302345,image,FALSE
CompanyJ_3771,"Clocked in, balled out   (via @st.lukesmith) @brfootball",56,972,231162,232134,video,FALSE
CompanyJ_3772,KD was busy this morning ,25,5041,446374,451415,carousel,FALSE
CompanyJ_3773,"A whole team, though  @brgridiron",33,3047,290795,293842,carousel,FALSE
CompanyJ_3774,Knicks coming for everybody's heads this year ,46,829,91940,92769,video,FALSE
CompanyJ_3775,"Matthew Stafford realizes the Lions have been a comedy, not a tragedy.  New #GridironHeights x Joker",100,1294,111750,113044,video,TRUE
CompanyJ_3776,The Alex Caruso hype is getting out of hand  @br_betting,56,1317,231774,233091,carousel,FALSE
CompanyJ_3777, BEN SIMMONS HIT A 3 ,21,25662,1089209,1114871,video,FALSE
CompanyJ_3778,All of Philly when Ben Simmons hit a 3:,39,9897,623553,633450,video,FALSE
CompanyJ_3779,Tyler Herro hit Marco Belinelli with a nasty step-back ,55,2953,285649,288602,video,FALSE
CompanyJ_3780,MPJ checked in and immediately drilled a step-back ,51,2712,498687,501399,video,FALSE
CompanyJ_3781,OBJ was too busy dancing  @brgridiron (via @jzfish),51,3263,341832,345095,video,FALSE
CompanyJ_3782,This story keeps getting more legendary.  @brgridiron,53,2670,336365,339035,carousel,FALSE
CompanyJ_3783,"She smoked EVERYBODY on that field  (via @fabe_seg, @julie9.casiano)",68,3630,229101,232731,video,FALSE
CompanyJ_3784,Ben made his first three and the whole Internet wasnt ready ,60,3786,437856,441642,video,FALSE
CompanyJ_3785,Rihanna is Team Kap,19,6891,302464,309355,image,FALSE
CompanyJ_3786,Luka gotta chill ,17,3461,344015,347476,video,FALSE
CompanyJ_3787, ZION ,6,1840,270931,272771,video,FALSE
CompanyJ_3788,Nationals heading to their first ever NLCS   Howie Kendricks 10th inning grand slam seals Game 5 7-3 win over Dodgers.,118,3281,282130,285411,carousel,FALSE
CompanyJ_3789,Minshew + Chark =  Time to go all in on the Jags passing attack,63,160,38631,38791,video,FALSE
CompanyJ_3790,@patbev21s journey is unlike any other    Slept in a car with his mom  Grew up without a father  Cousin shot dead at 16  Scouts said he was too small  Had to leave college to play in Europe  Now has $40M contract and a real shot at a ring,238,3633,495930,499563,image,FALSE
CompanyJ_3791,"Who saw this coming?   February 2019: Bryce Harper leaves Washington, signs 13-year deal with Phillies  October 2019: Phillies miss playoffs finishing 4th place in NL East, Nationals advance to first ever NLCS",209,1918,187427,189345,carousel,FALSE
CompanyJ_3792,"Whether training for an 82 game season or preparing for battle, nutrition is key  In partnership with @todaysmilitary X B/R",123,112,24792,24904,video,FALSE
CompanyJ_3793,"This Dodgers fan was so fed up  (via @_thehoopgod, @saljmenez) NSFW",67,5523,301817,307340,video,FALSE
CompanyJ_3794,"NFL vets fed up with Baker?According to @brgridirons Mike Freeman, a lot of players in the league think Baker is too cocky and acts like a better player than he is.  One defensive player with a ring said He acts like hes won 10 Super Bowls. He hasnt won any.",258,11779,459065,470844,image,FALSE
CompanyJ_3795,Raiders safety @thejabram is still getting roasted for how he pronounces salmon   Hard Knocks: Training Camp with the Oakland Raiders is Streaming on HBO,153,338,36586,36924,video,FALSE
CompanyJ_3796,TB12 passes Peyton Manning for second on the NFLs all-time passing list @brgridiron,83,1125,152330,153455,image,FALSE
CompanyJ_3797,Giants defense SWARMED Brady and Markus Golden gave it his all for this TD  @brgridiron (via @nfl),98,987,190350,191337,video,FALSE
CompanyJ_3798,Mystics win their first WNBA title!   Emma Meesseman named Finals MVP  @wearejayla,82,1733,119279,121012,carousel,FALSE
CompanyJ_3799,Elena Delle Donne battled through this season and came out with her first Title  -Herniated disk -Broken Nose -Bone bruise in knee  The WNBA MVP was also the first player to go 50/40/90 @wearejayla,197,1896,176368,178264,image,FALSE
CompanyJ_3800,"Houston Astros advance to 3rd straight ALCS  Astros handle Rays, 6-1 in Game 5",78,482,105535,106017,carousel,FALSE
CompanyJ_3801,Kawhis first 3-pointer on Clippers was too smooth ,50,1898,261813,263711,video,FALSE
CompanyJ_3802,Daniel Jones throws 3 INTs against the Patriots in 35-14 defeat @brgridiron,75,4625,358237,362862,image,FALSE
CompanyJ_3803,Cant guard Steph when he does this ,35,1475,259074,260549,video,FALSE
CompanyJ_3804,@45pedromartinez staked his claim as one of the GOATs 20 years ago ,67,346,97992,98338,carousel,FALSE
CompanyJ_3805,Bronny x Zaire  Just like their dads @br_hoops,46,5669,891512,897181,carousel,FALSE
CompanyJ_3806,This animator takes every LeBron post on social and recreates a giraffe version on @leraffejames ,97,1587,199198,200785,video,FALSE
CompanyJ_3807,#NAME?,54,202,30153,30355,video,FALSE
CompanyJ_3808, @brkicks @travisscott,22,706,110160,110866,video,FALSE
CompanyJ_3809,One of the best rivalries in sports: Oklahoma vs. Texas. Who ya got?,68,452,51375,51827,video,FALSE
CompanyJ_3810,Lonzo knows his little brothers real potential ,47,2021,361021,363042,carousel,FALSE
CompanyJ_3811,That father-son connection  @br_hoops,37,523,171233,171756,video,FALSE
CompanyJ_3812,ZION FROM LONG RANGE ,21,3637,372536,376173,video,FALSE
CompanyJ_3813,Jalen Hurts and Sam Ehlinger have been making plays for their team all season.  Can the Longhorns knock off the Sooners in their Red River showdown? ( @wendys),159,250,84262,84512,carousel,FALSE
CompanyJ_3814,RJ showing out in his first game at MSG ,40,1218,237794,239012,video,FALSE
CompanyJ_3815,"Ryan Zimmerman went SUPERMAN   Nationals win NLCS Game 1, 2-0.",62,834,158966,159800,video,FALSE
CompanyJ_3816,#NAME?,90,2265,328652,330917,carousel,FALSE
CompanyJ_3817,Red River Rivalry got off to a hot start  *NSFW* (via @eddie_rado),66,3279,333293,336572,video,FALSE
CompanyJ_3818,Headband. Chalk toss. Vintage @kingjames is back  (via @lakers),63,1660,283003,284663,video,FALSE
CompanyJ_3819,Death Valley at night. Tigers-Gators. Buckle up ,48,305,79533,79838,video,FALSE
CompanyJ_3820,CeeDee Lamb DESTROYED the Texas defense and led Oklahoma to a win in the Red River Rivalry ,91,1336,296433,297769,carousel,FALSE
CompanyJ_3821,"South Carolina upset No. 3 Georgia in Athens, and no one was happier than QB Ryan Hilinski, who honors his late brother Tyler by wearing the No. 3 jersey ",154,511,229995,230506,carousel,FALSE
CompanyJ_3822,This Bama fan needs a refund ,29,1716,372229,373945,video,FALSE
CompanyJ_3823,CeeDee Lamb left the Texas defense frozen  @exxonmobil,54,322,92736,93058,video,FALSE
CompanyJ_3824,Last Chance U alum Malik Henry out here throwing DIMES for Nevada ,66,4027,546147,550174,carousel,FALSE
CompanyJ_3825,CJ actually hit the one-legged three ,37,1114,242859,243973,video,FALSE
CompanyJ_3826,Jayden Daniels was cold blooded on this game game-winning TD run  (From BR x @coorslight),89,211,70349,70560,video,FALSE
CompanyJ_3827,Coco Gauff has won her first @wta title at 15 years old.  Shes the youngest American woman to win a tour singles title since 1991 after defeating Jelena Ostapenko in the Linz Open. Venus and Serena were 17 for their first singles titles.,237,464,127862,128326,carousel,FALSE
CompanyJ_3828, status.,8,823,176945,177768,image,FALSE
CompanyJ_3829,"Tyreek is back  5'10"" receiver MOSSED the Texans for a ridiculous touchdown in his first game since Week 1 @brgridiron",118,671,185664,186335,carousel,FALSE
CompanyJ_3830,Lamar joined Vick and Kap as the only QBs in the Super Bowl era to run for 150 yards in a game  @brgridiron,107,1195,210809,212004,carousel,FALSE
CompanyJ_3831,Broadway Sam gets the Jets their first win of the season  @brgridiron,69,1701,230548,232249,image,FALSE
CompanyJ_3832,Zion's last three preseason games have been near-perfect performances  22 PTS (8-11FG) 26 PTS (9-12FG) 29 PTS (12-13FG)  He's shooting 80.5% ,141,4834,481088,485922,carousel,FALSE
CompanyJ_3833,CARLOS CORREA CALLED GAME   Correa hits walk-off home run to beat Yankees in 11th inning to even ALCS 1-1,105,1042,184470,185512,carousel,FALSE
CompanyJ_3834,Talk that talk  @simonebiles (h/t @wearejayla),46,2088,235377,237465,image,FALSE
CompanyJ_3835,Cowboys fans waking up and realizing Jason Garrett hasnt been fired (@brgridiron),81,4561,280450,285011,video,FALSE
CompanyJ_3836,"49ers defense is a FORCE this year, and it has DC Robert Saleh going wild on the sidelines  @brgridiron  --- ( @thecheckdown)",125,1843,256711,258554,carousel,FALSE
CompanyJ_3837,CR700 - @cristiano becomes the 6th player in history to reach 700 career goals   @brfootball,92,611,99675,100286,carousel,FALSE
CompanyJ_3838,"LB Zach Brown called Kirk Cousins the ""weakest part"" of the Vikings offense three days ago.  Cousins threw for 333 yards and 4 TDs in a win against Philadelphia on Sunday.  Eagles released Brown today @brgridiron",212,5117,369335,374452,carousel,FALSE
CompanyJ_3839,Can you figure out whats different between the first and second video? ,71,12190,218480,230670,carousel,FALSE
CompanyJ_3840,"TYLER HERRO IS A FLAMETHROWER   Scored the first 14 points for the Heat, while hitting four-straight threes.",108,2507,394855,397362,carousel,FALSE
CompanyJ_3841,RODGERS DROPPED THAT IN  (via @nfl),35,1945,178024,179969,video,FALSE
CompanyJ_3842,Aaron Rodgers comes back to get it done.  Packers win 23-22 at Lambeau. @brgridiron,83,5064,239730,244794,video,FALSE
CompanyJ_3843,Zach Norvell Jr. had Jordan Poole on all fours and the Lakers bench went WILD ,78,1633,208341,209974,video,FALSE
CompanyJ_3844,It's been a long road to success for Last Chance U's Malik Henry ,65,445,105461,105906,video,FALSE
CompanyJ_3845,Bron clarified his comments on Daryl Morey/Hong Kong.,53,4126,213698,217824,carousel,FALSE
CompanyJ_3846,ONE. WEEK.,10,1726,350491,352217,image,FALSE
CompanyJ_3847,"Breaking: Rams have traded CB Marcus Peters to the Ravens, per @rapsheet  @brgridiron",85,3505,314141,317646,image,FALSE
CompanyJ_3848,The RB committee tries to figure out how to get paid like WRs  #GridironHeights,79,879,104317,105196,video,TRUE
CompanyJ_3849,"Breaking: Jalen Ramsey is headed to the Rams for two first-round picks and a fourth-round pick, per @adamschefter",113,7818,532455,540273,image,FALSE
CompanyJ_3850,Los Angeles is the city of stars  @brgridiron,45,4641,407991,412632,carousel,FALSE
CompanyJ_3851,New CB1  @jalenramsey  @brgridiron,34,967,221085,222052,image,FALSE
CompanyJ_3852," NATIONALS ARE GOING TO THE WORLD SERIES   Sweep the Cardinals, 4-0  Punch ticket to first WS in franchise history  Celebrate with champagne",140,1908,213206,215114,carousel,FALSE
CompanyJ_3853,"Russ leads the NFL in touchdowns, passer rating and game-winning drives. MVP?  @brgridiron",90,2702,291504,294206,carousel,FALSE
CompanyJ_3854,Jordan Clarkson pulled up on a scooter and posed for these newlywed photos in a Cleveland park  @benjaminscott714 | @lisalmacphoto,130,1227,238297,239524,carousel,FALSE
CompanyJ_3855, @brkicks,9,2694,146459,149153,image,FALSE
CompanyJ_3856,"@sergeibakas cooking show How Hungry Are You? is coming to B/R starting Mon., 10/21",83,375,34267,34642,video,FALSE
CompanyJ_3857,Myles Garrett says he got sucker punched by a fan  @brgridiron,62,2271,363935,366206,carousel,FALSE
CompanyJ_3858,KD is the  of Twitter beef and he proved it this offseason.,59,649,61821,62470,video,FALSE
CompanyJ_3859,Dejounte Murray locked up Harden and then scored on him ,56,8291,503933,512224,video,FALSE
CompanyJ_3860,Vinsanity had MSG on their feet ,32,1535,291648,293183,carousel,FALSE
CompanyJ_3861,LeBron and AD showed out at Staples Center vs. the Warriors  Swipe ,67,4149,495919,500068,carousel,FALSE
CompanyJ_3862,"Wizards and Bradley Beal agree to 2-year, $72M max extension, per @wojespn",74,1858,247421,249279,image,FALSE
CompanyJ_3863,@miketyson still got it at 53 years old ,40,2498,175748,178246,video,FALSE
CompanyJ_3864,"ANKLES @brianna_alger  (via @shoffman_14, @wsucougarsoccer)",59,6974,450332,457306,video,FALSE
CompanyJ_3865,Buddy wants his money ,22,11778,395754,407532,image,FALSE
CompanyJ_3866,Brons no-look pass from courtside (via @pablo024),49,1346,230531,231877,video,FALSE
CompanyJ_3867,GMs weigh in on the upcoming season ,36,1387,187666,189053,carousel,FALSE
CompanyJ_3868,Adam Silver didnt think twice.,30,4048,327062,331110,image,FALSE
CompanyJ_3869,Odell the modern Prime Time?  OBJ says hed consider pulling a @DeionSanders and play a second pro sport if there was ever an NFL lockout @brgridiron  - - - (via Pat McManamon of @theathletichq),193,3060,294080,297140,carousel,FALSE
CompanyJ_3870,"New season, new looks ",22,697,160882,161579,carousel,FALSE
CompanyJ_3871,Patrick Mahomes has been ruled out for rest of game vs. Broncos after suffering a knee injury.  Hope hes ok  @brgridiron,120,3279,289238,292517,carousel,FALSE
CompanyJ_3872,Mahomes says hell be ok  @brgridiron,36,1057,231086,232143,image,FALSE
CompanyJ_3873,Luka put the moves on Kawhi ,28,6427,372963,379390,video,FALSE
CompanyJ_3874,CC Sabathia walked off the mound to a Yankees fans standing ovation in Game 4 after experiencing discomfort ,108,829,201284,202113,carousel,FALSE
CompanyJ_3875,"Zion Williamson expected to miss a couple weeks to start the season due to knee injury, no shortage of confidence he will be fully recovered, per @wojespn",154,3783,345147,348930,image,FALSE
CompanyJ_3876,Knee injuries cant hold back this type of talent forever... Get well soon ,74,2835,512260,515095,image,FALSE
CompanyJ_3877,"This Twitch streamer was so in awe of 20K viewers, he woke up his mom to come and see it @brgaming (via @nicewigg)",114,1438,123329,124767,video,FALSE
CompanyJ_3878,"Larry Fitz had to school the rook on Julios greatness. ""11, dogYoure gonna see some s--t today"" @brgridiron (via @nflfilms)",123,1308,226843,228151,video,FALSE
CompanyJ_3879,"The NBA title will go through L.A., but it won't be for the Lakers... it will be the Clippers according to @howardabeck ",120,3306,158312,161618,video,FALSE
CompanyJ_3880,Elite guests eating nasty food   @easymoneysniper is on the premiere of How Hungry Are You? dropping Mondayand hes eating snake ,128,267,61198,61465,video,FALSE
CompanyJ_3881,"@shaq found a home for the family of a 12-year-old boy who was paralyzed in a shooting and will pay a year's rent for them, per @11alive",136,1947,344747,346694,image,FALSE
CompanyJ_3882,Kyrie gets his first bucket as a Net ,37,1732,254253,255985,video,FALSE
CompanyJ_3883,Lonzo left it short ,20,2737,231568,234305,video,FALSE
CompanyJ_3884,RJ put on a show at MSG with 17 first half points and an EMPHATIC dunk ,71,644,162180,162824,video,FALSE
CompanyJ_3885,Norvell drops Poole...again?!,29,1453,169520,170973,video,FALSE
CompanyJ_3886,Kendrick Nunn went undrafted in 2018  Tonight he dropped 40 points for the Heat ,80,2030,261762,263792,video,FALSE
CompanyJ_3887,Ronaldo really makes more money on Instagram than on the field  @brfootball,75,1175,211633,212808,image,FALSE
CompanyJ_3888,Hes only 4 years old and hes throwing gas  (via @hectorgomezmlb),64,3262,258275,261537,video,FALSE
CompanyJ_3889,"Pascal Siakam has agreed to a 4-year max contract extension with Raptors, per @wojespn & Zach Lowe",98,2180,293163,295343,image,FALSE
CompanyJ_3890,CR700.  What a flex. @brfootball,32,398,130570,130968,image,FALSE
CompanyJ_3891,Gus Johnson with the play call of the year on the Sooner Schooner collapsing ,77,9905,588018,597923,video,FALSE
CompanyJ_3892,Illinois really played Jump Around after upsetting No. 6 Wisconsin  (via @johnboelwave3),88,1244,284327,285571,carousel,FALSE
CompanyJ_3893,This Astros fan had to be escorted from his seat after getting beer and popcorn thrown in his face while he threw up 3-1 signs (via @mhjay_),140,9445,392768,402213,video,FALSE
CompanyJ_3894,The Crimson Tide are undefeated and their WR core is a big reason why ,70,628,79809,80437,video,FALSE
CompanyJ_3895, TCUs QB went BEAST MODE ,25,956,166022,166978,video,FALSE
CompanyJ_3896,Four-time cancer survivor Casey O'Brien got his first hold for the Gophers. Words can't do these type of moments justice. ,122,1082,284362,285444,video,FALSE
CompanyJ_3897,#NAME?,34,5998,360997,366995,image,FALSE
CompanyJ_3898,Michigan fans losing to a top-10 opponent yet again:,52,677,70450,71127,video,FALSE
CompanyJ_3899,Astros move on to the World Series for the second time in three years!  Ice cold in their biggest moment of the postseason   From B/R X @coorslight,147,767,62056,62823,video,FALSE
CompanyJ_3900,Altuve ripped the heart out of Yankees fans,43,1503,223812,225315,carousel,FALSE
CompanyJ_3901,ALTUVE. LEFT. NO. DOUBT. (via @napogh),38,915,157918,158833,video,FALSE
CompanyJ_3902,Behind the back. Through the legs. WHAT.  ( @Ballislife | @isaiahrivera1),73,4908,425912,430820,video,FALSE
CompanyJ_3903,FedEx Field is a slip 'n slide today @brgridiron  (via @thecheckdown),69,733,147344,148077,video,FALSE
CompanyJ_3904,Ramsey and Julio battling all day  @brgridiron   ( @nfl),56,1093,237344,238437,carousel,FALSE
CompanyJ_3905,Darius Leonard with the game-winning pick and BRUTAL stiff arm  @brgridiron  (via @NFL),87,618,110525,111143,video,FALSE
CompanyJ_3906,Rodgers tossed six TDs today and the Packers moved to 6-1  @brgridiron,70,2436,274269,276705,video,FALSE
CompanyJ_3907,Lamar wanted to go for it on fourth down. Lamar got it. Lamar scored  @brgridiron (via @thecheckdown),101,526,109363,109889,video,FALSE
CompanyJ_3908,Amari's route running is ridiculous  @brgridiron (via @thecheckdown),68,1929,229205,231134,video,FALSE
CompanyJ_3909,#NAME?,61,1592,294999,296591,video,FALSE
CompanyJ_3910,Zeke was eating all night  @brgridiron  147 yards TD W,54,1436,222922,224358,image,FALSE
CompanyJ_3911,Dak makes history in Dallas  (@campbells) #ad,45,513,68592,69105,video,TRUE
CompanyJ_3912,Niners WR Dante Pettis pulled up to go sailgating and started passing food to other boats  ( @wendys),101,165,32653,32818,video,FALSE
CompanyJ_3913,What we want to see in the East this season:,44,8096,642902,650998,carousel,FALSE
CompanyJ_3914,"2009  2019. The 09 draft class, 10 years later ",47,2099,494772,496871,carousel,FALSE
CompanyJ_3915,BASKETBALL IS BACK  B/R NBA writers predict the season ,55,1366,139793,141159,carousel,FALSE
CompanyJ_3916,Imagine this in the West ,25,4275,594212,598487,carousel,FALSE
CompanyJ_3917,Breaking: Zion Williamson out for 6-8 weeks after successful surgery for a torn lateral meniscus in his right knee,114,9904,495473,505377,image,FALSE
CompanyJ_3918,KD was confident if the Finals went 7 ,38,6884,499227,506111,carousel,FALSE
CompanyJ_3919,Tomorrow is STACKED ,20,1800,232394,234194,image,FALSE
CompanyJ_3920,"Over the summer, a young Chiefs fan with a brain tumor gave Patrick Mahomes a bracelet with her name on it (Whitney Wells). Hes been wearing it all season @brgridiron    (via @chiefslotjtailgatecrew | @nfldraftscout)",216,947,335841,336788,image,FALSE
CompanyJ_3921,Patriots forced Darnold into FIVE turnovers and moved to 7-0  @brgridiron,73,2232,242676,244908,carousel,FALSE
CompanyJ_3922,"The undefeated Patriots are trading a second-round pick for Falcons WR Mohamed Sanu, per @adamschefter  @brgridiron",115,5188,449281,454469,image,FALSE
CompanyJ_3923,Are you ready?,14,2658,104970,107628,video,FALSE
CompanyJ_3924,Hmm ,4,20405,435408,455813,image,FALSE
CompanyJ_3925,Timed the spare perfectly  (via @zachjbacon2),45,1914,275595,277509,video,FALSE
CompanyJ_3926,The NBA landscape has shifted to dynamic duos.,46,605,81287,81892,video,FALSE
CompanyJ_3927,"Belichick is an evil genius  In the 4th quarter last night, he had the Patriots commit back-to-back penalties on purpose. Jets declined both, and the clock kept running for over a minute. Belichick held back laughter on the sideline.  He said the loophole should be closed but right now, its open  @brgridiron",309,2687,447005,449692,carousel,FALSE
CompanyJ_3928,"Niners are trading for Emmanuel Sanders, per Mike Klis of @9newsdenver  Undefeated SF going all in @brgridiron",110,1317,216785,218102,image,FALSE
CompanyJ_3929,B/Rs Top 10 NBA players in 2019-20 ,35,3358,88773,92131,carousel,FALSE
CompanyJ_3930,The run. The finish. Raheem Sterling cut the defense open ,58,202,42518,42720,video,FALSE
CompanyJ_3931,Bradys former backups are balling...and Tom is freaking out  #GridironHeights,77,627,89598,90225,video,TRUE
CompanyJ_3932,The battle of LA begins tonight ,32,497,64654,65151,video,FALSE
CompanyJ_3933,Almost half the league  @brgridiron,35,2051,222372,224423,image,FALSE
CompanyJ_3934,THE NBA IS HERE...but Zion isnt ,32,5600,367084,372684,video,FALSE
CompanyJ_3935,"Welcome to the family, @dwyanewade ",35,225,70478,70703,video,FALSE
CompanyJ_3936,Every Raptors fan in attendance is gonna walk away with this replica championship ring  (via @lloydjulian),106,1647,257731,259378,video,FALSE
CompanyJ_3937,Raptors got their first championship banner ,44,2056,365318,367374,carousel,FALSE
CompanyJ_3938,Custom championship rings for @champagnepapi ,45,1825,333186,335011,carousel,FALSE
CompanyJ_3939,This Lonzo pass was filthy ,27,2823,382481,385304,video,FALSE
CompanyJ_3940,Bron fadeaway on Kawhi was tough ,33,5173,630941,636114,video,FALSE
CompanyJ_3941,Bron got MVP chants and Kawhi got booed. Staples Center is about to be appointment TV this year ,96,2499,299162,301661,video,FALSE
CompanyJ_3942,Kawhi and Bron trading buckets in the Battle of LA ,51,759,187802,188561,video,FALSE
CompanyJ_3943,LEBRON IS FED UP. STAREDOWN AFTER THE ,38,2465,230945,233410,video,FALSE
CompanyJ_3944,Its a new day in LA ,20,6177,328061,334238,video,FALSE
CompanyJ_3945,30 PTS | 6 REB | 5 AST,22,2990,255638,258628,video,FALSE
CompanyJ_3946,"Josh Normans crib has everything...giraffe rug, vibrating bed, personal barbershop, life-sized Batman painting. New Ditch the Playbook with @AdamLefkoe (@statefarm)",164,768,174283,175051,video,FALSE
CompanyJ_3947,This Raptors fan really got Commissioner Silver to present him with his replica ring  (via @k_jiwani),101,1738,369648,371386,video,FALSE
CompanyJ_3948,Nothing was going to stop this reporter  (via @matchtv_channel),63,834,107145,107979,video,FALSE
CompanyJ_3949,THIS GOAL. WOW.  (via @brfootball),34,1122,100643,101765,video,FALSE
CompanyJ_3950,"Kawhi may have been booed by Lakers fans during his home debut as a Clipper, but the Finals MVP stole the show at Staples ",122,518,89038,89556,video,FALSE
CompanyJ_3951,The silent superstar is speaking up  Julio Jones delivered an emotional locker room speech after the Falcons fifth straight loss supporting coach Dan Quinn: This man has done everything for us. ... Its on us. @brgridiron - - - (via @zachkleinwsb),246,2493,496453,498946,image,FALSE
CompanyJ_3952,"Patrick Beverley criticized TV programs that routinely show highlights of [LeBron] in defeats"" and challenged the media to ""report the facts"" after Lakers-Clippers on opening night  (via @chrisbhaynesnba)",204,10516,580539,591055,image,FALSE
CompanyJ_3953,"Patriots WR Josh Gordon is out for the year with a knee injury, per @FieldYates.   Flashs time in New England is likely over, too, and hell be waived once healthy, according to @rapsheet.",187,3265,305493,308758,image,FALSE
CompanyJ_3954,New era begins in Brooklyn tonight ,35,3517,340295,343812,image,FALSE
CompanyJ_3955,Kyrie and KD officially introduced in Brooklyn for the first time ,66,5123,537998,543121,carousel,FALSE
CompanyJ_3956,DJJ JUST THREW IT IN ,21,2571,324669,327240,video,FALSE
CompanyJ_3957,MARKELLE FULTZ DUNK IN TRANSITION,33,4784,449396,454180,video,FALSE
CompanyJ_3958,Cody Rhodes punched through the glass and threw Chris Jericho on the Dippin Dots cart  @brwrestling,99,5013,329313,334326,video,FALSE
CompanyJ_3959,"Despite the loss, Kyrie had an unforgettable Nets debut   50 PTS (most points ever in Nets debut) 8 REB 7 AST",109,3714,464827,468541,carousel,FALSE
CompanyJ_3960,The Joker and Nuggets open the season with a win over Portland ,63,1294,309554,310848,image,FALSE
CompanyJ_3961,DAME DOLLA. OPENING NIGHT. ,27,695,111050,111745,video,FALSE
CompanyJ_3962,Derrick Jones Jr. caught a BODY ,32,777,157822,158599,video,FALSE
CompanyJ_3963,LAMELO WITH THE GROWN MAN PUTBACK  (via @nbl) @br_hoops,55,1382,172117,173499,video,FALSE
CompanyJ_3964,If Kyrie hit a game-winner with an NBA Street move in his Brooklyn debut...,75,8268,554791,563059,video,FALSE
CompanyJ_3965,This Russ/Lockett elevator is genius  @brgridiron   (via @rudy_willingham),74,2166,278817,280983,video,FALSE
CompanyJ_3966,Happy birthday to the sideline champion @champagnepapi,54,1948,486768,488716,carousel,FALSE
CompanyJ_3967,"7'6"" Tacko Fall says a ""low ceiling"" was the reason he was in concussion protocol, per John Karalis",99,2079,369413,371492,image,FALSE
CompanyJ_3968,"Eight years ago, Adrian Peterson tore his ACL vs. the Redskins. He was ready for the start of the Vikings 2012 season nine months later. Unreal recovery  @brgridiron   His 2012 season:  MVP  2,097 yards  131.1 YPG  13 TDs  Eight yards from Eric Dickersons rushing record",270,1565,366535,368100,image,FALSE
CompanyJ_3969,This rally is wild  @brfootball (via @andersonaguia),52,2602,286273,288875,video,FALSE
CompanyJ_3970,Yesterday was one year after Kyrie's grandfather's death.  Dropped 50 for him ,78,918,300658,301576,image,FALSE
CompanyJ_3971,The artist who did it sucked!  @jno24 isnt a fan of the life-sized Batman painting in his house,95,263,58321,58584,video,FALSE
CompanyJ_3972,From OKC to H-town  Russ makes his Rockets debut tonight ,57,457,133935,134392,video,FALSE
CompanyJ_3973,"A man wielding a baseball bat tried to break into Fletcher Coxs New Jersey home earlier this month looking for his ex-girlfriend, but the Eagles tackle scared him off with a shotgun.  Cops pursued and eventually arrested the man. (via @6abcactionnews | @brgridiron)",265,4458,397280,401738,image,FALSE
CompanyJ_3974,#NAME?,48,452,102694,103146,video,FALSE
CompanyJ_3975,Vince checks in.  22 seasons. History made ,43,2688,444464,447152,carousel,FALSE
CompanyJ_3976,Russ got his old dance partner back  (via @nbaontnt),52,1805,382331,384136,video,FALSE
CompanyJ_3977,Russ and Harden already going back and forth ,45,8129,595244,603373,video,FALSE
CompanyJ_3978,NBA suspends Deandre Ayton 25 games for testing positive for a diuretic,71,5477,427063,432540,image,FALSE
CompanyJ_3979,Ice Trae looking to make the leap  38 PTS | 9 AST | 7 REB,57,1665,301085,302750,carousel,FALSE
CompanyJ_3980,GIANNIS CHASES DOWN HARDEN ,27,2448,332450,334898,video,FALSE
CompanyJ_3981, Beard to Brodie ,17,1056,167819,168875,video,FALSE
CompanyJ_3982,Loading...  DLo scores the first 10 PTS for the Warriors,56,1117,229088,230205,video,FALSE
CompanyJ_3983,Kawhi ,6,2057,264465,266522,video,FALSE
CompanyJ_3984,The connection would be unreal... @brgridiron,45,2664,345423,348087,image,FALSE
CompanyJ_3985,"People in the NFL think @jno24 is weird, but hes cool with it.",62,152,30187,30339,video,FALSE
CompanyJ_3986,"If the Chiefs star QB doesnt play this weekend, Kansas City could be in serious trouble...",90,273,49875,50148,video,FALSE
CompanyJ_3987,#NAME?,173,275,71700,71975,video,FALSE
CompanyJ_3988,He got them fired up before a big game   From @Ford X B/R #PFHOF,64,194,51703,51897,video,FALSE
CompanyJ_3989,He was having too much fun  @brfootball,39,750,118645,119395,video,FALSE
CompanyJ_3990,Juan Sotos come-up is bigger than baseball  Finished English program at Nationals Academy in one season  Refused to speak Spanish with teammates: Only English  Ordered off McDonalds menu for practice,199,608,181151,181759,carousel,FALSE
CompanyJ_3991,Kyrie vs. RJ. Knicks vs. Nets.  Battle of the boroughs goes down tonight at Barclays ,85,381,80625,81006,video,FALSE
CompanyJ_3992,@mattressmack already has more than $10M on the Astros winning the World Series and just put down $325K more in Vegas today @br_betting  All that money ,152,4919,276373,281292,video,FALSE
CompanyJ_3993,Kyrie and Theo Pinson had to impersonate Caris LeVert's hesi ,61,1254,341876,343130,video,FALSE
CompanyJ_3994,Kyrie's go-ahead shot vs. the Knicks looked familiar... ,56,2814,523998,526812,carousel,FALSE
CompanyJ_3995,Jerami Grant was FLYING in Denver tonight ,42,2047,471911,473958,carousel,FALSE
CompanyJ_3996,TORREY CRAIG: GAME-WINNING BLOCK IN OT ON DEVIN BOOKER,54,1357,209534,210891,video,FALSE
CompanyJ_3997,#NAME?,65,1176,296535,297711,video,FALSE
CompanyJ_3998,The Big Ten has represented well thus far this season ,54,802,129915,130717,image,FALSE
CompanyJ_3999,"35 years ago today, Michael Jordan made his NBA debut  Final Line: 16 PTS, 7 AST, 6 REB, 4 BLK, 2 STL ",102,2001,377370,379371,carousel,FALSE
CompanyJ_4000,#NAME?,139,288,78075,78363,video,FALSE
CompanyJ_4001,"After reports that Jalen Ramsey split with Golden Tates sister Breanna when she was pregnant, the WR says, He know he gonna have to see me. (h/t @nypost, @brgridiron)",166,3312,384509,387821,carousel,FALSE
CompanyJ_4002,Christian Pulisic scores his first Chelsea goal  @brfootball,60,472,108786,109258,image,FALSE
CompanyJ_4003,"The most dramatic strikeout call today  (via @hectorgomezmlb, @elampaya)",72,828,92675,93503,video,FALSE
CompanyJ_4004,First career hat-trick for Pennsylvanias own @cmpulisic  @brfootball,68,511,133155,133666,carousel,FALSE
CompanyJ_4005,"""I can't sign that."" @dwyanewade always staying loyal to the brand  @brkicks (via @itskage_official)",100,789,300662,301451,video,FALSE
CompanyJ_4006,"Justin Fields put on a show in Columbus   2 passing TDs, 0 INTs  1 rushing TD  Led Buckeyes to a 38-7 win over No. 13 Wisconsin",127,1559,247709,249268,carousel,FALSE
CompanyJ_4007,Ohio State marching band took the fans to Bikini Bottom at halftime  (via @tbdbitl),83,1922,173408,175330,video,FALSE
CompanyJ_4008,"You make me proud, son  Raptors GM Masai Ujiri went back to Nigeria to surprise his parents with the championship trophy  Real Sports HBO is streaming on @hbo",158,753,132212,132965,video,FALSE
CompanyJ_4009,Down goes Oklahoma ,19,924,107469,108393,video,FALSE
CompanyJ_4010,This hit  (via @vol_football),29,962,151307,152269,video,FALSE
CompanyJ_4011,GIANNIS FORCES OT,17,1440,257155,258595,video,FALSE
CompanyJ_4012,Bryan Edwards with one of the most absurd one-handed catches of the season ,75,486,129930,130416,video,FALSE
CompanyJ_4013,Tristan Thompson hit his first career 3PT and Kevin Love loved it ,66,1292,211649,212941,video,FALSE
CompanyJ_4014,Harden hit himself in the face and Josh Hart couldn't believe it ,65,7037,472226,479263,video,FALSE
CompanyJ_4015,D-Rose getting MVP chants in Detroit,36,2683,425583,428266,video,FALSE
CompanyJ_4016,"Zaire threw it down in front of LeBron, D-Wade and Gab  @br_hoops",65,563,150420,150983,video,FALSE
CompanyJ_4017,Russ passes Magic for second all-time in triple-doubles ,56,1140,265989,267129,image,FALSE
CompanyJ_4018,The Beard literally went off after this no-call ,48,2952,263891,266843,video,FALSE
CompanyJ_4019,OSU WR TYLAN WALLACE WENT BEAST MODE ,37,1386,226709,228095,video,FALSE
CompanyJ_4020,Opponents are statistically better off spiking the ball every play than passing on this Patriots defense  @brgridiron,117,3076,381599,384675,carousel,FALSE
CompanyJ_4021,@traeyoung over the first two games:   77 points  18 assists  14 rebounds  11 3s,80,1823,316654,318477,carousel,FALSE
CompanyJ_4022,Time to start talking about Rodgers in the MVP convo ,53,546,41642,42188,video,FALSE
CompanyJ_4023,Zaire to Bronny had DWade and Bron hyped  @br_hoops,51,726,131231,131957,video,FALSE
CompanyJ_4024,Drew Brees is back after missing five games. Saints season couldve been lost but Teddy Bridgewater held it DOWN and went 5-0  @brgridiron,137,2601,380555,383156,carousel,FALSE
CompanyJ_4025,Lou Williams turns 33 today   Drafted 45th overall in 2005  Played for six teams  3x 6th Man of the Year  One of the best players ever to come off the bench  Game is aging like fine wine.,187,1974,466584,468558,carousel,FALSE
CompanyJ_4026,SAQUON RUNNING MEAN (via @nfl),30,1608,161019,162627,video,FALSE
CompanyJ_4027,"Jets had the Butt Fumble. Today, the Browns gave us the Foot Fumble  Patriots scooped and scored after a Browns lineman kicked it out of Chubbs hands @brgridiron   (via @nfl)",174,638,117427,118065,video,FALSE
CompanyJ_4028,Warriors got beat by 28 ,24,6388,496693,503081,carousel,FALSE
CompanyJ_4029,Kyrie too cold with it   From B/R x @coorslight,47,314,34332,34646,video,FALSE
CompanyJ_4030,Deshaun Watson is ridiculous:  Broke the sack  Got kicked in the face  Threw the TD  WOW. @brgridiron (via @nfl),112,541,85228,85769,video,FALSE
CompanyJ_4031,Brady sends Baker home with an L.  Pats move on to 8-0  @brgridiron,67,3473,264739,268212,video,FALSE
CompanyJ_4032,J.J. Watt will miss the remainder of the season after suffering a torn pec  Prayers up  @brgridiron,99,1414,179752,181166,image,FALSE
CompanyJ_4033,JAE CROWDER FOR THE WIN ,24,2085,272972,275057,video,FALSE
CompanyJ_4034,Ja vs. Kyrie was a BATTLE   Ky: 37 | 7 | 7 Ja: 30 | 4 | 8,57,1404,191294,192698,video,FALSE
CompanyJ_4035,Spo called out each ref individually ,37,2542,441693,444235,video,FALSE
CompanyJ_4036,"Dwight Howard was everywhere for the Lakers tonight   16 PTS, 10 REB & 4 BLK on 8-8 FG against his former team",110,4415,594579,598994,video,FALSE
CompanyJ_4037,Odell gave Tom Brady cleats made with real goat hair after Patriots/Browns. OBJ said TB deserved them because hes more the GOAT than I am  @brkicks | @brgridiron,161,1854,378202,380056,carousel,FALSE
CompanyJ_4038,#NAME?,73,3407,501729,505136,video,FALSE
CompanyJ_4039,18-year-old wonderkid Sergino Dest officially chooses to represent the USMNT over the Netherlands  @brfootball,110,1389,192019,193408,image,FALSE
CompanyJ_4040,"Kawhi looking to monetize the memes  Klaws team files to trademark WHAT IT DO BABY for a brand of clothing, per @joshgerbenshow",127,3323,498124,501447,image,FALSE
CompanyJ_4041,"WR Decoldest ""ToEvaDoIt"" Crawford has committed to LSU    (via @_.cold2)",72,3395,418705,422100,image,FALSE
CompanyJ_4042,Thunder vs. Rockets. CP3 vs. Russ.  The revenge game is here ,61,485,119127,119612,video,FALSE
CompanyJ_4043,From @Ford X B/R #PFHOF,23,89,27130,27219,video,FALSE
CompanyJ_4044,Deshaun Watson took a foot directly to the face and threw the eventual game-winner with one eye. Built different  @brgridiron  (via @nflfilms),142,6072,677613,683685,carousel,FALSE
CompanyJ_4045,"Tom Brady and his son Ben waited outside the visiting locker room after the Browns/Patriots game so Ben could meet @obj.  The QB, WR and nine-year-old had a ""lengthy chatwell after both locker rooms had cleared out""  @brgridiron  (via Nicole Yang of the @bostonglobe)",267,3758,545623,549381,image,FALSE
CompanyJ_4046,Bulls and Raptors brought back the throwback heat tonight ,58,774,355441,356215,carousel,FALSE
CompanyJ_4047,"Straight up disrespectful, @joelembiid",38,2009,205145,207154,video,FALSE
CompanyJ_4048,VanVleet did Fultz dirty ,25,1882,199188,201070,video,FALSE
CompanyJ_4049,D-Rose coming through in the clutch ,36,1471,239706,241177,video,FALSE
CompanyJ_4050,Russ still taking rebounds from Steven Adams ,45,1789,365913,367702,video,FALSE
CompanyJ_4051,This Russ dime was NASTY.,25,1040,204884,205924,video,FALSE
CompanyJ_4052,"Kyrie Irvings ""mood swings"" are an ""unspoken concern that makes Brooklyn officials queasy.""  Nets sources say an episode happened on their trip to China, leaving the team confused, per Jackie MacMullan",201,14617,663008,677625,image,FALSE
CompanyJ_4053,Kawhi on the Clippers bench after Montrezl Harrells dunk ,57,4645,451065,455710,video,FALSE
CompanyJ_4054,Fun guy gets it ,16,2133,468089,470222,image,FALSE
CompanyJ_4055,#NAME?,86,1579,254470,256049,video,FALSE
CompanyJ_4056,"NCAA's governing board voted unanimously to allow student-athletes the opportunity to benefit from their names, images and likenesses",133,3145,405161,408306,image,FALSE
CompanyJ_4057,Patriots are a FORCE  @brgridiron,33,2470,269923,272393,image,FALSE
CompanyJ_4058,#NAME?,75,927,157189,158116,video,FALSE
CompanyJ_4059,"16 years ago today, @KingJames made his pro debut  25 PTS 6 REBS 9 ASTS 4 STLS  And the rest is history ",104,1513,274592,276105,carousel,FALSE
CompanyJ_4060,An evil clown is terrorizing the town and giving the 04 draft class nightmares   Special extended #GridironHeights x IT episode ,128,838,141566,142404,carousel,TRUE
CompanyJ_4061,"Bron sent a taco truck to feed the first responders fighting the Getty fire: ""Its an amazing job what they do and their commitment with whats going on right now, per @davemcten (via @mayorofLA)",193,3908,617092,621000,carousel,FALSE
CompanyJ_4062,Messi has now passed Ronaldo in club goals scoredin 118 fewer games@brfootball,78,4520,318402,322922,image,FALSE
CompanyJ_4063,Tyler Herro WENT OFF for 19 PTS in the 2Q ,42,1682,208429,210111,video,FALSE
CompanyJ_4064,CAM REDDISH ON TYLER HERRO ,27,1856,147495,149351,video,FALSE
CompanyJ_4065,"AD becomes first Lakers player since Shaq (March, 2003) to post 40+ PTS, 20+ REB in a game ",91,3194,617856,621050,carousel,FALSE
CompanyJ_4066,Bron got the crowd to chant Taco Tuesday ,41,1223,217769,218992,video,FALSE
CompanyJ_4067,Former All-Pro CB Antonio Cromartie says kneeling in 2016 led to his release from the Colts and ended his NFL career. New Untold Stories with @master_tesfatsion.,161,2080,137113,139193,video,FALSE
CompanyJ_4068,"Teddy Bridgewater set himself up to get PAID by going 5-0 without Brees  Several team officials believe the QB could get $20M-$30M yearly as a free agent this summer, per @brgridirons Mike Freeman.",197,11962,442301,454263,image,FALSE
CompanyJ_4069,Classic Mamba ,14,8667,628098,636765,image,FALSE
CompanyJ_4070,#NAME?,22,397,105132,105529,video,FALSE
CompanyJ_4071,The new teammates came together to do an escape room | From B/R x @jcpenney,75,168,48727,48895,video,FALSE
CompanyJ_4072,Amazing stuff from Russ  @brgridiron,36,1819,287820,289639,carousel,FALSE
CompanyJ_4073,"Kyle Kuzma will make his season debut this Friday vs. Dallas, per @shamsnba",75,1946,321838,323784,image,FALSE
CompanyJ_4074,KAT and Embiid GOING AT IT  Wow.,32,23964,1000359,1024323,video,FALSE
CompanyJ_4075,Did Ben Simmons really put KAT in a chokehold?,46,8214,434287,442501,video,FALSE
CompanyJ_4076,These pictures are wild ,24,10661,689623,700284,carousel,FALSE
CompanyJ_4077,COLLIN SEXTON CAUGHT A BODY.,28,3150,395193,398343,video,FALSE
CompanyJ_4078,Beard dropped 59 PTS in the win ,32,1565,268683,270248,carousel,FALSE
CompanyJ_4079,From Wild Card berth to World Series champions. What a run.,59,4109,399403,403512,image,FALSE
CompanyJ_4080,Breaking: Steph Curry has a broken left hand,44,15292,684659,699951,image,FALSE
CompanyJ_4081,KD gone. No Klay. No Steph. Tough go for Warriors fans ,55,9158,465430,474588,video,FALSE
CompanyJ_4082,Kyrie with the spooky handle ,29,2382,323430,325812,video,FALSE
CompanyJ_4083,Nationals made history  Well-deserved celebration,49,940,195743,196683,carousel,FALSE
CompanyJ_4084,"B/Rs NBA Frankenstein? We took LeBrons brain, Currys eyes and more to construct the spookiest basketball monster ",113,410,93171,93581,carousel,FALSE
CompanyJ_4085,"SPOT THE DIFFERENCE, HALLOWEEN EDITION: Can you find whats different between the first video and the second video? ",115,6974,238955,245929,carousel,FALSE
CompanyJ_4086,KD kept it real ,16,2359,240311,242670,image,FALSE
CompanyJ_4087,"One year ago today, D-Rose exploded for an unforgettable 50 points ",67,2730,591110,593840,carousel,FALSE
CompanyJ_4088,Beard dropped 59 and Book destroyed the Dubs. Hot hands all over the league last night ,87,174,43328,43502,video,FALSE
CompanyJ_4089,Fournette just laughed whenever the Jets tackled him  @brgridiron  (via @NFLFilms),82,1692,244577,246269,video,FALSE
CompanyJ_4090,"Trent Williams says he had a rare form of cancer (DFSP) and nearly lost his life. Williams says the growth on his head was found 5-6 years ago, but the Redskins medical staff diagnosed it as something minor.  The star tackle, who had been holding out for a new contract, has no trust in the team. @brgridiron",308,1778,322706,324484,image,FALSE
CompanyJ_4091,"Embiid and KAT suspended for 2 games for last nights fight, no fine for Ben Simmons.",84,2392,336976,339368,image,FALSE
CompanyJ_4092,"The Bosa family is taking over. Defensive Player of the Week (8): NFC, Nick Bosa AFC, Joey Bosa   @brgridiron",109,1152,298108,299260,image,FALSE
CompanyJ_4093,"Chuck called the Embiid-KAT fight a ""snuggle party""  (via @nbaontnt)",68,1223,121425,122648,video,FALSE
CompanyJ_4094,Bradys a savage for this one @brgridiron,40,1403,319591,320994,carousel,FALSE
CompanyJ_4095,#NAME?,58,2733,623038,625771,carousel,FALSE
CompanyJ_4096,MPJ checks in and gets first bucket in NBA debut ,49,1254,382379,383633,video,FALSE
CompanyJ_4097,Kendrick Nunn is making the most of his opportunity. What a pick up for the Heat ,81,1484,304823,306307,carousel,FALSE
CompanyJ_4098,Zion accidentally hit Jaxson Hayes in the face on this celebration. Hayes immediately moved seats ,98,1638,471586,473224,video,FALSE
CompanyJ_4099,Kentucky fan was beyond hyped after getting a wristband from Tyler Herro  (via @nba),84,2457,343710,346167,video,FALSE
CompanyJ_4100,Kawhi handled the Spurs on both ends of the floor   38 PTS 12 REB 4 STL,71,1617,367513,369130,carousel,FALSE
CompanyJ_4101,"After losing Stephen Curry, the Warriors as we knew them no longer exist  Howard Beck still sees a positive opportunity for this season",135,2537,283909,286446,video,FALSE
CompanyJ_4102,Kawhis son is his motivation ,29,1505,381227,382732,image,FALSE
CompanyJ_4103,Whoops  @brfootball,19,1973,293306,295279,video,FALSE
CompanyJ_4104,Ive always felt underrated ... its part of my DNA. @underarmour,63,746,120734,121480,video,FALSE
CompanyJ_4105,Bron on how the Lakers can stop Lukas razzmatazz hop-skiddilyy-doo  (via @instamulf),84,4899,531709,536608,video,FALSE
CompanyJ_4106,Stephen Curry underwent surgery for his broken left hand and is expected to miss at least three months,102,2866,296702,299568,image,FALSE
CompanyJ_4107,"Russell Wilson gets another weapon Josh Gordon will be a Seahawk after being claimed off waivers, per @rapsheet",111,2583,405858,408441,image,FALSE
CompanyJ_4108,Canelos head movement makes him nearly untouchable ,51,11305,827207,838512,video,FALSE
CompanyJ_4109,D-Rose got a standing ovation and MVP chants in his return to Chicago then converted the and-1 ,95,1857,350773,352630,video,FALSE
CompanyJ_4110,Thanasis Antetokounmpo with the poster and Giannis LOVES it ,60,2128,526946,529074,video,FALSE
CompanyJ_4111,@therock seems ready for UFC 244 between Nate Diaz and Jorge Masvidal  (via @ufc) Swipe ,88,754,231138,231892,carousel,FALSE
CompanyJ_4112,TATUM. GAME.,12,3055,227127,230182,video,FALSE
CompanyJ_4113,ALEX CARUSO CAME FLYING IN ,27,1356,175829,177185,video,FALSE
CompanyJ_4114,FLIGHT SQUAD  @acfresh21 @kingjames,35,2100,596902,599002,image,FALSE
CompanyJ_4115,Will we witness another shocker? ,33,1898,163354,165252,image,FALSE
CompanyJ_4116,LeBrons force is undeniable ,28,1834,288951,290785,video,FALSE
CompanyJ_4117,Canelo knocked him out with a body punch ,41,1427,223754,225181,video,FALSE
CompanyJ_4118,#NAME?,57,754,157669,158423,video,FALSE
CompanyJ_4119,CONTENDER FOR CATCH OF THE YEAR ,32,812,245013,245825,video,FALSE
CompanyJ_4120,Josh Hart pulled a Harden ,26,3205,482692,485897,video,FALSE
CompanyJ_4121,"Evander Holyfields son, Evan, just made his pro boxing debut and crushed his opponent   Looking like the real deal. (via @dazn_usa)",131,2536,363536,366072,video,FALSE
CompanyJ_4122,This go-ahead shot was Furkan crazy ,36,1971,234135,236106,video,FALSE
CompanyJ_4123,Jorge Masvidal beats Nate Diaz by TKO (doctors stoppage) going into round 4  Doctor stopped the fight due to Diazs cut over his eye,131,2828,371091,373919,carousel,FALSE
CompanyJ_4124,Canelo Alvarez knocks out Sergey Kovalev to become the WBO light heavyweight champion   Hes now a FOUR division boxing champion. (via @dazn_usa),144,3844,355564,359408,video,FALSE
CompanyJ_4125,TONIGHT  x  @brgridiron,23,1441,172875,174316,carousel,FALSE
CompanyJ_4126,"On this day in 1996, an 18-year-old rookie guard made his NBA debut wearing No. 8 for the Lakers. He played six minutes and scored zero points.  Quiet start to an epic career.",175,3858,645232,649090,image,FALSE
CompanyJ_4127,Nate wants to go again ,23,1711,271876,273587,image,FALSE
CompanyJ_4128,"@deshaunwatson said he checked to make sure his eye was still there after getting kicked while throwing the game-winner last Sunday. After dealing with swelling all week, he led the Texans to a 26-3 win in London without a visor. Different mentality  @brgridiron   (via @richeisen)",281,1836,441993,443829,carousel,FALSE
CompanyJ_4129,This is mesmerizing  @brgridiron  (via @thecheckdown),53,446,188379,188825,video,FALSE
CompanyJ_4130,Tyreek was the only one catching Damien Williams @brgridiron   (via @thecheckdown),82,1785,239402,241187,video,FALSE
CompanyJ_4131,Today was Trubiskys fifth game without a touchdown this year. He hasnt thrown for 300 yards once on the season  @brgridiron,123,5935,458776,464711,image,FALSE
CompanyJ_4132,COURTLAND SUTTON TURNED INTO RANDY MOSS @brgridiron  (via @NFL),63,762,132577,133339,video,FALSE
CompanyJ_4133,"Disney+ is set to develop a movie called Greek Freak about the life of Giannis, per @deadline",93,2352,469585,471937,carousel,FALSE
CompanyJ_4134,Masvidal has some words for Conor ,34,2174,270852,273026,image,FALSE
CompanyJ_4135,"NFL league office told OBJ and Jarvis Landry to change their cleats at halftime or they wouldnt be able to play the rest of game vs. Broncos, per @jayfeely | h/t @brgridiron",173,5163,518581,523744,image,FALSE
CompanyJ_4136,"FLEX ON EM, DWIGHT ",19,2534,428454,430988,video,FALSE
CompanyJ_4137,They let Snoop Dogg do the Lakers play-by-play ,47,6227,746425,752652,video,FALSE
CompanyJ_4138,Kawhi making it look too easy ,30,2476,251619,254095,video,FALSE
CompanyJ_4139,Lamar and the Ravens hand the Patriots their first loss of season @brgridiron,77,3082,479244,482326,carousel,FALSE
CompanyJ_4140,The last undefeated team in the NFL  @brgridiron,48,1971,265807,267778,image,FALSE
CompanyJ_4141,The comedian shares her epic revenge story before eating worm salad with @sergeibaka on the newest How Hungry Are You? (@SamsungMobileUSA),138,730,124621,125351,video,FALSE
CompanyJ_4142,Lakers have won five straight and are top of the West at 5-1. Look out ,71,4303,487717,492020,carousel,FALSE
CompanyJ_4143,Colin Kaepernick turned 32 on Sunday. He spent the day handing out food and supplies to the homeless in Oakland.  Respect  @brgridiron  - - - (via @tmz_tv | @yourrightscamp),173,1848,120774,122622,video,FALSE
CompanyJ_4144,Bradley Beal shared a key piece of advice with Jayson Tatum after he got drafted: Tomorrows not promised  Watch the full episode in the Uninterrupted Stream.,157,311,156872,157183,video,FALSE
CompanyJ_4145,All respect between Lamar and Brady  @brgridiron,48,1292,345261,346553,image,FALSE
CompanyJ_4146, New episode of the Champions  @brfootball,42,332,68828,69160,video,FALSE
CompanyJ_4147,"Frank Gore is a true OG  Bills vet made sure Adrian Peterson took time for rookie RB Devin Singletary | @brgridiron   (via @thadbrown7, @news8_wroc)",148,3265,584085,587350,video,FALSE
CompanyJ_4148,He's dropping 11 colorways ,27,613,74587,75200,video,FALSE
CompanyJ_4149,Tyreek Hill says he chased down Damien Williams on the running backs 91-yard TD because Williams always tells everyone hes the fastest player on the Chiefs. @cheetah had to let him know | @brgridiron --- (via ESPNs Ed Werder),225,818,351632,352450,image,FALSE
CompanyJ_4150,JA GOT DISRESPECTFUL ,21,2010,280417,282427,video,FALSE
CompanyJ_4151,Cat ran on the field and found the end zone  (via @thecheckdown),64,915,91960,92875,video,FALSE
CompanyJ_4152,BI WAS HOOPIN.  40 PTS (career high) 17-24FG 5 REBS 5 ASTS,58,4391,516625,521016,carousel,FALSE
CompanyJ_4153,Harden with the step-back dagger. Ice cold   From B/R X @coorslight,67,874,94091,94965,video,FALSE
CompanyJ_4154,MVP chants for D-Book tonight 40 PTS (15-19FG)  Suns are 5-2 and just handed the Sixers their first L of the season ,116,3918,561063,564981,carousel,FALSE
CompanyJ_4155,Rookie big man Eric Paschall went 3-3 from deep in the first quarter   From B/R x @underarmour,94,770,98279,99049,video,FALSE
CompanyJ_4156,"Warriors rookie @epaschall has dropped 61 total points in his last two games.  After being drafted in the second round back in June, @spidadmitchell let him know he deserved to be in the league. *NSFW* (via @caa_basketball)",223,1051,484537,485588,carousel,FALSE
CompanyJ_4157,"Frank Gore (No. 4 rusher ever) and Adrian Peterson (No. 6) made history on Sunday as the first two backs with 13,500+ yards to play in the same game. Two of our generations best. Dont take them for granted  @brgridiron  (h/t @andrewsiciliano)",242,1280,452011,453291,image,FALSE
CompanyJ_4158,Ice Trae was unstoppable before the ankle injury. Hes back tonight against the Spurs ,85,608,132810,133418,video,FALSE
CompanyJ_4159,Oregon has a collapsible toilet on the sideline for the players  (via @jcmack03),80,3980,501501,505481,video,FALSE
CompanyJ_4160,"Get healthy, Cam ",17,1981,204845,206826,image,FALSE
CompanyJ_4161,Dwight Howards second stint in LA is exactly what Superman needed ,66,1110,186393,187503,video,FALSE
CompanyJ_4162,Dak has been lights out against the Giants (@campbells) #ad,59,451,37357,37808,video,TRUE
CompanyJ_4163,THIS IS WILD  @brfootball,25,2139,154594,156733,video,FALSE
CompanyJ_4164,Still got the header though  @brfootball,40,338,77792,78130,video,FALSE
CompanyJ_4165,Wentz takes Foles under his wing to help him get his Big Nick Energy back  #GridironHeights,91,364,66363,66727,video,TRUE
CompanyJ_4166,C-Mac is on pace for an all-time RB season  @brgridiron,55,1381,217658,219039,image,FALSE
CompanyJ_4167,OFF THE FACE  @brfootball,25,1027,88372,89399,video,FALSE
CompanyJ_4168,Gordon Hayward is officially back  39 PTS (career-high) | 8 AST | 7 REB,71,3712,491466,495178,carousel,FALSE
CompanyJ_4169,First CFP rankings ,19,4027,206400,210427,image,FALSE
CompanyJ_4170,Trae is just RIDICULOUS ,24,3673,535659,539332,video,FALSE
CompanyJ_4171,DWIGHT DOING IT ALL ,20,3783,394467,398250,video,FALSE
CompanyJ_4172,"Bron went on an absolute tear this Lakers road trip, picking up his 3rd straight triple-double ",95,5039,627385,632424,carousel,FALSE
CompanyJ_4173,We'll wait.,11,6648,548223,554871,video,FALSE
CompanyJ_4174,Kentucky freshman @tyresemaxey iced the game at MSG to beat No. 1 MSU in front of John Wall  @br_hoops *NSFW*,109,1455,465197,466652,carousel,FALSE
CompanyJ_4175,Texas guard Andrew Jones played real minutes last night for the first time since being diagnosed with leukemia in January 2018.    20 points (career high)   8/13 FG   4/5 3PT   I cant even explain the feeling ,209,1215,407227,408442,image,FALSE
CompanyJ_4176,"Yeah, theyre screwed Rams punter @jhekk shows Caron Butler, @adamlefkoe and comedian Taran Killam how hard it is to catch punts in the NFL. New Ditch the Playbook.",163,231,81293,81524,video,FALSE
CompanyJ_4177,#NAME?,52,5186,484642,489828,video,FALSE
CompanyJ_4178,Kid saw his opportunity and took it  @brfootball,48,756,129717,130473,video,FALSE
CompanyJ_4179,"Some teams believe OBJ could get traded if Clevelands struggles continue into next season, per @brgridirons Mike Freeman    One NFC official: The vultures will be circling if the Browns keep sucking.",199,6011,492129,498140,image,FALSE
CompanyJ_4180,Former NBA stars are coaching the next generation,49,176,73399,73575,video,FALSE
CompanyJ_4181,Got past SEVEN players to win the game in the 93rd minute  @brfootball,70,589,101816,102405,video,FALSE
CompanyJ_4182,WHAT JUST HAPPENED  @brfootball,31,1001,124475,125476,video,FALSE
CompanyJ_4183,Looking for mama @brgridiron   (via @nflfilms),46,1408,266037,267445,video,FALSE
CompanyJ_4184,18 years old. Champions League hat-trick for Real Madrid. Rodrygo is the real deal  @brfootball,95,444,131385,131829,image,FALSE
CompanyJ_4185,"Bill Polian infamously said Lamar should be a receiver. Today he admitted he was wrong  @brgridiron  LJ since those comments: 12-3 as starter 28 total TDs 4,346 total yards Youngest QB to start playoff game Youngest with perfect passer rating No. 1 scoring offense (2019) Beat undefeated Patriots",296,2471,298987,301458,image,FALSE
CompanyJ_4186,Carusos got jokes ,18,2052,565467,567519,image,FALSE
CompanyJ_4187,Trevor Lawrences twin  (via @bellasmartina),43,2907,329273,332180,video,FALSE
CompanyJ_4188,Cole Anthony had a historic debut for the Tar Heels  @br_hoops,62,1217,274297,275514,image,FALSE
CompanyJ_4189,H-Town ,7,1212,389904,391116,carousel,FALSE
CompanyJ_4190,You cant do that Bledsoe ,25,2305,206948,209253,video,FALSE
CompanyJ_4191,Which one is worse? ,20,8815,555657,564472,video,FALSE
CompanyJ_4192,Greek Freak making more history ,32,3514,490210,493724,image,FALSE
CompanyJ_4193,Kent States Kalin Bennett becomes the first player with autism to score in a D-I game  (via mitchmeyersTV/tw),109,10475,804479,814954,video,FALSE
CompanyJ_4194,Agree with MJ? ,15,7109,499887,506996,image,FALSE
CompanyJ_4195,CMC is poised to go OFF this Sunday ,36,201,48099,48300,video,FALSE
CompanyJ_4196,Lamars leadership  Ravens QB ran in to help both of his linemen up  (via @thecheckdown),87,1084,306443,307527,video,FALSE
CompanyJ_4197,Kings star @swipathefox talks trash and goes 1v1 with four-time Call of Duty champ @censorr during a game of Black Ops 4. Swipa held his own  #Battlestations @brgaming,167,293,78907,79200,video,FALSE
CompanyJ_4198,NBA has fined Clippers $50K for Doc Rivers' inconsistent statements on Kawhi Leonard's health status,100,3891,463034,466925,image,FALSE
CompanyJ_4199,"""Suck it, Lefkoe!"" Rams punter @jhekk roasted @adamlefkoe for losing in a punt-catching competition ",100,120,69637,69757,video,FALSE
CompanyJ_4200,"Hours after posting f--k the NFL, AB says he just wants to play  @brgridiron",76,18044,479507,497551,carousel,FALSE
CompanyJ_4201,Kemba Walker was emotional after getting a tribute video and standing ovation in his return to Charlotte ,105,974,391193,392167,video,FALSE
CompanyJ_4202,Embiid missed a clutch free throw in a two-point loss and ruined this guys 10-game parlay  @br_betting  (via @babyafrica_),122,4283,327970,332253,video,FALSE
CompanyJ_4203,Kemba showed loved to all the Hornets players postgame. Nothing but respect ,76,392,218805,219197,video,FALSE
CompanyJ_4204,Jimmy Butler became the 1st Heat player since Bron (2014) to post a 30-point half ,82,2039,502829,504868,carousel,FALSE
CompanyJ_4205,"Coach Prime?   Deion Sanders has emerged as a candidate for the head coaching job at Florida State, per @rapsheet and @mike_garafolo",132,2635,360211,362846,image,FALSE
CompanyJ_4206,"@swipathefox games every day, but you wont catch him playing 2K  #Battlestations",80,386,126818,127204,video,TRUE
CompanyJ_4207,Kawhi Leonards shirt was made by students at the LA and Moreno Valley schools where he donated a million backpacks ,115,2508,466982,469490,image,FALSE
CompanyJ_4208,"Can you catch a punt? @adamlefkoe, @caronbutler and SNL alum @tarzannoz learned how hard it is in the NFL ",106,438,71236,71674,video,FALSE
CompanyJ_4209,Shaq showed no mercy for Charles Barkley  (via @nbaontnt),57,2946,332315,335261,video,FALSE
CompanyJ_4210,Kendrick Nunn has been making a strong case for ROY in Miami ,61,1035,253189,254224,video,FALSE
CompanyJ_4211,The Warriors had their time. Now the league wants revenge.,58,10855,509927,520782,image,FALSE
CompanyJ_4212,"Stephen Curry unlikely to play the remainder of the season, per B/Rs Ric Bucher",79,12071,504073,516144,image,FALSE
CompanyJ_4213,Mahomes ready for action again  @brgridiron,43,612,136618,137230,image,FALSE
CompanyJ_4214,Beard doesn't believe in taking games off for load management ,62,4481,312302,316783,image,FALSE
CompanyJ_4215,The King has been goatd in LA  (via butlerthebully/TW),54,4166,431971,436137,video,FALSE
CompanyJ_4216,Its been exactly one year since Melo last played in an NBA game,63,4545,490120,494665,carousel,FALSE
CompanyJ_4217,#NAME?,88,425,92112,92537,video,FALSE
CompanyJ_4218,NCAA has ruled Memphis James Wiseman ineligible for 2019-2020 season,68,4764,361559,366323,image,FALSE
CompanyJ_4219,Nobody in sports is touching @swipathefox in CoD ,49,2794,292489,295283,image,FALSE
CompanyJ_4220,Rui Hachimura was HYPED after dropping the hammer ,50,628,203788,204416,video,FALSE
CompanyJ_4221,Donovan Mitchell with one of the best dunks that didnt count ,61,3805,615210,619015,video,FALSE
CompanyJ_4222,"AD's move was so good, Dwight had to do his own version ",56,1469,475565,477034,video,FALSE
CompanyJ_4223,James Johnson got out of Alex Caruso's way REAL quick ,54,2980,524965,527945,video,FALSE
CompanyJ_4224,JOKIC FOR THE WIN ,18,2100,384811,386911,video,FALSE
CompanyJ_4225,That Caruso and LeBron chemistry ,33,2752,599945,602697,video,FALSE
CompanyJ_4226,BOJAN. BOGDANOVIC. GAME.,24,1938,363027,364965,video,FALSE
CompanyJ_4227,LeBron had the lane wide open ,30,1938,287356,289294,video,FALSE
CompanyJ_4228,D'Angelo Russell scored a career-high 52 PTS tonight  Warriors got themselves a true bucket getter ,99,2835,523392,526227,carousel,FALSE
CompanyJ_4229,Dame left it all on the floor tonight.,38,2700,406300,409000,image,FALSE
CompanyJ_4230,That time of the year  @brgridiron,34,2973,308318,311291,carousel,FALSE
CompanyJ_4231,Tigers. Crimson Tide. SEC West foes take center stage ,54,847,137167,138014,image,FALSE
CompanyJ_4232,"Whether it's a behind-the-back pass or pulling up from deep, LaMelo been in his bag  (via @NBL)",95,1286,201383,202669,video,FALSE
CompanyJ_4233,Lakers are undefeated (7-0) when Alex Caruso plays,50,7424,675961,683385,carousel,FALSE
CompanyJ_4234,"Unlimited bounce from @jalen  (via @hometeamhoops, @br_hoops)",61,3666,351351,355017,video,FALSE
CompanyJ_4235," No. 17 MINNESOTA UPSETS No. 4 PENN STATE, 31-26 ",49,1009,256674,257683,carousel,FALSE
CompanyJ_4236,"RIP Penn State's No. 4 ranking: Nov. 5, 2019 - Nov. 9, 2019 ",60,1212,232596,233808,image,FALSE
CompanyJ_4237,"Upsets in college football. Nothing like it. (via @theothermegryan, @startribune)",81,1973,610197,612170,image,FALSE
CompanyJ_4238,Bron with the @obj cleats  @brkicks,35,383,115730,116113,video,FALSE
CompanyJ_4239,Gordon Hayward suffered a fractured left hand vs. Spurs,55,5800,422353,428153,image,FALSE
CompanyJ_4240,Tigers pick up their biggest win of the year in Tuscaloosa ,59,2290,450782,453072,image,FALSE
CompanyJ_4241,Thaddeus Moss had a wild catch that would make his dad Randy proud ,67,1130,206151,207281,video,FALSE
CompanyJ_4242,Joe Burrow might have locked up the Heisman in win over No. 3 Bama ,67,1076,307178,308254,carousel,FALSE
CompanyJ_4243,"Dion Waiters had a panic attack during Heat flight to Los Angeles after taking an edible, per @windhorstespn @wojespn",117,18934,617843,636777,image,FALSE
CompanyJ_4244,Just another day at the office for Luka   24 PTS 14 REB 8 AST W,63,1561,422436,423997,carousel,FALSE
CompanyJ_4245,LSU spun out of Alabamas grasp to take home the W ,50,246,98639,98885,video,FALSE
CompanyJ_4246,THROUGH THE ENTIRE BARBED WIRE BED  @brwrestling  Jon Moxley and Kenny Omega put on a show at #AEWFullGear,106,5549,360555,366104,video,TRUE
CompanyJ_4247,Larry is one of a kind  @brgridiron,35,971,316097,317068,carousel,FALSE
CompanyJ_4248,"They said you wasnt no running back. YOU SHOWED EM.  This post-win moment between LSU's Clyde Edwards-Helaire and his father  (via @codymworsham, @lsu Athletics)",161,2000,444381,446381,video,FALSE
CompanyJ_4249,"Cam Newton returning to the Panthers next year is highly unlikely, per @RapSheet.   The former MVP is likely to be traded  @brgridiron",134,9918,390153,400071,image,FALSE
CompanyJ_4250,@melos got eyes on No. 1 (@br_hoops) via @nbl,45,2369,385740,388109,carousel,FALSE
CompanyJ_4251,TOE  TAP  @brgridiron   (via @nfl),34,812,146527,147339,video,FALSE
CompanyJ_4252,Lamar Jackson running the option with RGIII is amazing to witness.  Two black QBs Two Heisman winners  Important for the next generation  @brgridiron  (via @nfl),161,5490,564187,569677,carousel,FALSE
CompanyJ_4253,Lamar Jackson is a superhero. (via @NFL),40,7345,415099,422444,video,FALSE
CompanyJ_4254,Mahomes is RIDICULOUS  MVP is back and he's out here making jump passes (via @thecheckdown),91,1143,152314,153457,video,FALSE
CompanyJ_4255,Lamar chilling on the bench after destroying the Bengals for four touchdowns  @brgridiron,89,2474,545647,548121,image,FALSE
CompanyJ_4256,Dion Waiters has been suspended for the edible incident.,56,3185,292258,295443,image,FALSE
CompanyJ_4257,Birds of a feather  @brgridiron,31,980,336240,337220,image,FALSE
CompanyJ_4258,Lamars run will live on  @brgridiron  @campbells #ad,52,178,63356,63534,video,TRUE
CompanyJ_4259,"MSU holds a moment of silence for Cassius Winston's brother, Zachary, who died last night   Cassius will play tonight.",118,2855,302457,305312,video,FALSE
CompanyJ_4260,Kyrie too crafty ,17,2657,224966,227623,video,FALSE
CompanyJ_4261,Giannis' last 5 games   36 PTS | 15 REBS | 8 ASTS 34 PTS | 15 REBS | 6 ASTS 38 PTS | 16 REBS | 9 ASTS 30 PTS | 13 REBS | 4 ASTS 35 PTS | 16 REBS | 3 ASTS  Another MVP season?,174,3415,390162,393577,carousel,FALSE
CompanyJ_4262,"Raptors upset Lakers on the road, 113-104 and end LAs 7-game winning streak   Siakam: 24 PTS, 11 REB, 4 AST Raps had six different players in double figures",156,3445,376989,380434,carousel,FALSE
CompanyJ_4263,Dancing Dak is everywhere  @brgridiron,38,2989,377886,380875,video,FALSE
CompanyJ_4264,Answering spicy questions and eating worm salad   From B/R x @SamsungMobileUSA,78,169,33496,33665,video,FALSE
CompanyJ_4265,JuJu vs. Ramsey  @brgridiron,28,1247,252140,253387,carousel,FALSE
CompanyJ_4266,Washington is treating IT well ,31,1135,355691,356826,image,FALSE
CompanyJ_4267,This Harbaugh/Lamar convo is so real  You changed the game...You know how many little kids in this country are gonna be wearing No. 8 playing QB for the next 20 years?  (via @Ravens),182,2261,354011,356272,video,FALSE
CompanyJ_4268,Through the legs. Baseball behind the back. No way (via @maxwellpearce),71,1439,293727,295166,video,FALSE
CompanyJ_4269,NFC West rivalry renewed for Richard Sherman  @brgridiron,57,790,175452,176242,video,FALSE
CompanyJ_4270,Suns are scorching to open 2019-20  6-3 record  No. 1 assists  No. 1 FG%  No. 4 3PT%  No. 5 scoring  Booker: 25.8 PPG | 54.5 FG%,128,4268,561981,566249,carousel,FALSE
CompanyJ_4271,Raptors forward shows off his different styles in the latest edition of 'What Are You Wearing?' @brkicks,104,324,50884,51208,video,FALSE
CompanyJ_4272,Luka kicked Smart where it hurts and still got the and-1 ,57,2584,420501,423085,video,FALSE
CompanyJ_4273,"Wyd, Dejounte? ",15,1819,216003,217822,video,FALSE
CompanyJ_4274,Luka hit 'em with the MJ shrug \_()_/,37,836,163159,163995,video,FALSE
CompanyJ_4275,Andrew Wiggins' last 4 games:  30 PTS | 6 ASTS | 2 STLS 40 PTS | 5 REBS | 7 ASTS 25 PTS | 4 REBS | 5 ASTS 33 PTS | 6 REBS | 5 ASTS  Breakout year?,146,5420,424874,430294,carousel,FALSE
CompanyJ_4276,"""I feel lucky that I was a part of something that may not ever happen again."" Tony Parkers jersey is officially retired ",120,1169,385793,386962,carousel,FALSE
CompanyJ_4277,SEAHAWKS MOOD AFTER THEY HAND THE 49ERS THEIR FIRST LOSS (via @thecheckdown),76,2573,343884,346457,video,FALSE
CompanyJ_4278,Draymond gets the first ejection in Chase Center history in his first game back from injury ,92,2922,372189,375111,video,FALSE
CompanyJ_4279,15 years ago today.,19,3687,422218,425905,image,FALSE
CompanyJ_4280,Stole the cone...and almost put it back  (via @foxsportssouth),62,660,131186,131846,video,FALSE
CompanyJ_4281,Paul George back on Thursday. Clippers finally about to be at full strength ,76,1339,342246,343585,carousel,FALSE
CompanyJ_4282,Russ has hardware on his mind  @brgridiron,42,5258,300615,305873,image,FALSE
CompanyJ_4283,"The Bosa brothers are terrorizing the league, but the Watt bros arent having it  #GridironHeights",97,288,63793,64081,video,TRUE
CompanyJ_4284,"The NFL arranged a private workout for Colin Kaepernick in Atlanta on Saturday that will include on-field work and an interview. All teams are invited to attend, per @adamschefter",179,12392,557473,569865,image,FALSE
CompanyJ_4285,"A club in Argentina used a CGI lion to celebrate their stadium reopening  (via @diarioas, @edelpoficial)",104,1810,215852,217662,video,FALSE
CompanyJ_4286,The Brodie turns 31 today. 2017 MVP 8x All-Star 2x All-Star Game MVP 2x scoring and assist leader Averaged a triple-double for 3 straight seasons,145,2656,523012,525668,carousel,FALSE
CompanyJ_4287,#WashedKing? Nope.  @howardabeck says @kingjames is still the most devastating all-around force in the NBA ,107,1554,115812,117366,video,TRUE
CompanyJ_4288,Darius Garland has filthy handles ,34,1122,146201,147323,video,FALSE
CompanyJ_4289," Evansville UPSETS No. 1 Kentucky, 67-64 ",41,4025,459148,463173,image,FALSE
CompanyJ_4290,AD went at Rubio for the poster ,32,702,155184,155886,video,FALSE
CompanyJ_4291,Coby White set a Bulls record for most 3PTs in a single quarter with 7 in the 4Q ,81,1207,204242,205449,video,FALSE
CompanyJ_4292,Trae had to stare down the Nuggets' bench after this nasty nutmeg and bucket ,77,1974,277810,279784,video,FALSE
CompanyJ_4293,Ice Trae dropped a season-high 42 PTS against the Nuggets ,58,1617,307221,308838,video,FALSE
CompanyJ_4294,Kuz came up BIG in the clutch for the Lakers ,45,728,157910,158638,video,FALSE
CompanyJ_4295,Coby White thanked Roy Williams for attending his career night game for the Bulls ,82,1385,448173,449558,video,FALSE
CompanyJ_4296,"CM Punk is back in the WWE world  @brwrestling  After speculation, Punk has joined WWE Backstage as an analyst. It's his first WWE appearance since abruptly leaving the company in 2014.",185,3982,319880,323862,image,FALSE
CompanyJ_4297,Man of the people  @kingjames,29,8794,1017789,1026583,carousel,FALSE
CompanyJ_4298,"""I aint gonna lie to you. Halfway through your question, I stopped listening.""   Bye week started early for Jamaal Williams @brgridiron  (via @packersnewsinsta)",160,2585,377167,379752,video,FALSE
CompanyJ_4299,"Kawhi has supporters for load management, but not everyone is a fan of it",73,1294,104293,105587,video,FALSE
CompanyJ_4300,A wild night in Miami after an L resulted in @chrisjohnsontwo8 and some Titans teammates paying $140K in team fines for being late. New Untold Stories with @Master_Tesfatsion,174,212,73884,74096,video,FALSE
CompanyJ_4301,Dont sleep ,11,2322,525456,527778,image,FALSE
CompanyJ_4302,Cam to the Chi?  Panthers QB would welcome a trade to the Bears if Chicago is in the market for a QB this offseason | @brgridiron  (via @rapsheet),146,6438,410520,416958,carousel,FALSE
CompanyJ_4303,What could have been ,21,6180,505257,511437,video,FALSE
CompanyJ_4304,"Eddie Guerrero passed away 14 years ago today, at only 38 years old  @brwrestling",81,4887,393676,398563,image,FALSE
CompanyJ_4305,Joe Burrow playing like a lock for the No. 1 pick in 2020   @localtoyotadealers,79,362,51487,51849,video,FALSE
CompanyJ_4306,KD taking shots in the vintage Kukocs uni  (via @___devonte___),63,3600,472223,475823,carousel,FALSE
CompanyJ_4307,Zlatan confirms he has left the LA Galaxy: I gave you Zlatan. You are welcome. @brfootball,90,1730,314544,316274,image,FALSE
CompanyJ_4308,"""Who keeps putting the towels on the top shelf? DAMN!"" - 5'6"" Tarik Cohen is fed up with the @ChicagoBears locker room  @brgridiron",131,1713,232994,234707,video,FALSE
CompanyJ_4309,KAT is fed up this season ,26,8192,490741,498933,video,FALSE
CompanyJ_4310,JA. FOR THE WIN. TOUGH.,23,3603,424037,427640,video,FALSE
CompanyJ_4311,First career NBA game-winner.  Only took the rook 11 games.,59,1695,558711,560406,carousel,FALSE
CompanyJ_4312,Austin Rivers wanted the refs to give his dad a tech ,53,7188,634211,641399,video,FALSE
CompanyJ_4313,Harden put up 47 PTS for the Rockets' fifth straight win ,57,1884,303360,305244,carousel,FALSE
CompanyJ_4314,Beard. Dagger. That's cold   From B/R x @coorslight,51,342,52668,53010,video,FALSE
CompanyJ_4315,Russ not buying Pat Bev's antics ,33,7712,560819,568531,image,FALSE
CompanyJ_4316,Raptors got a duo in Siakam and VanVleet  Pascal: 36 PTS | 6 REBS Fred: 30 PTS | 7 ASTS  Toronto's not slowing down ,116,3228,584764,587992,carousel,FALSE
CompanyJ_4317,"JaVale dunked on the Warriors during Klay's interview  ""He's athletic. Good for JaVale."" ",89,1379,388846,390225,video,FALSE
CompanyJ_4318,Lakers (9-2) are off to their best start since 2010.,52,3572,548222,551794,carousel,FALSE
CompanyJ_4319,Ja Morant went Super Saiyan in the closing seconds ,51,1403,201658,203061,video,FALSE
CompanyJ_4320,The King sees no difference ,28,8443,497340,505783,image,FALSE
CompanyJ_4321,"1 Milli  New logo, new feel, next generation of hoops. @br_hoops",64,124,56242,56366,video,FALSE
CompanyJ_4322,Lamar Jackson will keep the burners on with the Texans in the house ,68,164,40504,40668,video,FALSE
CompanyJ_4323,Flash catching for an MVP candidate now  @brgridiron,52,2584,306025,308609,image,FALSE
CompanyJ_4324,KP makes his return to The Garden tonight   The Mavs won the Porzingis trade and it's not even close,100,580,96300,96880,video,FALSE
CompanyJ_4325,"No easy buckets for Kaavia in the Union-Wade household  (via @dwyanewade, @gabunion)",84,1089,172269,173358,video,FALSE
CompanyJ_4326,"KD coming back, one day at a time  (via  @___devonte___)",56,1957,262813,264770,carousel,FALSE
CompanyJ_4327,NFL confirms the following teams 11 will attend Kaps workout  @brgridiron  Patriots Dolphins Broncos Lions Cardinals Falcons Browns Giants Jets Bucs Redskins  More expected to come.,181,16228,508114,524342,image,FALSE
CompanyJ_4328,Kalin Bennett couldn't walk until age 3 and couldn't talk until age 7.  Now he's the first player diagnosed with autism to play D-I hoops ,138,466,105518,105984,video,FALSE
CompanyJ_4329,Cody Bellinger and Mike Trout named NL and AL MVPs ,51,1120,159907,161027,carousel,FALSE
CompanyJ_4330,Knicks fans boo KP during intros in his first game back to MSG  (via @master_tesfatsion),88,1156,102324,103480,video,FALSE
CompanyJ_4331,"Carmelo Anthony is back in the NBA. Melo is signing with the Blazers, per @wojespn",82,31499,1267581,1299080,image,FALSE
CompanyJ_4332,RJs spin move on Luka ,22,2624,284324,286948,video,FALSE
CompanyJ_4333,Trae has mastered the nutmeg move and his defenders are helpless,64,903,154030,154933,video,FALSE
CompanyJ_4334,Luka was HYPED after this KP putback ,37,472,161042,161514,video,FALSE
CompanyJ_4335,Melo showing up to Rip City,27,1650,161581,163231,video,FALSE
CompanyJ_4336,Morris step-back  FOR GAME. Thats cold   From B/R x @coorslight,63,880,154420,155300,video,FALSE
CompanyJ_4337,Melos Banana Boat brothers are happy hes back ,46,1750,442882,444632,image,FALSE
CompanyJ_4338,"Myles Garrett ripped Mason Rudolphs helmet off and hit him with it in the closing seconds of Thursday Night Football. Steelers center Maurkice Pouncey attacked Garrett, throwing punches and kicks on the ground. CHAOS  @brgridiron",229,9537,500958,510495,carousel,FALSE
CompanyJ_4339, @brgridiron,12,7742,366278,374020,image,FALSE
CompanyJ_4340,@jhart threw the controller so hard  #Battlestations @brgaming,62,480,109805,110285,video,TRUE
CompanyJ_4341,"Gigi with the fadeaway. Like father, like daughter  (via @kobebryant)",69,2947,320150,323097,video,FALSE
CompanyJ_4342,Space Jam premiered 23 years ago today. MJ year ,48,1132,375536,376668,image,FALSE
CompanyJ_4343,The fallout from the TNF brawl. @brgridiron,43,8179,431217,439396,image,FALSE
CompanyJ_4344,It worked ,10,1871,500909,502780,image,FALSE
CompanyJ_4345,Mike Tomlin made a yawning gesture when asked about facing Odell twice a year in the offseason. OBJ didnt forget  @brgridiron,125,2303,365064,367367,carousel,FALSE
CompanyJ_4346,Still going  @kingjames,23,4872,588491,593363,image,FALSE
CompanyJ_4347,The Suns are HOT this season ,29,620,72217,72837,video,FALSE
CompanyJ_4348,"Jay-Z reportedly pressured Roger Goodell to set up a Colin Kaepernick workout because he took a reputational bullet for the commissioner when their partnership was announced, per @danpatrickshow | h/t @brgridiron",212,5132,461584,466716,image,FALSE
CompanyJ_4349,"Carmelo Anthony not expected to make Trail Blazers debut before Tuesday's game against Pelicans, per @wojespn",109,784,323587,324371,image,FALSE
CompanyJ_4350,MALIK MONK STUNS THE PISTONS   Blakes reaction says it all,58,3845,489136,492981,video,FALSE
CompanyJ_4351,Ja was flying around tonight ,29,777,113934,114711,video,FALSE
CompanyJ_4352,"44 PTS, 10 AST, and the W behind Bradley Beal for the Wizards. Magical ",71,985,301509,302494,carousel,FALSE
CompanyJ_4353,"Hit the three, let 'em know about it  @kingjames",48,2493,438181,440674,video,FALSE
CompanyJ_4354,"No-look, between the legs, three points. Bron and Kuz got that chemistry ",73,1226,462111,463337,carousel,FALSE
CompanyJ_4355,LEBRON JAMES. POSTER. YEAR 17.  @kingjames,42,11580,699547,711127,video,FALSE
CompanyJ_4356,JR's live reaction to LeBron's poster ,38,2578,762067,764645,image,FALSE
CompanyJ_4357,Game on the line... AD's defense wins it for the Lakers ,56,2178,161183,163361,video,FALSE
CompanyJ_4358,Kemba with the dagger  Ice cold   From B/R x @coorslight,56,656,158241,158897,video,FALSE
CompanyJ_4359,Celtics got synced up after the rebound ,40,2363,442345,444708,video,FALSE
CompanyJ_4360,"There are at least two teams seriously interested in signing Colin Kaepernick, one NFC West executive told B/Rs Mike Freeman  Two other execs say the interest in the QB is real and he could be on a team by the end of the month if he throws well  @brgridiron",257,6299,471024,477323,image,FALSE
CompanyJ_4361,@jharden13 has been on FIRE in his last 6 games   44 PTS | 8 REB | 5 AST 47 PTS | 6 REB | 7 AST 39 PTS | 4 REB | 9 AST 42 PTS | 10 REB | 9 AST 36 PTS | 4 REB | 13 AST 44 PTS | 10 REB | 6 AST  All W's,199,3830,503563,507393,carousel,FALSE
CompanyJ_4362,"Too small, too young, too expensive? @leomessis journey to his Barcelona first-team debut  @brfootball",102,908,191681,192589,carousel,FALSE
CompanyJ_4363,#NAME?,29,4471,418144,422615,video,FALSE
CompanyJ_4364,"From unknown rookie to standout star, Brandon Boykin's Georgia comeback was one for the books    This story has been supplemented by @aflacduck #ad",147,122,52564,52686,video,TRUE
CompanyJ_4365,"Down 55 in garbage time, Monmouth's George Papas steals the ball, dunks and gets a tech ",88,6407,314203,320610,video,FALSE
CompanyJ_4366,Tua Tagovailoa got carted off after suffering an apparent hip injury vs. Mississippi State.,91,1883,281277,283160,carousel,FALSE
CompanyJ_4367,Celtics have won 10 straight games and sit first in the NBA standings.  Don't sleep on this team ,97,5151,465373,470524,carousel,FALSE
CompanyJ_4368,Defender caught the most disrespectful hurdle of the year ,58,2374,377973,380347,carousel,FALSE
CompanyJ_4369,"The goalkeeper took a penalty, missed and knocked a light down  @brfootball (via @nickdillam)",93,859,157019,157878,video,FALSE
CompanyJ_4370,Prayers up for Tua ,19,8307,545981,554288,image,FALSE
CompanyJ_4371,Kap said and showed he's still ready to be in the NFL  @brgridiron (via @jrsportbrief),86,7018,507918,514936,carousel,FALSE
CompanyJ_4372," No. 20 Iowa UPSETS undefeated No. 8 Minnesota, 23-19 ",54,1332,233535,234867,carousel,FALSE
CompanyJ_4373,"Normal posters aren't enough for Giannis, had to drop it on two Pacers ",71,632,133907,134539,video,FALSE
CompanyJ_4374,James Harden is a scoring machine. 30 points in the first half like it's nothing.,81,2540,370217,372757,carousel,FALSE
CompanyJ_4375,"Luka got two defenders to go flying on the pump fake, then kicked it out for 3 ",79,989,314585,315574,video,FALSE
CompanyJ_4376,"Pop got ejected, so Becky Hammon and Tim Duncan took over to coach the Spurs ",77,2090,397054,399144,video,FALSE
CompanyJ_4377,"Jalen Hurts and Oklahoma do the impossible, come back from 28-3 deficit to stun Baylor, 34-31  Hurts: 30-43 passing, 411 total yards, 4 TDs, INT ",145,2617,396983,399600,image,FALSE
CompanyJ_4378,James Harden. My goodness.,26,7909,491645,499554,video,FALSE
CompanyJ_4379,"Paul George put on a show in his Staples Center debut, scoring 37 PTS in a 49-point Clippers win.  No rust for PG-13 ",117,3224,589201,592425,carousel,FALSE
CompanyJ_4380,Nate Diaz is a man of the people  Fan said hes sleeping in a car because he lost rent money betting on Nate. Diaz replied Dont trip I got ur b---ass and helped him out | @br_betting   (via @unknownkillers213),208,2030,335117,337147,carousel,FALSE
CompanyJ_4381,Lamar and Deshaun have been battling for top honors since college. Week 11 should be fun ,89,357,58076,58433,video,FALSE
CompanyJ_4382,"Wasnt just analysts who slept on Lamar  There was privately ""a lot"" of talk from opposing teams and coaches that he ""couldnt throw from the pocket"" and ran too much before the season started. Ravens shut out the noise and built around him, per @brgridirons Mike Freeman.",270,1877,418787,420664,image,FALSE
CompanyJ_4383,70 points combined in two games as a Clipper. Healthy PG is a scary sight ,74,3135,478568,481703,image,FALSE
CompanyJ_4384,Diggs cleats level up every single week    @brkicks | @brgridiron   (via @mache275),83,1831,435995,437826,carousel,FALSE
CompanyJ_4385,Fans did their best to troll Ronaldo  @brfootball,49,910,185081,185991,carousel,FALSE
CompanyJ_4386,LAMAR COOKING EVERYBODY. (via @nfl),35,4174,377637,381811,video,FALSE
CompanyJ_4387,Zeke paid homage to Dak after the TD  @brgridiron (via @thecheckdown),69,979,199643,200622,video,FALSE
CompanyJ_4388,Your weekly ridiculous numbers from Lamar Jackson:  17/24  222 yards  4 TD  86 rushing yards  Beat Texans 41-7 @brgridiron,122,3597,509979,513576,image,FALSE
CompanyJ_4389,"Lamar Jackson has now defeated Tom Brady, Russell Wilson and Deshaun Watson in the past month alone. Forget the future. Hes got now  @brgridiron",144,3999,510979,514978,carousel,FALSE
CompanyJ_4390,Lamar and the Ravens looking good after another W  @brgridiron,62,573,196858,197431,video,FALSE
CompanyJ_4391,Mark Ingram drops the intro of the year for Lamar Jackson  (via @Ravens),72,5792,506054,511846,video,FALSE
CompanyJ_4392,"The touchdown didnt count, but Quenton Nelsons celebration will live forever (via @Colts | @nfl)",96,501,129996,130497,video,FALSE
CompanyJ_4393,The end of the Celtics-Kings game was brutal for Boston... Buddy kicked it right into the stands ,97,1480,209803,211283,video,FALSE
CompanyJ_4394,Kirk Cousins was ice cold with 3 TDs in the Vikings' historic comeback win   From B/R x @coorslight,99,389,74951,75340,video,FALSE
CompanyJ_4395,DROPPED.  HIM.,14,717,144406,145123,video,FALSE
CompanyJ_4396,MARKELLE. CLUTCH ,17,3772,385726,389498,video,FALSE
CompanyJ_4397,Bron daps up Kobe then immediately hits a 3 ,44,1587,417724,419311,video,FALSE
CompanyJ_4398,Evan Turner really crossed Bron ,32,19279,747256,766535,video,FALSE
CompanyJ_4399,SHOWTIME AT STAPLES ,20,594,224339,224933,video,FALSE
CompanyJ_4400,Staples Center gives Kobe a standing O as he walks out ,55,2289,516918,519207,video,FALSE
CompanyJ_4401, x   All smiles.,16,2754,770667,773421,carousel,FALSE
CompanyJ_4402,From one legend to another  @kingjames @kobebryant,50,1168,294852,296020,image,FALSE
CompanyJ_4403,RG3 helps the Ravens defense prepare by imitating opposing QBs on the scout team. He says his Tom Brady impression was his best all year because he stopped my natural instincts and ran in slow motion   @brgridiron   (via @mike_garafolo),236,2209,376414,378623,image,FALSE
CompanyJ_4404,"Aging like fine wine    Cristiano Ronaldo, age 34: More goals for Portugal than any other year (14)  LeBron James, age 34: Leads NBA in assists, 2nd in triple-doubles  Lionel Messi, age 32: Averaging a goal or assist every 45 minutes in La Liga",244,3150,527872,531022,image,FALSE
CompanyJ_4405,Bill Belichick was waiting for this one  @brgridiron (SWIPE),60,2066,323019,325085,carousel,FALSE
CompanyJ_4406,"Instead of scoring the TD himself, he hands it off to his teammate so he can score in his last college game.  What a play  (via @utpbfalcons)",141,1175,211668,212843,video,FALSE
CompanyJ_4407,"Over Baltimores six-game winning streak, Lamar has a 67.6 completion percentage and 14 touchdowns. Hes officially the MVP front-runner  @brgridiron",147,2550,341490,344040,carousel,FALSE
CompanyJ_4408,"Arizona high school RB Adonis Watt is blind, and he's out here scoring TDs ",75,673,79065,79738,video,FALSE
CompanyJ_4409,Danny Green shocked the world last night ,41,3051,781110,784161,carousel,FALSE
CompanyJ_4410,Flat out dropped him ,21,1577,157983,159560,video,FALSE
CompanyJ_4411, New career-high for Luka   42 PTS 11 REBS 12 ASTS  6th triple-double of the year.,82,3142,531720,534862,carousel,FALSE
CompanyJ_4412,Good company.,13,846,274881,275727,image,FALSE
CompanyJ_4413,PG coming up CLUTCH against his former team,43,869,172659,173528,video,FALSE
CompanyJ_4414,STICKY HANDS  This touchdown celebration is awesome @brgridiron   (via @nyjets),79,2079,360982,363061,video,FALSE
CompanyJ_4415,#NAME?,30,5320,549074,554394,image,FALSE
CompanyJ_4416,Both of these players are 14 years old  @brfootball (via @john_groeneweg),73,5700,398110,403810,image,FALSE
CompanyJ_4417,Crossover is FILTHY  @ticket52 (via @auburnmbb),47,1680,192624,194304,video,FALSE
CompanyJ_4418,Blazers announce Melo will wear No. 00 with Portland ,53,3493,315444,318937,video,FALSE
CompanyJ_4419,Patriots CB Stephon Gilmore says he knew hed rattle Zach Ertz on Sunday because he saw the Eagles TE crying on film and complaining about not getting passes or calls  @brgridiron  - - - (via @dougkyed),201,2563,318845,321408,image,FALSE
CompanyJ_4420,The NBA needs JCrossover.,25,12449,419551,432000,image,FALSE
CompanyJ_4421,Tottenham is in 14th place in the Premier League  @brfootball,61,1601,170065,171666,image,FALSE
CompanyJ_4422,#NAME?,135,1301,197349,198650,video,FALSE
CompanyJ_4423,Lukas stats so far this season  @lukadoncic,43,1998,292726,294724,carousel,FALSE
CompanyJ_4424,"LaMelos playing with former NBA players in Australia, and they say hes league-ready: IQ is amazingHis ceiling is so high.  @br_hoops",132,744,106119,106863,video,FALSE
CompanyJ_4425," New #GridironHeights!  Belichick, Lamar and Sherman are contestants on the new game show Which Teams Are Good? ",112,505,61362,61867,video,TRUE
CompanyJ_4426,Melo will be starting in his Blazers debut tonight,50,2637,352529,355166,video,FALSE
CompanyJ_4427,Melo is officially back ,24,6731,765480,772211,video,FALSE
CompanyJ_4428,Melo through the years ,23,3966,622986,626952,carousel,FALSE
CompanyJ_4429,RONDO  LEBRON,13,837,128116,128953,video,FALSE
CompanyJ_4430,First player ever to have a triple-double against every team in the league: @kingjames ,87,6735,725785,732520,carousel,FALSE
CompanyJ_4431,Top of the NBA is back to the way it used to be...,50,4898,617779,622677,carousel,FALSE
CompanyJ_4432,Jose Mourinho is officially the new manager of Tottenham  @brfootball,69,948,149021,149969,image,FALSE
CompanyJ_4433,Melo's happy to be back ,24,3531,435791,439322,image,FALSE
CompanyJ_4434,Bron arguing with the ref about a foul   (via @briansher18),59,3002,443844,446846,video,FALSE
CompanyJ_4435,"Jerry Jones says Bill Belichick found him at a ski resort in the 90s after hed been fired from the Browns. Belichick told Jones, I can coachdont forget about me.  The Cowboys owner has thought about that many times ever since  @brgridiron - - - (via @1053thefandfw)",265,7728,399702,407430,image,FALSE
CompanyJ_4436,What if... ,11,3497,465026,468523,image,FALSE
CompanyJ_4437,"Kawhi and PG will take the court for the first time together tonight, per @notoriousohm and @wojespn.",101,3551,329228,332779,image,FALSE
CompanyJ_4438,Everyone's getting in on the basketball challenge ,50,1120,97714,98834,video,FALSE
CompanyJ_4439,NCAA has suspended James Wiseman,32,7410,343387,350797,image,FALSE
CompanyJ_4440,The West couldve looked real different ,39,1754,257431,259185,image,FALSE
CompanyJ_4441,Thats a real leader  @brgridiron,32,474,197844,198318,image,FALSE
CompanyJ_4442,Ben Simmons officially hits the first 3 of his career ,54,7557,510824,518381,video,FALSE
CompanyJ_4443,Morris threw down Embiid and Joel wasnt having it ,50,5983,369325,375308,video,FALSE
CompanyJ_4444,Simmons to his 3PT doubters:,28,1281,163949,165230,video,FALSE
CompanyJ_4445,Luka making more history ,25,1754,297261,299015,carousel,FALSE
CompanyJ_4446,Kawhi ENDED a man. Lou Will came up clutch. Clippers took OT at Staples over the Celtics ,89,1382,171831,173213,video,FALSE
CompanyJ_4447,TATUM DROPPED PG.,17,4994,257169,262163,video,FALSE
CompanyJ_4448,Bronny making his official debut for Sierra Canyon  @br_hoops,61,576,112950,113526,video,FALSE
CompanyJ_4449,#NAME?,101,384,63787,64171,video,FALSE
CompanyJ_4450,Naz Carter NBA-bound?   Jay-Zs nephew is lighting it up at Washington playing alongside 5-star recruits,103,412,75879,76291,video,FALSE
CompanyJ_4451,Chicago. NYC. LA. Which city is the Mecca of basketball? SWIPE ,63,1547,97771,99318,carousel,FALSE
CompanyJ_4452,"The Kid turns 50 today  Debuted 30 years ago, at 19 years old  One of three players with 500 HRs and 10 Gold Gloves  First No. 1 pick inducted into Hall of Fame",160,1583,237269,238852,carousel,FALSE
CompanyJ_4453,Real-life heroes. All-Star athletes. Watch these stories come to life on the new season of B/Real ,98,136,43962,44098,carousel,FALSE
CompanyJ_4454,CHEAT CODE  CMC becomes just the sixth running back ever to earn a 99 rating on Madden | @brgridiron  - Barry Sanders - Marshall Faulk - LaDainian Tomlinson - Chris Johnson - Adrian Peterson  (via @panthers),207,2797,420061,422858,carousel,FALSE
CompanyJ_4455,One of the best MVP races in years  @brgridiron,47,9229,335641,344870,image,FALSE
CompanyJ_4456,Michael Thomas has more catches and yards this year than all Eagles receivers combined  @brgridiron,99,7100,443785,450885,carousel,FALSE
CompanyJ_4457,This week might be the long-awaited OBJ breakout ,49,236,35607,35843,video,FALSE
CompanyJ_4458,Melo celebrations are timeless ,31,2171,356980,359151,video,FALSE
CompanyJ_4459,"Every time DeAndre Hopkins scores, he finds his momwho is blindand gives her the touchdown ball. One of the best traditions in sports  @brgridiron",146,6937,908550,915487,image,FALSE
CompanyJ_4460,Money Mayweather comeback? ,27,9666,484471,494137,image,FALSE
CompanyJ_4461,Pelicans went to Brandon Ingram in crunch time and he delivered ,64,3914,585027,588941,carousel,FALSE
CompanyJ_4462,"Tatum making PG13 touch Earth. Kawhi catching a body. Everything is better in-person.  (via @edforthewin_, @leandrogeoffrey, @yojameson)",136,1264,423149,424413,carousel,FALSE
CompanyJ_4463,Ja Morant leads all rookies in scoring and assists   Is he also leading the race for Rookie of the Year?,104,821,79161,79982,video,FALSE
CompanyJ_4464,"""Get back in the weight room""  Redskins RB @dhasickestt went in on Carson Wentz",79,294,30366,30660,video,FALSE
CompanyJ_4465,#NAME?,79,1674,398634,400308,image,FALSE
CompanyJ_4466,#NAME?,77,332,205438,205770,video,FALSE
CompanyJ_4467,The Kyrie 6 just dropped at Uncle Drews Bodega. Its been a long time in the making  @brkicks,92,268,66379,66647,video,FALSE
CompanyJ_4468,OBJ LBJ with the one-handed snag and assist to KCP at the buzzer ,65,5519,654117,659636,video,FALSE
CompanyJ_4469,AD AND BRON ACTIVATE SHOWTIME ,30,737,267157,267894,video,FALSE
CompanyJ_4470,Kemba Walker had to be stretchered off the court after colliding with teammate Semi Ojeleye ,92,7635,588527,596162,carousel,FALSE
CompanyJ_4471,Peyton Manning was at the Nuggets game and had their mascot go deep  @brgridiron,80,2182,616767,618949,carousel,FALSE
CompanyJ_4472,Kawhi with the game on the line... one of the best in the clutch,64,1739,229579,231318,video,FALSE
CompanyJ_4473,Pat Bev and Russ were still going at it after they both fouled out ,67,7609,640550,648159,video,FALSE
CompanyJ_4474,Odell made The Catch five years ago today as a rookie  @porsche,63,461,64295,64756,video,FALSE
CompanyJ_4475,Harden vs. Pat Bev always a show ,33,3000,280747,283747,carousel,FALSE
CompanyJ_4476,"28 years ago today, Jordan was getting in the rookies head   Free Throw % Mutombo 1991-92: .642 MJ Eyed Closed: 1.000 (via @nbaontnt)",133,2717,412264,414981,video,FALSE
CompanyJ_4477,What are you doing? ,20,2324,376588,378912,video,FALSE
CompanyJ_4478,Vince Carters dunk on Dikembe in 99 is still iconic ,52,1161,240372,241533,carousel,FALSE
CompanyJ_4479,"Just a week after season-ending hip surgery, Tua returned to Alabama to support his teammates. Respect. ",104,826,320259,321085,image,FALSE
CompanyJ_4480,"@jamorant already sees the floor like a vet, the ROY race is ""over before Thanksgiving"" ",88,3311,402782,406093,video,FALSE
CompanyJ_4481,Ohio State marching band cut up a Michigan logo at halftime  (via @thewilderthings),83,3283,408757,412040,video,FALSE
CompanyJ_4482,"Following the footsteps of todays superstars  NFL draft comps for the next generation (via @brgridiron, @nfldraftscout)",119,1198,261384,262582,carousel,FALSE
CompanyJ_4483,Harvard-Yale game delayed by student protest over climate injustice. (via lim_woojin/Twitter),93,6404,333783,340187,video,FALSE
CompanyJ_4484,Taulia threw his first TD pass and Tua returned to support his Bama teammates just one week after suffering a season-ending hip injury. Proud day for the Tagovailoa household ,175,593,258156,258749,carousel,FALSE
CompanyJ_4485,Chase Young broke the Ohio State single-season sack record in his return vs. Penn State   Ready to hunt down NFL QBs. @brgridiron,129,2686,397104,399790,carousel,FALSE
CompanyJ_4486,Spurs are 5-11 but Pop doesnt believe it ,41,1074,280915,281989,image,FALSE
CompanyJ_4487,MALIK MONK CLEARED FOR TAKEOFF ,31,1426,341960,343386,video,FALSE
CompanyJ_4488,Grizzlies throwback game is ,28,1754,469596,471350,carousel,FALSE
CompanyJ_4489,Zach LaVine stole the ball and the game from the Hornets   LaVine had 49 to help Bulls come back from down 5 with 14 sec left,125,13184,1062005,1075189,video,FALSE
CompanyJ_4490,AD and Bron came through when the Lakers needed them most in the clutch. Lifted the team to get the win ,104,1156,317340,318496,video,FALSE
CompanyJ_4491,The Hoosiers didn't stand a chance on Nico Collins' breakaway TD ,65,524,112048,112572,video,FALSE
CompanyJ_4492,42-0 with 41 knockouts  @bronzebomber is a bad man.,51,2379,463543,465922,image,FALSE
CompanyJ_4493,"Zach LaVine got benched by Bulls coach Jim Boylen for making egregious defensive errors on Friday. LaVine felt disrespected.""  His response on Saturday:  49 PTS  17-28 FG  13-17 3PT  Game-winner",194,3378,602580,605958,carousel,FALSE
CompanyJ_4494,"Deshaun Watson knew his first NFL paycheck would hit his bank account at 2 a.m., but he had to be up at 6 a.m. for practice.  Watson says he set an alarm for 2:01 just to see the money go through because he knew it changed his life  @brgridiron  - - - (via @theboardroom)",271,1669,452609,454278,image,FALSE
CompanyJ_4495,#NAME?,59,245,66933,67178,video,FALSE
CompanyJ_4496,Only Odell  Pulled up to Dolphins/Browns in a Rolls-Royce with his legendary catch on the front | @brgridiron  - - - (via @nflonfox),132,1970,256581,258551,video,FALSE
CompanyJ_4497,"Cam Newton is serving Thanksgiving meals to 1,300 underprivileged kids Monday, for the eighth straight year. Everyone gets free food and another meal to make at home  @brgridiron  (via Joe Marusak of the @charlotteobserver)",223,1314,338309,339623,image,FALSE
CompanyJ_4498,@obj scores his first touchdown since Week 2. Back to his old self   (via @clevelandbrowns | @nfl),98,2100,243465,245565,video,FALSE
CompanyJ_4499,Browns fans were using a helmet to hit a Mason Rudolph piata  @brgridiron --- (via @cal.rainey | @oxp.media),108,2861,149421,152282,video,FALSE
CompanyJ_4500,This fan snuck a whole PUMPKIN PIE and whipped cream into the Bears game  @brgridiron  (via @ernestwilkins),107,1338,145428,146766,video,FALSE
CompanyJ_4501,TOP. THREE. EVER @brgridiron,28,945,157269,158214,image,FALSE
CompanyJ_4502,Richard Jefferson said he knew it was time to retire when the Knicks offered him a contract ,92,5783,589098,594881,video,FALSE
CompanyJ_4503,Patriots were haunting Dak all night  @brgridiron,49,1007,108929,109936,video,FALSE
CompanyJ_4504,"Frank Gore thanked all his coaches, linemen and anyone whos blocked for him after passing Barry Sanders on the all-time rushing list  @brgridiron (via @cbssports)",162,3100,536747,539847,video,FALSE
CompanyJ_4505,The game comes too easy for The Joker ,38,1364,299431,300795,video,FALSE
CompanyJ_4506,A member of the Packers equipment staff's mom has cancer. Za'Darius Smith promised to shout her out if he got a sack tonight on national TV @brgridiron  Well done. ,164,871,340900,341771,image,FALSE
CompanyJ_4507,Packers got smacked 37-8 in SF @brgridiron,42,6736,452151,458887,video,FALSE
CompanyJ_4508,Lukas got jokes ,16,1579,465387,466966,image,FALSE
CompanyJ_4509, @brgridiron,12,8331,479684,488015,image,FALSE
CompanyJ_4510,Youll remember my name. I got two sacks on your ass.  Shaq Lawson confronted Denvers Connor McGovern postgame after the Bills won. The OL supposedly told Shaq he hadnt heard of him since college | @brgridiron --- (via @thadbrown7 | @news8_wroc),244,4359,446603,450962,video,FALSE
CompanyJ_4511,STACKED ,8,1161,154625,155786,image,FALSE
CompanyJ_4512,This is Alex Carusos world. Were just living in it.,51,3199,489962,493161,video,FALSE
CompanyJ_4513,Curtis Martin gives back to where it all began for him: his high school.  Getting to the Hall of Fame started right here.   From @ford X B/R #PFHOF,147,94,29523,29617,video,TRUE
CompanyJ_4514,This is wild  @brfootball @wearejayla (via @vanja_rolandsgarden),64,4082,320427,324509,video,FALSE
CompanyJ_4515,"Lamar has coaches scared  Two NFC assistants gave a ""definitive no"" when asked if its possible to stop LJ right now. The main reason is his improved throwing accuracy, per @brgridirons Mike Freeman",197,1826,354139,355965,image,FALSE
CompanyJ_4516,Messi playing with his son Ciro is too sweet  @brfootball (via @antonelaroccuzzo),81,751,194094,194845,video,FALSE
CompanyJ_4517,Jamal Adams and Derek Carrs brother got into a Twitter fight on Sunday. NYJs star safety: Stop living through your brothas. You need to focus on your lil high school job.   Swipe for the full battle  @brgridiron,211,3584,323280,326864,carousel,FALSE
CompanyJ_4518,2009  2019  Decade full of stars.,33,1782,500816,502598,carousel,FALSE
CompanyJ_4519,She was bullied growing up. Homeless at 21. Had never boxed before. Then Naomi Graham became a Team USA champ  (@statefarm),123,113,21961,22074,video,FALSE
CompanyJ_4520,Lamar getting MVP chants in LA  @brgridiron (via @ravens),57,1035,301188,302223,video,FALSE
CompanyJ_4521,Trae has him lost ,18,947,210984,211931,video,FALSE
CompanyJ_4522,Melo finding his groove?  He just dropped 12PTS on 5-8 shooting in the quarter ,79,4275,592866,597141,video,FALSE
CompanyJ_4523,Still got that burst in year 17 ,32,1522,270871,272393,video,FALSE
CompanyJ_4524,Lamars checklist:  Pick up bobbled snap  Avoid the sack  Make the defense miss  Set up the Ravens for their third TD of the half (via @nfl),139,1253,252587,253840,video,FALSE
CompanyJ_4525,"THROW IT DOWN, MELO ",20,4287,522519,526806,video,FALSE
CompanyJ_4526,Giannis dropped a season-high 50-piece tonight   50 PTS 14 REBS 6 ASTS 2 STLS,77,1658,311921,313579,carousel,FALSE
CompanyJ_4527,The @ravens are a whole vibe  @brgridiron,41,1209,218396,219605,video,FALSE
CompanyJ_4528,They said Lamar couldnt throw. Now hes leading the league in passing touchdowns  @brgridiron,92,3289,424756,428045,carousel,FALSE
CompanyJ_4529,Drake showed off the diamond championshipringall night and then trolled Embiid for going scoreless vs. the Raptors(via @tsn_official),133,3723,553008,556731,carousel,FALSE
CompanyJ_4530,Better stats than his MVP year so far. The Greek Freak keeps leveling up ,73,1496,218883,220379,carousel,FALSE
CompanyJ_4531,"Cam giving back  Eighth year in a row the former MVP is serving Thanksgiving dinner to over 1,000 underprivileged kids | @brgridiron --- (via @charlotteclture)",159,1233,193482,194715,video,FALSE
CompanyJ_4532,KAT and Wiggins are the NBA's breakout duo this season ,55,696,78412,79108,video,FALSE
CompanyJ_4533,Greatness doesnt come easy  @brgridiron,39,2215,356695,358910,carousel,FALSE
CompanyJ_4534,DYBALA REALLY SCORED FROM THAT ANGLE  @brfootball,49,487,67827,68314,video,FALSE
CompanyJ_4535,Rihanna out supporting Juventus in the Champions League ,56,1322,196335,197657,carousel,FALSE
CompanyJ_4536,"On Thanksgiving 21 years ago today, Randy Moss put up one of the most iconic stat lines of all time  @brgridiron",112,3612,438543,442155,image,FALSE
CompanyJ_4537,New two-minute #GridironHeights special.  The great MVP race gets the go-kart treatment ,88,552,96821,97373,carousel,TRUE
CompanyJ_4538,EMONI BATES CAUGHT A BODY  @br_hoops,36,833,111344,112177,video,FALSE
CompanyJ_4539,Lakers hit up a Mexican restaurant after beating the Spurs.  You know what these fans got Bron to yell  (via @rhiannf_),119,5205,628029,633234,video,FALSE
CompanyJ_4540,Ravens have the best celebrations in the game  @brgridiron (via @samsteffanina),79,654,192234,192888,video,FALSE
CompanyJ_4541,PAUL  GEORGE   PG13 went off for 17 points in the first quarter ,64,736,330051,330787,carousel,FALSE
CompanyJ_4542,"Bradley Beal is back in Denver, so he had to make the famous face  (via @washwizards)",85,1129,475456,476585,carousel,FALSE
CompanyJ_4543,Describe these Mavs uniforms in one word ,41,29852,658835,688687,carousel,FALSE
CompanyJ_4544,"STEPHEN F. AUSTIN STUNS NO. 1 DUKE   Duke's 19-year, 150 game winning streak of beating non-conference teams at home ends. (via JoshGrahamRadio/TW)",147,2285,411193,413478,carousel,FALSE
CompanyJ_4545,Lamar dethrones '04 Mike Vick to make Madden history  @brgridiron,65,4404,418225,422629,image,FALSE
CompanyJ_4546,"12 years ago today, we lost a legend before his prime. The great Sean Taylor died from a gunshot wound protecting his family from armed robbers. He was only 24.",160,4983,506166,511149,image,FALSE
CompanyJ_4547,"Ballboy's quick play helped Tottenham score, so Mourinho gave him props for the assist",86,1818,238433,240251,video,FALSE
CompanyJ_4548,Brow returns to NOLA as a Laker tonight  How we got here in 60 seconds,70,322,104475,104797,video,FALSE
CompanyJ_4549,Hines Ward was one of the games complete receivers. Does the former Super Bowl MVP belong in the @profootballhof?  From B/R X @ford   #PFHOF20,142,304,25752,26056,video,TRUE
CompanyJ_4550,"Football is family After being hospitalized vs. San Francisco, Tyler Lockett needed a certain type of therapy device for his shin.  Hospital didnt have one, so his agent hit up the Niners. The rival squad brought Lockett what he needed within hours. | @brgridiron  --- (via @rapsheet)",284,1538,407314,408852,image,FALSE
CompanyJ_4551,Whyd he fly like that  (via u/loveshack007) @brgaming,53,1357,168541,169898,video,FALSE
CompanyJ_4552,"I went through the stands and threw up a deuce-one, man. Because  thats how I got to pay tribute every week. Showin' him that we out here doin' it still for him. - Santana Moss remembering his late friend, Sean Taylor ",218,85,31828,31913,video,FALSE
CompanyJ_4553,Brandon Ingram opens up on his struggles with the Lakers and questioning whether hed make a full recovery after blood clot.,123,1520,320147,321667,image,FALSE
CompanyJ_4554,Kawhi had Sam Cassell ROLLING on the bench ,43,3243,472630,475873,video,FALSE
CompanyJ_4555,#NAME?,62,137,38466,38603,video,FALSE
CompanyJ_4556,Hold the tributes. Melos not done ,34,2329,344621,346950,image,FALSE
CompanyJ_4557,What Spicy P is doing should be impossible. MIP  MVP?,53,1128,146467,147595,video,FALSE
CompanyJ_4558,OH MY GOD ,10,1444,185504,186948,video,FALSE
CompanyJ_4559,Dame really designed a shoe after a heckler he humbled in Orlando  @brkicks,75,150,44153,44303,video,FALSE
CompanyJ_4560,Only right that Zeke eats on Thanksgiving ,42,163,32914,33077,video,FALSE
CompanyJ_4561,Gilly hasnt allowed a catch since Week 9  @brgridiron,53,2841,274292,277133,carousel,FALSE
CompanyJ_4562,Messis stats after 700 games for Barcelona. UNREAL  @brfootball,63,469,92816,93285,image,FALSE
CompanyJ_4563,League feels right with @carmeloanthony back,44,1650,396780,398430,carousel,FALSE
CompanyJ_4564,Dame Jr. looks ready to suit up  (via @trailblazers),52,1163,314792,315955,video,FALSE
CompanyJ_4565,Giannis didnt have to do Vince like that ,41,9834,502172,512006,video,FALSE
CompanyJ_4566,"On Friday, Kemba sustained a neck strain after a scary collision with a teammate. Tonight he dropped a season-high 39 PTS in a win over the Nets ",145,2080,465724,467804,carousel,FALSE
CompanyJ_4567,"""I got it Hassan get outta here""  Melo wanted that rebound ",59,2116,369905,372021,video,FALSE
CompanyJ_4568,The commentary was elite. The move was better.  (via @jdougie08),64,1153,485182,486335,video,FALSE
CompanyJ_4569,33k club. The King's in good company ,37,2908,374730,377638,image,FALSE
CompanyJ_4570,Melo gets a standing ovation as he exits the game with 19 PTS on 9/11 shooting ,79,3356,482353,485709,video,FALSE
CompanyJ_4571,"AD got showered with boos from Pels fans in his return to NOLA, but he dropped 41 PTS and got the W ",100,1644,456547,458191,carousel,FALSE
CompanyJ_4572,AD felt right at home against his former team tonight ,54,1745,242631,244376,image,FALSE
CompanyJ_4573,"SPOT THE DIFFERENCE, THANKSGIVING EDITION: Can you find whats different between the first and second video? ",108,2283,123119,125402,carousel,FALSE
CompanyJ_4574,Thanksgiving. Football. ALL. Day. Who are you taking in the games?  @brgridiron,79,229,67191,67420,carousel,FALSE
CompanyJ_4575,"Corner Marlon Humphrey says Lamar is the reason for the Ravens chemistry this year  Before Monday Night Football, the QB spent time in the training room after practice to shake hands with every rehabbing player and trainer.  As hes gotten more and more success, hes gotten more and more humble | @brgridiron",307,1954,411278,413232,image,FALSE
CompanyJ_4576,Sneakerhead Thanksgiving for @brkicks ,38,645,187898,188543,image,FALSE
CompanyJ_4577,"Bobby Wagner gives back for the love, not the glory  Seahawks star LB was at the supermarket buying Thanksgiving meals for people in lower income areas this week.  Then he picked up the tab for everyone in the store and quietly left before any cameras showed up. Thats real. | @brgridiron",288,925,286801,287726,image,FALSE
CompanyJ_4578,Return of the Mac.,18,2979,296747,299726,image,FALSE
CompanyJ_4579,Who you got? @brwrestling,25,9681,294961,304642,carousel,FALSE
CompanyJ_4580,Taysom Hill dominating on all cylinders @brgridiron  Blocked punt  2 receptions  Touchdown (via @thecheckdown),110,482,144806,145288,video,FALSE
CompanyJ_4581,Things are getting tense in Dallas  @brgridiron,47,4534,325250,329784,image,FALSE
CompanyJ_4582,MATT RYAN GOT STIFF-ARMED INTO OBLIVION  @brgridiron (via @thecheckdown),72,1187,214067,215254,video,FALSE
CompanyJ_4583,Part II: @rj14 vs. @melo  These top-five prospects are already showtime overseas,80,318,113078,113396,video,FALSE
CompanyJ_4584,Isaac Bruce will be remembered as one of the Rams' all-time greats. Will he also be in the @profootballhof?   From B/R X @ford  #pfhof20,136,163,27887,28050,video,TRUE
CompanyJ_4585,#NAME?,44,701,270595,271296,image,FALSE
CompanyJ_4586,Kyrie showed loved to the Celtics players after the game ,57,1216,247936,249152,video,FALSE
CompanyJ_4587,"Had a whole dribble sequence for the free throw  (via @daniii_s4, @_mthangg_)",77,2441,445244,447685,video,FALSE
CompanyJ_4588,"#1 Ohio State and #13 Michigan look to add another chapter tomorrow in 'The Game.' Harbaugh is 0-4 against the Buckeyes, does that change?",138,411,88238,88649,carousel,TRUE
CompanyJ_4589,@shai is quietly one of the best scorers under 25 ,50,1581,289020,290601,video,FALSE
CompanyJ_4590,Giannis dunked on Kevin Love AND Tristan Thompson in less than 5 minutes ,73,1354,275115,276469,video,FALSE
CompanyJ_4591,Jazz-Grizzlies uniform matchup is straight out of the 90's ,59,2515,580271,582786,image,FALSE
CompanyJ_4592,Trae Young tied his career-high with 49 points in the Hawks OT loss to the Pacers  The rest of Atlantas starting lineup had 19 points combined,142,2866,439291,442157,carousel,FALSE
CompanyJ_4593,Rondo oops it to LeBron for the poster ,39,1063,234830,235893,video,FALSE
CompanyJ_4594,It's finally happening ,23,3185,302524,305709,image,FALSE
CompanyJ_4595,Bron enters the everlasting debate... ,38,7740,426692,434432,video,FALSE
CompanyJ_4596,Rui Hachimura and Shohei Ohtani got together before the Lakers-Wizards game in LA ,82,928,350882,351810,carousel,FALSE
CompanyJ_4597,"Lakers were up by 35, so LeBron started shooting with his left hand ",68,5187,577659,582846,video,FALSE
CompanyJ_4598,Melo with the touch pass and then the pull-up 3 in transition  Hes having fun out here ,87,2005,257283,259288,video,FALSE
CompanyJ_4599,This weekend means a little more ,33,1028,208229,209257,image,FALSE
CompanyJ_4600,The @buffalobills had no chill   @brgridiron,44,4597,390804,395401,video,FALSE
CompanyJ_4601,"Melos last three games:  23 PTS, 11 REB 19 PTS, 4 REB 25 PTS, 8 REB  All wins",77,4348,497346,501694,carousel,FALSE
CompanyJ_4602,This kid in the Dominican Republic is hitting bottle tops off a slingshot  (via @coco_jose_12),94,3943,329483,333426,video,FALSE
CompanyJ_4603,Three to the dome  @virgilvandijk hit the @carmeloanthony after securing all 3 points for Liverpool,99,728,221854,222582,image,FALSE
CompanyJ_4604,Justin Fields came out of the medical tent with a knee brace on and immediately threw a TD on his first play back. Definition of tough ,135,382,114156,114538,video,FALSE
CompanyJ_4605," J.K. ALL DAY   Dobbins had a field day against Michigan in The Game, rushing for a career-high 211 yards and 4 TDs.",116,397,132662,133059,image,FALSE
CompanyJ_4606,"Michigan defense couldnt slow down J.K. Dobbins, so they untied and took off his shoe ",86,775,158997,159772,video,FALSE
CompanyJ_4607,Former NFL WR Terrelle Pryor was the victim of a stabbing Friday morning. Hes expected to make a full recovery @brgridiron,122,1135,133846,134981,image,FALSE
CompanyJ_4608," No. 15 Auburn STUNS No. 5 Alabama, 48-45 in another WILD Iron Bowl ",68,1873,385701,387574,carousel,FALSE
CompanyJ_4609,Harden realizing he got benched two points away from his career-high ,69,2864,407498,410362,video,FALSE
CompanyJ_4610,James Harden torched the Hawks in only 3 quarters tonight  60 PTS  8 AST  3 STL  16-24 FG  20-23 FT,99,2171,326802,328973,carousel,FALSE
CompanyJ_4611,Theres a chance history might repeat itself again  @brgridiron,62,2653,271696,274349,image,FALSE
CompanyJ_4612,"Michigan State corner Josh Butler's parents both died while he was in college. During his final home game, Butler came onto the field with his two dogs for Senior Day   (DavidHarns/Twitter)",189,1255,188592,189847,video,FALSE
CompanyJ_4613,"In December 2005, Kobe dropped 62 in three quarters (18-31 FG) and outscored the entire Mavs team by himself. A month later he went for 81.  James Harden dropped 60 in three quarters last night (16-24 FG). Beard 80-piece  ?",223,2952,338278,341230,image,FALSE
CompanyJ_4614,Lamars updated speed rating (96) on Madden is NOT FAIR  @brgridiron  @brgaming --- (via @the.azel),98,3994,561314,565308,carousel,FALSE
CompanyJ_4615,This fan was so happy Giannis took the time for him. Bigger than basketball  @brkicks   (via @bucks),100,1544,433429,434973,carousel,FALSE
CompanyJ_4616,I SEE WHY YOU DONT PAY DAK  @brgridiron --- (via Ted Goldberg of @spectrumnewsbuffalo),86,3105,330364,333469,video,FALSE
CompanyJ_4617,Memphis does the KD pregame dance as part of their handshake  (via @__unotres),78,2579,506016,508595,carousel,FALSE
CompanyJ_4618,Niners scored first and Deebo imitated Lamars MNF celebration.  Ravens answered and imitated Nick Bosas flag celebration.   @brgridiron   (via @NFL),148,827,242479,243306,carousel,FALSE
CompanyJ_4619,LAMAR TAKING ANKLES EVERY WEEK (via @nfl),41,471,61810,62281,video,FALSE
CompanyJ_4620,Dolphins with the fake of the century  @brgridiron (via @nfl),61,723,112662,113385,video,FALSE
CompanyJ_4621,DeAndre Hopkins says his favorite player in the league right now is Julian Edelman. Hop spent time this summer studying how Jules always picks up extra yardage  @brgridiron - - -  (via @JamesPalmerTV | @sarahbarshop),216,625,278082,278707,image,FALSE
CompanyJ_4622,Lamar and the Ravens can't be stopped  Baltimore beats the Niners 20-17 in a heavyweight fight @brgridiron,106,1744,279032,280776,image,FALSE
CompanyJ_4623,AD pocket pass. Caruso jam. Dwight reaction.  Everyone having fun on the Lakers ,80,2009,355291,357300,video,FALSE
CompanyJ_4624,Dirk is at the Lakers-Mavs game in LA today and the Lakers gave him a tribute  Respect.,87,612,137567,138179,video,FALSE
CompanyJ_4625,Luka with the step-back over LeBron ,36,2124,185528,187652,video,FALSE
CompanyJ_4626,"Lamar on the Ravens mentality this season  ""Nobody cares about what you doin', you gotta work harder. If you wanna be the best, you gotta work harder. (via @ravens | @brgridiron)",178,1343,216842,218185,video,FALSE
CompanyJ_4627,Deshauns 4 TDs lead the Texans to a 28-22 win over New England  @brgridiron,75,627,227846,228473,image,FALSE
CompanyJ_4628,Deshaun Watson and Lamar Jackson are the only QBs to beat the Patriots this season  @brgridiron,95,3286,376471,379757,image,FALSE
CompanyJ_4629,"Lamar Jackson, 22: TD leader, could break Vick's rushing record  Luka Doncic, 20: 32/10/10 AST in Nov  Trae Young, 21: 28.4 PTS, 4.2 REB, 8.4 AST this season  Kylian Mbappe, 20: Averaging a goal or assist every game  Erling Haaland, 19: 27 goals in 20 games, all comps",268,1481,367541,369022,image,FALSE
CompanyJ_4630,"40-INT, 20-sack club and 215 straight starts  Does Ronde Barber belong in the@profootballhof?  From B/R X@ford  #PFHOF20",120,435,32731,33166,video,TRUE
CompanyJ_4631,Lamar leads the league in TDs. Hes topped the best defenses in the NFL while chasing his idols records. Baltimores No. 1 in the AFC.  Has LJ ended the MVP race?  @brgridiron,173,2496,375274,377770,carousel,FALSE
CompanyJ_4632,"This fan tweeted James Conner that his friend has an untreatable form of cancer, and they were fulfilling a bucket list item by going to Steelers/Browns.  Connerwho doctors once gave about a week to livemade sure to find them and share a moment  @brgridiron --- (via @steelers | @sergentrusty)",293,1181,273986,275167,carousel,FALSE
CompanyJ_4633,Wiggins has been silencing the doubters this year ,50,837,175430,176267,image,FALSE
CompanyJ_4634,Official: @uswnt star Megan Rapinoe wins her first Ballon d'Or  @brfootball,75,1267,113707,114974,image,FALSE
CompanyJ_4635,#NAME?,55,1904,229897,231801,image,FALSE
CompanyJ_4636,Melo wins a Conference Player of the Week award for the first time since 2014   Back when Mel00 was Me7o,104,2466,439978,442444,image,FALSE
CompanyJ_4637,2009 vs. 2019  ,15,776,183044,183820,carousel,FALSE
CompanyJ_4638,"This ain't a damn farewell tour.  Western Conference Player of the Week, Carmelo Anthony.",89,783,94614,95397,video,FALSE
CompanyJ_4639,Giannis just bullied Randle then put him on a poster ,53,1872,165124,166996,video,FALSE
CompanyJ_4640,WHAT JUST HAPPENED?  @brgridiron (via @nfl),43,1067,109957,111024,video,FALSE
CompanyJ_4641,Seahawks receivers at it again with the celebrations... New Edition after the TD  @brgridiron (via @nfl),104,1245,163893,165138,video,FALSE
CompanyJ_4642,Giannis was having too much fun during the kiss cam ,52,1055,313818,314873,video,FALSE
CompanyJ_4643,"Kelly Oubre was clutch for the Suns, but his poster was the play of the night for Phoenix ",90,1232,352227,353459,carousel,FALSE
CompanyJ_4644,51-year-old @garysheffield casually hitting bombs while smoking a cigar ,72,1351,147652,149003,video,FALSE
CompanyJ_4645,Is Zach Thomas built for the @profootballhof?   7x Pro Bowl  5x First Team All-Pro  2x tackles leader  From B/R X @ford   #PFHOF20,130,248,23886,24134,video,TRUE
CompanyJ_4646,Everybody eats in Seattle  Starting running back Chris Carson subbed himself out near the goal line so Rashaad Penny could score Monday night.  Penny: Everybody thinks were supposed to hate each other. This is literally love in the backfield.  (via @brgridiron),261,3033,348639,351672,image,FALSE
CompanyJ_4647,They experienced racism on the field and poverty off it. But this soccer team of immigrants shocked all of Texas by winning a state championship. This is their story.,166,257,42208,42465,video,FALSE
CompanyJ_4648,Kelly Oubre Jr.'s handshake game is next level ,47,2072,247334,249406,video,FALSE
CompanyJ_4649,Panthers looked like the future during their run to the Super Bowl four years ago. Is Cam out next? @brgridiron,111,1488,185997,187485,carousel,FALSE
CompanyJ_4650,Clevelands gotta find a way to get  13 the rock | @brgridiron,61,6363,272861,279224,carousel,FALSE
CompanyJ_4651, New #GridironHeights x The Mandalorian. Kliff Kingsbury and Baby Kyler lead the way for the Cardinals ,103,223,44311,44534,video,TRUE
CompanyJ_4652,BOOM SHAKA LAKA! Giannis. Embiid. AD. Steph. Luka. And more. The NBA Jam limited edition pack from BR x @homage is out NOW. Hit the link in bio to get yours ,157,284,37847,38131,carousel,FALSE
CompanyJ_4653,New career-high for Markelle tonight   20 PTS 6 ASTS  Fultz is flourishing in Orlando.,86,4097,421560,425657,carousel,FALSE
CompanyJ_4654,"A Spurs fan told Harden ""no one wants to see a free throw shooting contest""  Beard: ""Nobody wants to see fouls either goddammit!"" ",130,5414,343136,348550,video,FALSE
CompanyJ_4655,CARUSO OUTTA NOWHERE ,21,3098,252539,255637,video,FALSE
CompanyJ_4656,Luka did it all tonight.  He grabbed a career-high 18 REBS to go along with 33 PTS and 5 ASTS.,94,1448,278697,280145,carousel,FALSE
CompanyJ_4657,The refs really didn't count this Harden dunk ,46,2482,216083,218565,video,FALSE
CompanyJ_4658,Tre Jones broke his ankles then stepped on him ,47,2409,239730,242139,video,FALSE
CompanyJ_4659,Bazemore denied The Klaw ,25,805,102349,103154,video,FALSE
CompanyJ_4660,#NAME?,28,290,67376,67666,video,FALSE
CompanyJ_4661,Shaq tried the TikTok challenge and Charles smoked him in the head with an egg  (via @NBAonTNT),95,4254,302262,306516,video,FALSE
CompanyJ_4662,"After losing his first fumble of the year, Lamar started apologizing to everybody on the @Ravens sideline.   We riding with you regardless.""  @brgridiron",153,2791,283166,285957,video,FALSE
CompanyJ_4663,Torry Holt going from the Greatest Show on Turf to the @profootballhof?  2x yardage leader  7x Pro Bowl  From B/R X @ford   #PFHOF20,132,168,22219,22387,video,TRUE
CompanyJ_4664,In sync ,8,2406,497987,500393,image,FALSE
CompanyJ_4665,D-Hop and Gilly still going at it after Texans/Patriots @brgridiron,67,3455,292852,296307,image,FALSE
CompanyJ_4666,"Help on the way in New England?  Deion Sanders says the Pats are getting Brady a receviver soon: ""I guarantee it, somethings going to happen within the next few weeks"" | @brgridiron  --- (via @nflnetwork)",204,8972,338296,347268,image,FALSE
CompanyJ_4667,"That move was FILTHY, @paigebueckers  @br_hoops",47,970,115286,116256,video,FALSE
CompanyJ_4668,Luka or Harden?   The debate over who's better goes deeper than the stepback,76,4008,209855,213863,video,FALSE
CompanyJ_4669,"49ers have suspended radio color analyst Tim Ryan over controversial comments made about Lamar Jackson on Monday. Ryan said Jackson was successful at faking handoffs because of his dark skin with a dark football, per @sfchronicle (h/t @brgridiron)",247,17029,561478,578507,image,FALSE
CompanyJ_4670,#NAME?,29,4534,217579,222113,video,FALSE
CompanyJ_4671,Watching @lindor12bc coach his nephew through his first HR is so wholesome ,75,687,194740,195427,video,FALSE
CompanyJ_4672,Devonte Graham was a second-round draft pick in 2018. Tonight he hit TEN threes and dropped 33 PTS ,99,2822,359256,362078,carousel,FALSE
CompanyJ_4673,Bron went for a walk ,21,15684,700775,716459,video,FALSE
CompanyJ_4674,Melo out-hustling everybody ,28,6686,648342,655028,video,FALSE
CompanyJ_4675,Dwights reaction ,17,1992,389535,391527,video,FALSE
CompanyJ_4676,DWIGHT OUT HERE HITTING 3s ,27,3164,457551,460715,video,FALSE
CompanyJ_4677,"Jazz announcers were fed up with Bron for his late-game shoeless celebration, but he was actually giving them away to some fans  @brkicks",137,4142,417917,422059,carousel,FALSE
CompanyJ_4678,Bron was walking all over the galaxy ,37,5283,465785,471068,video,FALSE
CompanyJ_4679,The stories of Patrick Mahomes playing different sports growing up are unbelievable   (SWIPE for footage),105,790,252414,253204,carousel,FALSE
CompanyJ_4680,Ron Rivera says he was criticized by some for having his wife and daughter around the Panthers so much. But he told the players he was trying to set an example of how to treat your family  @brgridiron,200,3411,477592,481003,carousel,FALSE
CompanyJ_4681,Beards game is not for the untrained eye ,41,3392,342155,345547,image,FALSE
CompanyJ_4682,"Carmelo Anthony's contract with the Blazers will become fully guaranteed for the remainder of the season, @wojespn",114,4739,594626,599365,image,FALSE
CompanyJ_4683,How the race for the NFC East is playing out  @brgridiron,57,3097,264770,267867,video,FALSE
CompanyJ_4684,OUBRE ON INGRAM ,16,5554,520351,525905,video,FALSE
CompanyJ_4685,OH MY JAXSON HAYES ,19,4047,537844,541891,video,FALSE
CompanyJ_4686,Cowboys are now 6-7 and somehow still in first place in the NFC East  @brgridiron,81,2234,298082,300316,image,FALSE
CompanyJ_4687,9 years ago today ,18,2723,499200,501923,image,FALSE
CompanyJ_4688,"The Knicks might be 4-18, but theres still a few things fans can be hopeful for",79,1353,96292,97645,carousel,FALSE
CompanyJ_4689,Giannis turns 25 today  3x All-Star NBA Most Improved Player (2017) All-NBA First Team (2019) NBA All-Defensive First Team (2019) 2019 MVP 5th player born outside the U.S. to win MVP  Greek Freak is just getting started,219,1083,274382,275465,carousel,FALSE
CompanyJ_4690,Eagles center Jason Kelce was still going to sign this Chiefs jersey after it was destroyed ,92,78,42246,42324,video,FALSE
CompanyJ_4691, @br_hoops,10,7504,274534,282038,image,FALSE
CompanyJ_4692,The Knicks are 4-18 this season.,32,4652,300415,305067,image,FALSE
CompanyJ_4693,Fizdale leaving NYC knowing hes getting paid to not coach the Knicks ,69,1381,287069,288450,video,FALSE
CompanyJ_4694,Which team would you want K-Love to go to? ,43,14246,381733,395979,image,FALSE
CompanyJ_4695,OH. MY. GIANNIS.  Might not be another player that can make this a poster.,74,1213,274632,275845,video,FALSE
CompanyJ_4696,Year 1  Year 17  Legendary @kingjames @carmeloanthony,53,754,417473,418227,carousel,FALSE
CompanyJ_4697,Prayers up for Rodney Hood ,27,3558,353787,357345,image,FALSE
CompanyJ_4698,Tatum lit the Nuggets up #MtnDew3pt,35,613,191151,191764,video,FALSE
CompanyJ_4699,Bron's made the courtside vendors night ,40,1201,221440,222641,video,FALSE
CompanyJ_4700,20-3 record for the Lakers.  Bron and AD combined for 70 points ,64,2110,390482,392592,carousel,FALSE
CompanyJ_4701,"Top Heisman contenders take center stage on Championship Saturday, who gets your vote?",86,581,103403,103984,carousel,FALSE
CompanyJ_4702,Welcome to Conference Championship weekend ,43,567,127271,127838,video,FALSE
CompanyJ_4703,"Happy 63rd birthday to Larry Legend   3x NBA champ  3x NBA MVP  12x All-Star  3x 3-Point Shootout champ  Only person to win MVP, Coach of the Year and Executive of the Year",172,1403,314311,315714,carousel,FALSE
CompanyJ_4704,"Jimmy Butler to the Heat bench after draining a three: Im a bad motherfker, Im sorry ",85,2794,527000,529794,video,FALSE
CompanyJ_4705,"Anthony Joshua beats Andy Ruiz by unanimous decision in their rematch.  Joshua takes back the WBO, IBF, IBO, and WBA heavyweight titles.",136,4789,500081,504870,image,FALSE
CompanyJ_4706,It's official: the Lane Train heads to Ole Miss ,48,1215,164573,165788,image,FALSE
CompanyJ_4707,They started carting out Georgias SEC championship gear at the start of the 4Q  (via scottcarptv/Twitter),105,2152,201637,203789,video,FALSE
CompanyJ_4708,LSU wins its first SEC Championship since 2011   Joe Burrow joins other legendary Tigers on top of the conference. @lsufootball,127,938,335569,336507,video,FALSE
CompanyJ_4709,No idea how Joe Burrow was able to pull off this pass ,54,1076,250086,251162,video,FALSE
CompanyJ_4710,Ben Simmons from three... GOOD ,31,4536,499601,504137,video,FALSE
CompanyJ_4711,"Terrell Owens put his career on the line in Super Bowl 39, playing with a broken leg and torn ankle ligament. Still put up numbers with 9 catches for 122 yards. @brgridiron Im on half a leg and they cant stop me. Happy 46th to one of the GOATs ",244,3231,468549,471780,image,FALSE
CompanyJ_4712,"Ohio State takes home the Big Ten Championship after coming back to beat Wisconsin, 34-21.  JK Dobbins:  33 carries  172 yards  1 touchdown",139,2843,297655,300498,image,FALSE
CompanyJ_4713,Alistair Overeem got knocked out in the final seconds of his UFC fight and got something to show for it ,104,11917,543356,555273,carousel,FALSE
CompanyJ_4714,Need answers @brgridiron,24,2298,313962,316260,image,FALSE
CompanyJ_4715,2020 College Football Playoff field is set   LSU  Ohio State  Clemson Oklahoma,78,1369,179280,180649,image,FALSE
CompanyJ_4716,21 years old. R.I.P. ,21,1380,566432,567812,carousel,FALSE
CompanyJ_4717,Uh oh  @brgridiron,18,7815,388294,396109,image,FALSE
CompanyJ_4718,Every single week. VIDEO GAME  (via @thecheckdown),50,2571,328721,331292,video,FALSE
CompanyJ_4719,"8 years ago today, the Lakers' trade for CP3 was vetoed.  One of the craziest things in sports to happen this decade.",117,5222,528428,533650,image,FALSE
CompanyJ_4720,"Ravens play sheet blew onto the field, so Bills CB Tre White picked it up started reading. Ref snatched it  @brgridiron",119,2201,415371,417572,image,FALSE
CompanyJ_4721,NFC KINGS  Jimmy G throws four TDs and leads the game-winning drive to beat the Saints in an unreal 48-46 shootout | @brgridiron,128,796,85948,86744,video,FALSE
CompanyJ_4722,"OKAY VC   Vince Carter was drafted on June 24, 1998 PJ Washington was born on August 23, 1998",93,2613,532164,534777,video,FALSE
CompanyJ_4723,Mahomes leads the Chiefs over the Patriots in Foxboro  @brgridiron,66,1421,83924,85345,video,FALSE
CompanyJ_4724,Luka continues to make history ,31,1599,246825,248424,image,FALSE
CompanyJ_4725,Tyler Herro caught fire from deep. CLUTCH  #MtnDew3pt,53,415,89910,90325,video,TRUE
CompanyJ_4726,LEBRON PLAYING BULLY BALL ,26,3252,526790,530042,video,FALSE
CompanyJ_4727,LaMelo Ball is expected to be out of action until January,57,1423,219637,221060,image,FALSE
CompanyJ_4728,Niners retake control of the NFC West from the Seahawks @brgridiron,67,1729,270808,272537,video,FALSE
CompanyJ_4729,Anthony Davis had another vintage performance tonight   50 PTS  7 REB  6 AST  4 STL  20-29 FG  W,96,1274,368534,369808,carousel,FALSE
CompanyJ_4730,LeBron and AD became the first Lakers teammates to combine for 70+ points in consecutive games since Kobe and Shaq in 2003,122,1890,473500,475390,image,FALSE
CompanyJ_4731,The new era is special  @brgridiron,35,3767,287250,291017,image,FALSE
CompanyJ_4732,Legend. (via @nbahistory),25,1418,319459,320877,carousel,FALSE
CompanyJ_4733,Kawhi hooped against Bobby Wagner in high school. Small world  @brgridiron   (via @nbcsports),93,1464,363700,365164,image,FALSE
CompanyJ_4734,CHAMPIONS LEAGUE BACK  Follow @brfootball for the best of the UCL,65,441,51457,51898,video,FALSE
CompanyJ_4735,"Pete Frates, the former college baseball player with Lou Gehrigs disease who helped make the ALS ice bucket challenge go viral, has died at 34. R.I.P. ",151,2540,385260,387800,image,FALSE
CompanyJ_4736,The NBA Jam limited edition pack from BR x @homage  Last chance to order for an X-Mas delivery is Thursday. Hit link in bio NOW ,128,223,19012,19235,video,FALSE
CompanyJ_4737,PG went off against the Pacers ,31,1274,324742,326016,carousel,FALSE
CompanyJ_4738,Eli passes Big Ben  @brgridiron,31,2348,272745,275093,image,FALSE
CompanyJ_4739,17 points in the 4th and the game-winner.  D-Rose went off ,59,5823,544285,550108,video,FALSE
CompanyJ_4740,"Russ was yelling ""game over!"" after hitting a shot with 1 second left...then Bjelica called game ",97,14675,816924,831599,video,FALSE
CompanyJ_4741,CP3 did Gobert dirty ,21,1691,237046,238737,video,FALSE
CompanyJ_4742,"Patrick Mahomes girlfriend Brittany Matthews says security moved her and Pats brother to a ""safe place"" at Gillette Stadium because Patriots fans were harassing them  @brgridiron",178,5285,392076,397361,carousel,FALSE
CompanyJ_4743,Cowboys fans seeing Philly win in OT  @brgridiron,49,3823,267683,271506,video,FALSE
CompanyJ_4744,Clutch is in @droses DNA,24,1204,312427,313631,image,FALSE
CompanyJ_4745,WNBA legend @sbird10 surprised the Salam Stars girls basketball team in Milwaukee that's getting buckets and turning heads ,123,410,38644,39054,video,FALSE
CompanyJ_4746,Philip Rivers talking trash will never get old  @brgridiron  - - - (via @Jaguars),81,5788,475962,481750,video,FALSE
CompanyJ_4747,One of a kind  @brgridiron,26,4741,351482,356223,carousel,FALSE
CompanyJ_4748,Mo Salah from an impossible angle ,34,601,80239,80840,video,FALSE
CompanyJ_4749,17-year-old Ansu Fati keeps making history  @brfootball,55,228,57670,57898,carousel,FALSE
CompanyJ_4750,Knicks could unlock a promising future if they start their young guys now ,74,3184,362176,365360,video,FALSE
CompanyJ_4751,New #GridironHeights   Gronk is having trouble getting everybody in position for playoff picture day ,101,291,50676,50967,video,TRUE
CompanyJ_4752,#NAME?,110,533,296765,297298,carousel,FALSE
CompanyJ_4753,Thats real @brgridiron,22,1135,225851,226986,image,FALSE
CompanyJ_4754,Miles Bridges with the dagger  #MtnDew3pt,41,324,126484,126808,video,TRUE
CompanyJ_4755,How did Gary Harris finish this? ,33,8714,358519,367233,video,FALSE
CompanyJ_4756,"Trae Young yelled ""It's over!"" to the Heat crowd after the Hawks went up 6 with 1 minute left ...The Heat ended up winning by 14 in OT.",135,4589,394212,398801,video,FALSE
CompanyJ_4757,Duncan Robinson went off. TEN THREES ON 71% shooting ,53,1768,282855,284623,carousel,FALSE
CompanyJ_4758,"Breaking: Gerrit Cole is heading to the Yankees  9-years, $36M per year. $324M total, per @jonheymanmlb",103,6998,404020,411018,image,FALSE
CompanyJ_4759,"After their win, Barcelonas Frenkie de Jong finds out his former team Ajax has been knocked out of the Champions League. Heartbreaking ",135,1052,264194,265246,video,FALSE
CompanyJ_4760,It only took one year for the Fun Guy to become King in the North. Kawhi returns to Toronto tonight ,100,633,135684,136317,video,FALSE
CompanyJ_4761,Alex Antetokounmpo throwing down with Giannis in the crowd  @br_hoops,69,2372,380416,382788,video,FALSE
CompanyJ_4762,"Five years ago today, Kobe called the Lakers soft like Charmin after practice  (via @arashmarkazi)",98,5523,467526,473049,video,FALSE
CompanyJ_4763,Prime Time breaking down his old pregame routine is legendary  @brgridiron  (SWIPE),83,963,227631,228594,carousel,FALSE
CompanyJ_4764,AD doing the Bron three  (via @hoopjab),39,4009,577700,581709,video,FALSE
CompanyJ_4765,Running away with it  @br_betting,33,980,199287,200267,image,FALSE
CompanyJ_4766,Mbappes drag-back assist for Neymars goal ,42,283,51955,52238,video,FALSE
CompanyJ_4767,The Champions League Round of 16 is set ,40,215,34864,35079,video,FALSE
CompanyJ_4768,Kawhi comes back to Toronto to face off against Siakam's Raptors squad   From B/R X @americanexpress,100,209,84639,84848,video,FALSE
CompanyJ_4769,Hardens elite ability to draw fouls is because of hisbeard? ,60,791,95335,96126,video,FALSE
CompanyJ_4770,Ronaldo was pissed at this pitch invader @brfootball,52,3881,326387,330268,video,FALSE
CompanyJ_4771,"The Magic ran a Lakers ""bandwagon cam"" before the game. Man really went all out with the Bron fit ",98,5580,612002,617582,video,FALSE
CompanyJ_4772,Terrence Ross shoved Dwight so Dudley stepped in for the smoke and got ejected,78,6461,514380,520841,video,FALSE
CompanyJ_4773,55 points and 10 threes for The Beard tonight.,46,1895,334210,336105,carousel,FALSE
CompanyJ_4774,Help is on the way for Mike Trout ,34,1640,192290,193930,image,FALSE
CompanyJ_4775,JA MORANT ENDED ARON BAYNES ,28,10442,647666,658108,video,FALSE
CompanyJ_4776,Bogdan. Triple. Cold.   From B/R x @coorslight,46,166,46520,46686,video,FALSE
CompanyJ_4777,A work of art ,14,1271,345757,347028,image,FALSE
CompanyJ_4778,"Joe Burrow is the AP Player of the Year, first LSU player to win the award",74,1594,440840,442434,image,FALSE
CompanyJ_4779,"Devonte Graham has been this seasons surprise gem  Drafted 2nd round, 34th overall in 2018  Started three games in his rookie year  Averaging 20.0 points, 7.6 assists per game",175,2490,404814,407304,carousel,FALSE
CompanyJ_4780,Imagine this duo  @brgridiron,29,3843,285246,289089,image,FALSE
CompanyJ_4781,This courtside angle of Jas dunk  (via @teamdelle),50,810,237438,238248,video,FALSE
CompanyJ_4782,Welcome to the LAMAR JACKSON EXPERIENCE @brgridiron  LJ has passed Vick for the single-season QB rushing record,111,3634,418143,421777,video,FALSE
CompanyJ_4783,This is what it means to inspire the next generation  @brgridiron    Lamar grew up idolizing Vick.  Vick mentored Lamar.  Lamar broke Vicks record.  Vick celebrated it.,168,840,244310,245150,image,FALSE
CompanyJ_4784,Luka and Blake both welcomed Mexico City to their game tonight in Spanish ...Luka's went better than Blake's ,109,8905,873468,882373,video,FALSE
CompanyJ_4785,New mixed-reality from the @Ravens. This is WILD  @brgridiron,61,5435,469181,474616,video,FALSE
CompanyJ_4786,More history for Luka. He was also getting MVP chants tonight in Mexico.,72,1437,384068,385505,carousel,FALSE
CompanyJ_4787,Embiid sealed the game with a vicious block ,44,996,103057,104053,video,FALSE
CompanyJ_4788,The thought of if these happened...  #FridayThe13th,51,5082,480869,485951,carousel,TRUE
CompanyJ_4789,Twelve days. Twelve dunks from stars playing on Christmas Day.  The #BRNBAXmas countdown starts now ,100,216,74781,74997,video,TRUE
CompanyJ_4790,Luka recreated the iconic Heat moment with KP,45,15544,735671,751215,carousel,FALSE
CompanyJ_4791,LeBrons best regular-season start could turn into a historic Lakers run with AD ,80,867,146663,147530,video,FALSE
CompanyJ_4792,It's been a year since @shareefoneal had heart surgery and started his journey back to basketball.  Shareef is currently playing as a redshirt freshman at UCLA  @br_hoops,170,1385,424754,426139,carousel,FALSE
CompanyJ_4793,Kevin Love is on the trade block. Which team needs him the most?  @howardabeck says the Celtics ,96,1631,117858,119489,video,FALSE
CompanyJ_4794,Nuggets Melo is a forever legend ,33,2821,390720,393541,image,FALSE
CompanyJ_4795,Hornets breakout star @dtaegraham is playing his way onto All-Star ballots ,75,615,106755,107370,video,FALSE
CompanyJ_4796,Video-game mode ,16,2778,289235,292013,image,FALSE
CompanyJ_4797,AD & LeBron were clutch in the 4th quarter to give the Heat their first home loss of the year ,94,2910,542013,544923,carousel,FALSE
CompanyJ_4798,Kyle Anderson put Giannis on a poster and Ja was lovin it ,58,1430,312008,313438,video,FALSE
CompanyJ_4799,LeBron and Chris Bosh embraced each other before the game in Miami ,67,422,175554,175976,video,FALSE
CompanyJ_4800,This would be wild  @brgridiron,31,3628,303388,307016,image,FALSE
CompanyJ_4801,88 combined points for Kawhi & PG.  Two bucket-getters ,55,2394,348447,350841,image,FALSE
CompanyJ_4802,SPOT THE DIFFERENCE: Joe Burrow Heisman Edition,47,794,111129,111923,carousel,FALSE
CompanyJ_4803,"Five years ago, Kobe Bryant passed Michael Jordan for third all-time leading scorer",83,2570,575714,578284,carousel,FALSE
CompanyJ_4804,Sit down by the fire and listen to the story of the Bred 11s on Day Eleven of #BRNBAXmas   @brkicks,99,353,138058,138411,carousel,TRUE
CompanyJ_4805,Chase Young said not so fast  @brgridiron,41,5523,325671,331194,image,FALSE
CompanyJ_4806,"8 years ago today: After his trade to the Lakers was vetoed, Chris Paul was traded to the Clippers.  Birth of the Lob City era in LA",132,1463,314844,316307,carousel,FALSE
CompanyJ_4807,From Ohio State benchwarmer to the toast of college football.  LSUs Joe Burrow wins the Heisman trophy ,103,849,214518,215367,video,FALSE
CompanyJ_4808,Joe Burrow had a sensational season at LSU ,43,708,223911,224619,carousel,FALSE
CompanyJ_4809,Jamal Murray faked the defense and threw it off the glass   Mamba Mentality.,76,3462,596963,600425,video,FALSE
CompanyJ_4810,LeBrons reaction to Bronnys clutch bucket is everything  @br_hoops (via @whosnexths),84,1414,344017,345431,video,FALSE
CompanyJ_4811,Bronny showed up to Ohio against his Dads alma mater and won MVP of the game right in front of him. @br_hoops  Hes got next  (via @_tarekfattal),144,2136,626788,628924,carousel,FALSE
CompanyJ_4812,The NFL MVP could be younger than the Heisman winner this year  @brgridiron,75,2090,416767,418857,image,FALSE
CompanyJ_4813,Giannis hit the Cobra finisher on Robin Lopez for the second-straight night  @brwrestling (via @bucks),102,1250,168476,169726,video,FALSE
CompanyJ_4814,Kamaru Usman TKOs Colby Covington to retain the UFC welterweight Championship   What a fight.,93,2005,267690,269695,carousel,FALSE
CompanyJ_4815,All-time talent. The world doubts. Second act is legendary  OBJ might follow the same career arc as Randy Moss | @brgridiron,124,3128,258148,261276,carousel,FALSE
CompanyJ_4816,Jamal Murray. Still wild.  (via @j2thamfnp),43,447,152501,152948,video,FALSE
CompanyJ_4817,Usman was fighting for something bigger.,40,3434,252682,256116,image,FALSE
CompanyJ_4818,LBJ and Savannah courtside for Bronny ,38,1862,495996,497858,image,FALSE
CompanyJ_4819,A sports familys dream  @brgridiron,35,699,207921,208620,image,FALSE
CompanyJ_4820,Last game in Oakland before the Raiders move to Vegas. League wont be the same  @brgridiron,91,544,56524,57068,video,FALSE
CompanyJ_4821,Impossible throw from Carson Wentz  (via @thecheckdown),55,2653,394129,396782,video,FALSE
CompanyJ_4822,Giants fans give Eli his well-deserved ovation in what could be his last home start   @brgridiron (via @thecheckdown),117,419,88080,88499,video,FALSE
CompanyJ_4823,Markelle made Jrue pay for going for the steal   So smooth.,59,1170,193046,194216,video,FALSE
CompanyJ_4824,#NAME?,27,2100,358963,361063,video,FALSE
CompanyJ_4825,Rondo faked the oop so Bron faked the block ,44,6765,825758,832523,video,FALSE
CompanyJ_4826,"""You can thank Chris Paul""  The ref told Elfrid Payton to thank CP3 for getting a delay of game for having an untucked jersey ",126,527,181367,181894,video,FALSE
CompanyJ_4827,Raiders fans started throwing trash on the field after losing their final home game in Oakland @brgridiron (via @torreyhart),124,5105,317362,322467,video,FALSE
CompanyJ_4828,Bron showed VC respect after their final game against each other ,65,992,353712,354704,video,FALSE
CompanyJ_4829,The Champions League last 16 is going to be  @brfootball,56,448,63640,64088,image,FALSE
CompanyJ_4830,No load management for @kingjames ,34,4272,343099,347371,image,FALSE
CompanyJ_4831,Is Super Bowl champ Reggie Wayne heading to the @profootballhof?   Retired with 7th-most catches ever  6x Pro Bowl  From B/R X @ford   #PFHOF20,143,287,28294,28581,video,TRUE
CompanyJ_4832,League-wide respect for Lamar is real  @brgridiron,50,995,341168,342163,carousel,FALSE
CompanyJ_4833,9 of the best Christmas Day outfits for day 9 of the #BRNBAXmas ,64,545,154832,155377,carousel,TRUE
CompanyJ_4834,Fifth time the league has suspended Flash (@brgridiron),55,3197,190814,194011,image,FALSE
CompanyJ_4835,"Houston Rockets forward PJ Tucker surprised Kent State basketball player Kalin Bennett, who became the first D-I player with autism to score in a game earlier this year.  Bennett was able to choose and sign Tuckers sneakers for his game. ",238,275,73953,74228,video,FALSE
CompanyJ_4836,This angle of the Wentz throw. Ridiculous  @brgridiron (via  metro_boonin/Twitter),82,1457,253721,255178,video,FALSE
CompanyJ_4837,You can say China loves them some T-Mac  (via @tmac213),55,1676,192348,194024,video,FALSE
CompanyJ_4838,Dejounte Murray and Harden going at it ,39,13076,615894,628970,video,FALSE
CompanyJ_4839,Drew Brees becomes the all-time TD pass leader  @brgridiron,59,3148,304503,307651,image,FALSE
CompanyJ_4840,Drew Brees sends love to his family after breaking the NFL record for touchdown passes  @brgridiron (via @thecheckdown),119,600,218147,218747,video,FALSE
CompanyJ_4841,"""I absolutely s--t my pants""  Steven Adams kept it a little too real in his postgame interview ",95,1009,340196,341205,video,FALSE
CompanyJ_4842,"No Luka, no problem. The Bucks streak has ended.  KP:  26 PTS (4 threes) 12 REBS 4 ASTS",87,2334,412561,414895,carousel,FALSE
CompanyJ_4843,Melo balled out tonight ,24,2393,441512,443905,carousel,FALSE
CompanyJ_4844,"From the 2015 playoffs to the tunnel game, Rockets-Clippers is one of the NBAs hottest rivalries ",97,856,217997,218853,video,FALSE
CompanyJ_4845,Is John Lynch heading to the @profootballhof?  Super Bowl XXXVII champion  9x Pro Bowl  From B/R X @ford  #PFHOF20,114,183,26013,26196,video,TRUE
CompanyJ_4846,Generational  @brkicks,22,1426,503880,505306,image,FALSE
CompanyJ_4847,Eight players wed love to see go head-to-head next year   Day 8 of #BRNBAXMas,77,531,99677,100208,carousel,TRUE
CompanyJ_4848,@swaggyp1s kid went viral off one highlight and now he's pulling up to school like he's in the NBA ,99,1879,312895,314774,video,FALSE
CompanyJ_4849,Cole Anthony is projected to be a potential top pick in the 2020 NBA Draft. Best wishes for a speedy recovery  @br_hoops,120,1127,178597,179724,image,FALSE
CompanyJ_4850,Kobe vs. MJ 33 PTS vs. 36 PTS  22 years ago today,49,819,215327,216146,image,FALSE
CompanyJ_4851,"New #GridironHeights  The NFC East is up for grabs, and it doesnt look like the Eagles or the Cowboys want it ",110,423,49790,50213,video,TRUE
CompanyJ_4852,Zion couldn't believe Zo hooked up the Pelicans with custom Xboxes for the holidays  (via @pelicansnba),103,4063,654005,658068,video,FALSE
CompanyJ_4853,"Teddy Bridgewater is real  Rode his bike to the Superdome for the high school state championship and sat on the bench with players. The Saints QB wants to make sure kids see role models in the flesh @brgridiron    - - -  (via@thesamspiegs,@rivalsdotcom)",253,1347,399439,400786,carousel,FALSE
CompanyJ_4854,Bron is too smooth with it ,27,2077,345971,348048,video,FALSE
CompanyJ_4855,Big Truss  @brgridiron,22,2203,340343,342546,image,FALSE
CompanyJ_4856,"You been watching film, huh? Thats cool. Watch this."" Two years ago today, Cam called his shot on Clay Matthews.   Then he delivered  @brgridiron   (via @thecheckdown)",167,1961,383339,385300,video,FALSE
CompanyJ_4857,Oubre bodied PG ,16,10165,571040,581205,video,FALSE
CompanyJ_4858,Who is screaming that loud? ,28,4067,319702,323769,video,FALSE
CompanyJ_4859,#NAME?,42,4876,563573,568449,video,FALSE
CompanyJ_4860,"@kingjames is having the best Year 17 weve ever seen, says Howard Beck ",71,1263,128414,129677,video,FALSE
CompanyJ_4861,Is Edgerrin James heading to the @ProFootballHOF?   NFL All-Decade Team (2000s)  4x Pro Bowl  2x All-Pro first team  From B/R X @Ford  #PFHOF20,143,217,24760,24977,video,TRUE
CompanyJ_4862,KG didnt hold back ,19,10801,392993,403794,image,FALSE
CompanyJ_4863,Gerrit Cole brought back the sign he made as a kid for the 2001 World Series  (via @yesnetwork),95,1901,352613,354514,carousel,FALSE
CompanyJ_4864,"8 & 24  Two years ago today, the Lakers retired both of @kobebryants jerseys ",77,1166,320912,322078,image,FALSE
CompanyJ_4865,Things are going well in Cleveland  @brgridiron,47,5010,328639,333649,carousel,FALSE
CompanyJ_4866,Seven games of NBA 2K taking an unexpected twist  @brgaming  Day 7 of #BRNBAXMas,80,725,95939,96664,video,TRUE
CompanyJ_4867,"Frame this, @kellyoubrejr ",26,3687,505659,509346,carousel,FALSE
CompanyJ_4868,Air @cristiano  @brfootball,27,648,148990,149638,image,FALSE
CompanyJ_4869,"Herman Boone, the iconic coach portrayed in 'Remember the Titans', dies at 84",77,2842,291395,294237,image,FALSE
CompanyJ_4870,DIFFERENT ,10,1336,391419,392755,image,FALSE
CompanyJ_4871,D-Rose getting shifty ,22,1980,291069,293049,video,FALSE
CompanyJ_4872,Pat Mahomes making it look too easy even in the snow  @brgridiron (via @chiefs),79,661,136369,137030,video,FALSE
CompanyJ_4873,Melo called for the OOP ,24,625,170543,171168,video,FALSE
CompanyJ_4874,Serena Williams training with Mike Tyson   Legends. (via @miketyson),68,1687,116151,117838,video,FALSE
CompanyJ_4875,There can only be one.   Bucks & Lakers battle tonight on TNT,61,1822,267287,269109,video,FALSE
CompanyJ_4876,You always hear about LeBrons humble beginnings. Now hes helping to reshape this narrative for future generations.,114,433,61248,61681,video,FALSE
CompanyJ_4877,Is DT Richard Seymour heading to the @profootballhof? Three Super Bowls in NE 2000s All-Decade Team  #pfhof20 From B/R X @ford,126,157,24593,24750,video,TRUE
CompanyJ_4878,"Seven of the NBAs best take the floor tonight, and the list of their accolades isnt too shabby",94,464,122791,123255,carousel,FALSE
CompanyJ_4879, BRING. BACK.CHRISTMAS. JERSEYS.  Reimagined NBA holiday jerseys for Day 6 of #BRNBAXmas,88,7611,937459,945070,carousel,TRUE
CompanyJ_4880,Chad @ochocinco nailed a 60-yard FG to win this fan his bet   New @br_betting Gameday Gameshow ( @caesarspalace),112,136,38809,38945,video,FALSE
CompanyJ_4881, @br_hoops,10,2059,338507,340566,image,FALSE
CompanyJ_4882,The battle of NBAs best records will feature the reunion of the Antetokounmpo brothers ,87,158,63099,63257,video,FALSE
CompanyJ_4883,Giannis vs. Bron's numbers at age 25 are very similar   The Greek Freak and The King face off tonight on @nbaontnt,114,963,142228,143191,carousel,FALSE
CompanyJ_4884,Young SoCal legends face off on the big stage tonight  @br_hoops,64,812,292498,293310,image,FALSE
CompanyJ_4885,Greek Freak vs. Bron  Who had the better first signature shoe? @brkicks,71,1794,260347,262141,image,FALSE
CompanyJ_4886,Russ officially debuts the Jordan Why Not Zer0.3  @brkicks,58,1001,189489,190490,carousel,FALSE
CompanyJ_4887,Bron passes Gary Payton on the all-time assists list ,53,856,232333,233189,image,FALSE
CompanyJ_4888,The Greek Freak strikes down the King and the Lakers ,53,6189,503465,509654,video,FALSE
CompanyJ_4889,Antetokounmpo family reunion  (via @nbaontnt),45,2025,406223,408248,video,FALSE
CompanyJ_4890,Giannis showed off his new and improved jumper in a statement win over the Lakers ,82,1844,358214,360058,carousel,FALSE
CompanyJ_4891,Russ really made the Staples Center crew bring out a ladder to make sure the rim was straight ,94,3463,405721,409184,video,FALSE
CompanyJ_4892,Harden hit PG with a nasty combo ,33,1974,167387,169361,video,FALSE
CompanyJ_4893,Russ waved off Pat Bev after his ejection and got hit with a technical. Harden immediately tried to calm Russ down ,115,2940,446719,449659,video,FALSE
CompanyJ_4894,Harden drilled the biggest shot of the game to help lift the Rockets over the Clippers ,87,573,107367,107940,video,FALSE
CompanyJ_4895,Career-high five triples vs. the King. Greek Freak wants that crown    #MtnDew3pt,81,639,94212,94851,video,TRUE
CompanyJ_4896,Two trios of brothers got to swap jerseys in one week. Sports are incredible.,77,1515,596015,597530,image,FALSE
CompanyJ_4897,Can you spot the five holiday-related differences on Day 5 of #BRNBAXMas?,73,6708,200058,206766,carousel,TRUE
CompanyJ_4898,The reigning MVPs squad has the best record in the NBA. He's keeping himself humble.,84,1704,437433,439137,image,FALSE
CompanyJ_4899,Theres nobody in football like Action Jackson  @brgridiron,58,3278,399758,403036,carousel,FALSE
CompanyJ_4900,Check the Brodies resume ,25,1834,383910,385744,image,FALSE
CompanyJ_4901,Does Darren Woodson belong in the@ProFootballHOF?   3x champ  3x All Pro  Cowboys all-time tackles leader  From B/R X@ford   #PFHOF20,133,181,24110,24291,video,TRUE
CompanyJ_4902,Father/son duo in the NFL would be unreal  @brgridiron,54,787,225600,226387,image,FALSE
CompanyJ_4903,Mamba outscored the Mavs by himself with a quarter to go62 points on 18/31 FG. Lakers were up 34 and Kobe declined playing the 4th to chase 70. Ill do it when we really need it. Bryant dropped 81 a month later. ,211,1703,270651,272354,image,FALSE
CompanyJ_4904,UConn commit @andrejackson5 put him on a poster then stared him down  @br_hoops,79,2777,256429,259206,video,FALSE
CompanyJ_4905,Ja was WILD for trying this over Kevin Love ,44,13589,867330,880919,carousel,FALSE
CompanyJ_4906,Joe Mixon tweeted @tombrady that he was too nervous to ask for his jersey after the Patriots beat the Bengals. TB came through  @brgridiron,139,512,184227,184739,image,FALSE
CompanyJ_4907,Kevin Love had to give the rook his credit ,43,2387,623540,625927,image,FALSE
CompanyJ_4908,Brad Stevens wanted to see how loud Boston would get before he subbed Tacko in the game  (via @marcdamiconba),109,4541,828010,832551,video,FALSE
CompanyJ_4909,Binoculars make any nosebleed seat better  (via @kevinpaskevich60 | @brgridiron),80,1245,240781,242026,video,FALSE
CompanyJ_4910,Combined 67 from Dame and CJ gave the Blazers their third-straight win ,71,640,298971,299611,carousel,FALSE
CompanyJ_4911,Four days til these four MVPs take the court on Christmas #BRNBAXMas,68,610,186312,186922,image,TRUE
CompanyJ_4912,#NAME?,76,920,262842,263762,video,FALSE
CompanyJ_4913,"Fifty. Goals. In. A. Year. For most, thats impossible. For Messi, its the ninth time.  @brfootball",98,1098,168176,169274,image,FALSE
CompanyJ_4914,Legendary. @brgridiron - - -  ( @nflthrowback),46,1679,416123,417802,carousel,FALSE
CompanyJ_4915,56 RB got laughed at during the combine. He spent a decade-and-a-half in the league. Salute  @brgridiron,104,1863,326581,328444,image,FALSE
CompanyJ_4916,Airness still making history  @brkicks,38,1142,232980,234122,image,FALSE
CompanyJ_4917,Hardens got respect from the greats,35,3103,365544,368647,image,FALSE
CompanyJ_4918,Luka Doncic is nearing a lucrative multi-year deal with Jordan Brand. Future of the Jumpman is in good hands  @brkicks --- (via @shamsnba | @tcat75),148,1417,402972,404389,image,FALSE
CompanyJ_4919,BRADY TOOK HIM OUT. @brgridiron  (via @nfl),43,1118,125303,126421,video,FALSE
CompanyJ_4920,"I got ice in my veins  After taking a pic with Luka, this Sixers fan drained a jumper in front of him  (via @fanaticsview)",122,1589,216833,218422,video,FALSE
CompanyJ_4921,"""Yeah, they might be open, but they can just get your rebound if you miss."" ",76,6397,741404,747801,video,FALSE
CompanyJ_4922,THANASIS ANTETOKOUNMPO   Bucks bench couldn't believe it,56,2635,662040,664675,video,FALSE
CompanyJ_4923,Rams fans watching their squad go from the Super Bowl to missing the playoffs @brgridiron,89,3152,243555,246707,video,FALSE
CompanyJ_4924,@jharden13 now has the 4th-most 40-point games ever after dropping 47 last night ,81,2510,302292,304802,image,FALSE
CompanyJ_4925,"""Don't do that, man.""  IT confronts the fan who allegedly shouted ""f--k you, b---h"" after he made a free throw (via @victoria_finnegan)",135,8136,736195,744331,video,FALSE
CompanyJ_4926,Christmas clutch from 3  Day 3 of #BRNBAXmas,44,1944,407946,409890,video,TRUE
CompanyJ_4927,Philly fans get a Frosty if an opponent misses two free throws in the second half,81,6355,537110,543465,image,FALSE
CompanyJ_4928,Gotta respect this  @brgridiron,31,1647,431661,433308,image,FALSE
CompanyJ_4929,SAQUON BACK TO EMBARRASSING DEFENDERS  108 yards on his first four carries of the game @brgridiron   (via @nfl),111,1240,289895,291135,video,FALSE
CompanyJ_4930,Steelers benched QB Duck Hodges for Mason Rudolph against the Jets. This guy was READY  @brgridiron - - - (via steelersfan8479/Twitter),135,1085,184434,185519,video,FALSE
CompanyJ_4931,144 times that proved you @Cantguardmike. Most catches in a single season  @brgridiron,86,556,130884,131440,video,FALSE
CompanyJ_4932,Raptors fans loved every second of this historic comeback ,58,1018,379508,380526,carousel,FALSE
CompanyJ_4933,Eagles fans going to bed knowing the Cowboys couldnt clinch the NFC East today  @brgridiron,91,2170,142797,144967,video,FALSE
CompanyJ_4934,OBJ and Lamar showed love postgame.   Much respect between these two studs. (via @ravens | @brgridiron),103,3116,304776,307892,video,FALSE
CompanyJ_4935,Pat Mahomes counted to 10 to let the Bears know where he landed in the draft  @brgridiron - - - ( @chiefs),106,2312,390566,392878,video,FALSE
CompanyJ_4936,#NAME?,54,1025,217442,218467,video,FALSE
CompanyJ_4937, @brgridiron,12,2986,336592,339578,image,FALSE
CompanyJ_4938,"Daniel Jones and Eli celebrating the Giants win with flip cup  (via @dquiznj, @greenrock_hoboken)",97,972,108981,109953,video,FALSE
CompanyJ_4939,Twas two nights before the two LA teams face off on Christmas Day  #brnbaxmas,77,1882,144057,145939,video,TRUE
CompanyJ_4940, @brgridiron,12,4897,472641,477538,image,FALSE
CompanyJ_4941,Lamar Jackson will sit out next week after Baltimore locked up the AFCs No. 1 seed. His regular season is over. Youll remember it for a long time  @brgridiron,158,3446,377505,380951,image,FALSE
CompanyJ_4942,The NBA investigated and found no evidence the Clippers granted his requests.,77,4027,315998,320025,image,FALSE
CompanyJ_4943,AD is already cementing himself as one of LeBrons best-ever teammates ,70,1641,95463,97104,video,FALSE
CompanyJ_4944,"From the Last Dance jersey swap to the 2019 All-Star Game, @dwyanewade has been preparing @dloading to become the face of Way of Wade. @brkicks",143,222,124254,124476,carousel,FALSE
CompanyJ_4945,Nailed the half-court shot and won free Chick-fil-A for a year  The basketball gods were on his side.,101,3467,343494,346961,video,FALSE
CompanyJ_4946,DERRICK JONES JR. ON THE REIGNING DPOY ,39,1372,258810,260182,video,FALSE
CompanyJ_4947,24 is back in Seattle @brgridiron,33,3035,420753,423788,image,FALSE
CompanyJ_4948,Lonzo put his own teammate on a poster ,39,1278,352553,353831,video,FALSE
CompanyJ_4949,Jerami Grant. SHUT IT DOWN. ( @nhtsagov),40,282,100983,101265,video,FALSE
CompanyJ_4950,The Jazz bench got a lot stronger with Jordan Clarkson  - - - From B/R x @americanexpress,89,1837,210532,212369,video,FALSE
CompanyJ_4951,The wait is almost over  One day full of hoops for basketball fans everywhere tomorrow #BRNBAXmas,97,166,49695,49861,video,FALSE
CompanyJ_4952,#NAME?,59,966,321358,322324,video,FALSE
CompanyJ_4953,Will another chapter be added to the book of NBA Christmas legends tomorrow?,76,168,39509,39677,video,FALSE
CompanyJ_4954,"New #GridironHeights  Mahomes and Co. are in the holiday spirit, singing their favorite tunes ",94,385,62637,63022,video,TRUE
CompanyJ_4955,Santa hit Staples Center early ,31,1193,339398,340591,carousel,FALSE
CompanyJ_4956,Michael Thomas creating unforgettable moments for a special fan at the hospital  @brgridiron (via Nader723/Twitter),115,1636,203621,205257,video,FALSE
CompanyJ_4957,#NAME?,60,2884,369365,372249,carousel,FALSE
CompanyJ_4958,The NBA Holiday Party is lit ,29,758,258725,259483,carousel,FALSE
CompanyJ_4959,#NAME?,88,971,329104,330075,carousel,FALSE
CompanyJ_4960,Safe to say @dsproles43 proved them all wrong  @brgridiron,58,1359,327700,329059,image,FALSE
CompanyJ_4961,Warriors vs. Cavaliers on Christmas Day 2016 was a classic ,59,2661,339430,342091,video,FALSE
CompanyJ_4962,Todays the day...,17,1692,327111,328803,video,FALSE
CompanyJ_4963,A full day of hoops. Merry Christmas to all ,44,953,376261,377214,image,FALSE
CompanyJ_4964,The NBAs biggest stars will take center stage on Christmas Day ,63,184,65413,65597,video,FALSE
CompanyJ_4965,The best Christmas-themed sneakers  @brkicks,44,1489,227110,228599,carousel,FALSE
CompanyJ_4966,"Enes Kanter has not played a game outside the US in over a year out of fear for his safety since criticizing the Turkish government.  Today, he finally gets to ",160,1316,319973,321289,carousel,FALSE
CompanyJ_4967,Jaylen Brown. GOODNESS ,23,1038,101907,102945,video,FALSE
CompanyJ_4968,"These boys recently lost their father, so Matthew Stafford and his wife Kelly came to their house to bring them Christmas presents  @brgridiron (via Heather Krause, Jenny Myers/FB)",180,822,152482,153304,video,FALSE
CompanyJ_4969,Joel Embiid shut down Giannis ,30,2679,264034,266713,video,FALSE
CompanyJ_4970,Embiid has his eyes set on DPOY ,32,2675,276621,279296,image,FALSE
CompanyJ_4971,Embiid got the best of Giannis and the Bucks   #NBAXmas,55,974,233326,234300,video,TRUE
CompanyJ_4972,The Lakers went in on Kuz's fit  @brkicks (via @qcook323),57,4188,368684,372872,video,FALSE
CompanyJ_4973,The Rockets just gave the Warriors their first win over a team with a .500 record ,82,3196,497972,501168,image,FALSE
CompanyJ_4974,Draymond was feeling it from 3PT and nailed the dagger against the Rockets  #MtnDew3pt,86,501,94610,95111,video,TRUE
CompanyJ_4975,Kawhi and the Clippers steal an #NBAXMas win.,45,4603,250443,255046,video,TRUE
CompanyJ_4976,AD really landed on Kevin Hart ,31,598,108260,108858,video,FALSE
CompanyJ_4977,Pat Bev with the clutch block on Bron to seal the game ,55,1402,102877,104279,video,FALSE
CompanyJ_4978,Pat Bev responsed to a fan telling him dont make me call James Harden Ill lock his ass up too!  (via @haylohaylz),113,4563,441948,446511,video,FALSE
CompanyJ_4979,Embiid ruined the Greek Freak's Christmas ,42,444,95590,96034,video,FALSE
CompanyJ_4980,Cant teach that ,16,1807,352456,354263,image,FALSE
CompanyJ_4981,Mans a legend  @brgridiron,26,1214,402085,403299,image,FALSE
CompanyJ_4982,June could determine who really runs Los Angeles ,49,2519,407062,409581,image,FALSE
CompanyJ_4983,"Zlatan Ibrahimovic has agreed a deal to return to AC Milan, per @gianlucadimarzio (@brfootball)",95,1017,179750,180767,image,FALSE
CompanyJ_4984,Its all about giving back  @brfootball,38,2120,311106,313226,image,FALSE
CompanyJ_4985,#NAME?,51,748,289798,290546,image,FALSE
CompanyJ_4986,Never bet against the Spurs...until now?,40,503,84221,84724,video,FALSE
CompanyJ_4987,Even coach Harbaugh is saying it now  @brgridiron,49,844,322076,322920,image,FALSE
CompanyJ_4988,Basketball is better with the Splash Bros ,42,3073,463301,466374,carousel,FALSE
CompanyJ_4989,Luka joins Zion on Team Jordan  @brkicks,40,1045,384400,385445,image,FALSE
CompanyJ_4990,THIS SETH CURRY DIME ,21,2237,542356,544593,video,FALSE
CompanyJ_4991,#NAME?,89,1000,237636,238636,video,FALSE
CompanyJ_4992,Imagine this duo... @brgridiron  ( @saints),43,3409,372678,376087,image,FALSE
CompanyJ_4993,Salute.,7,4708,583989,588697,image,FALSE
CompanyJ_4994,Hawks are last in the East but Ice Trae is putting up ridiculous numbers. All-Star?   29 PPG  8.5 APG,101,965,92406,93371,video,FALSE
CompanyJ_4995,Brodie wasnt about it ,22,4018,535582,539600,image,FALSE
CompanyJ_4996,LETS GO ,8,2429,272705,275134,image,FALSE
CompanyJ_4997,This mentality from Drew Brees...    @brgridiron,48,3003,362471,365474,image,FALSE
CompanyJ_4998,"Zach Randolph was an enforcer on the floor but would give the shirt off his back. Enjoy retirement, Z-Bo.   (via @NBA)",118,1097,321998,323095,video,FALSE
CompanyJ_4999,Showtime when 77 is on the floor,32,549,221806,222355,image,FALSE
CompanyJ_5000,Iron sharpens iron @champagnepapi  @rapradar,44,1163,345812,346975,carousel,FALSE
CompanyJ_5001,Shai with one of the filthiest eurosteps you'll see all season ,63,2089,381003,383092,video,FALSE
CompanyJ_5002,It had been three years since Heat rookie Chris Silva had last seen his mother  That changed today ,99,1276,186457,187733,video,FALSE
CompanyJ_5003,@dloading dropped 31 to lead the Warriors to their fourth-straight dub   Steph loved it.,88,2171,539829,542000,carousel,FALSE
CompanyJ_5004,Z-Bo officially says goodbye. Respect to a legend ,50,1465,283414,284879,image,FALSE
CompanyJ_5005,#NAME?,84,2499,456310,458809,video,FALSE
CompanyJ_5006,Wolves winger Adama Traore might be playing the wrong football  @brfootball,75,2658,465388,468046,image,FALSE
CompanyJ_5007,Can't wait for Burrow at the next level  @brgridiron,52,2640,377229,379869,image,FALSE
CompanyJ_5008,Jamal Murray GOT UP  (: @nhtsagov),34,346,76610,76956,video,FALSE
CompanyJ_5009,Joe Burreaux leads No. 1 LSU to the 2019 CFP title game with an unforgettable and historic Peach Bowl performance ,114,1080,373500,374580,image,FALSE
CompanyJ_5010,Best perfomance by a WR in Peach Bowl history will catch NFL scouts' eyes  @brgridiron,86,348,148331,148679,image,FALSE
CompanyJ_5011,Doesnt get much more ridiculous than this ,42,712,243284,243996,carousel,FALSE
CompanyJ_5012,"History was made tonight in New Orleans   The three Holiday brothers, Jrue, Justin and Aaron, became the first trio of brothers to all play in the same NBA game together",169,4610,789884,794494,carousel,FALSE
CompanyJ_5013,Tyler Herro came up CLUTCH against Philly  ( @rockstargames),60,436,68175,68611,video,FALSE
CompanyJ_5014,Trevor Lawrence and Clemson advance to the CFB title game with a 29-23 win over No. 2 Ohio State  The Tigers have now won 29 straight.,134,5412,518266,523678,image,FALSE
CompanyJ_5015,The Buckeyes blew a 16-0 lead...,32,2648,320048,322696,image,FALSE
CompanyJ_5016,Spida hit Kawhi with the fake and then took flight ,51,748,162043,162791,video,FALSE
CompanyJ_5017,Mavs vs. Warriors was full of trash-talk. ,42,7218,483264,490482,video,FALSE
CompanyJ_5018,This was @obj right after getting officially eliminated from the playoffs last week. Respect... @brgridiron  - - - (via @randyisice),132,721,242169,242890,video,FALSE
CompanyJ_5019,"Trios of brothers are making history this year  Holidays, Antetokounmpos and Edmunds",84,2044,599156,601200,image,FALSE
CompanyJ_5020,Wait for it... @brgridiron  (via @seahawks),43,1019,179216,180235,video,FALSE
CompanyJ_5021,A decade of greatness   @brfootball,35,1645,200996,202641,image,FALSE
CompanyJ_5022,New Orleans got the full AB experience  @brgridiron,51,2982,421719,424701,carousel,FALSE
CompanyJ_5023,  ,2,3669,388792,392461,image,FALSE
CompanyJ_5024,#NAME?,51,2223,319109,321332,video,FALSE
CompanyJ_5025,One of the greatest running back seasons ever @brgridiron,57,807,199440,200247,image,FALSE
CompanyJ_5026,First time this has ever happened. Final interception was a pick-six in OT that gave him the NFL record for pick-sixes.   Simply incredible. @brgridiron,152,5171,325177,330348,image,FALSE
CompanyJ_5027,Klay's been dressing in full uniform and a headband before Warriors games while going through his workout.  Seems like he can't wait to be back (via @zazapachulia),163,2040,463592,465632,video,FALSE
CompanyJ_5028,Gelo is back.,13,5127,429849,434976,image,FALSE
CompanyJ_5029,Mason Crosby was cold-blooded today   From B/R x @coorslight,60,219,48152,48371,video,FALSE
CompanyJ_5030,Eagles closed the door on the Cowboys playoff hopes  @brgridiron,64,7832,452605,460437,video,FALSE
CompanyJ_5031,Playoff bound  @brgridiron,26,3248,297625,300873,carousel,FALSE
CompanyJ_5032,Four threes in the first quarter for @zo. New career-high in a quarter ,71,2177,262995,265172,video,FALSE
CompanyJ_5033,JOKIC. BIG GUARD.,17,2868,342570,345438,video,FALSE
CompanyJ_5034,Justin Tucker did @dababys bop  (via @ravens),45,3395,429289,432684,video,FALSE
CompanyJ_5035,Marshawn Lynch scores a touchdown in his first game back as a Seahawk  @brgridiron (via @nfl),93,1869,272375,274244,video,FALSE
CompanyJ_5036,"Joe Mixon went to celebrate the Bengals' second win all year, but the ref got in the way  @brgridiron (via ChaseLaub1/Twitter)",126,2792,364491,367283,video,FALSE
CompanyJ_5037,LeBron and Kobe reunited at Staples ,36,992,270775,271767,video,FALSE
CompanyJ_5038,Shai capped off his 32-point night with the go-ahead bucket against the defending champs ,89,237,59749,59986,video,FALSE
CompanyJ_5039,In a league of his own ,23,2874,386558,389432,image,FALSE
CompanyJ_5040,"Luka said Kobe was speaking to him in Slovenian from the sidelines   ""He was talking Slovenian. So I was like, 'who's talking my language?' I saw Kobe and was really surprised.""  (via @ben.golliver)",198,3713,908359,912072,video,FALSE
CompanyJ_5041,"35 years of wearing the crown. Happy birthday, @kingjames   3x champ  3x Finals MVP  4x MVP  6x All-Defensive  15x All-Star  15x All-NBA  4th in career points  9th in career assists  Playoff points leader",204,1002,143678,144680,video,FALSE
CompanyJ_5042,Only Mamba.,11,2209,532792,535001,image,FALSE
CompanyJ_5043,"Browns locker room after going 6-10, missing the playoffs and firing Freddie Kitchens  @brgridiron",98,5008,370865,375873,video,FALSE
CompanyJ_5044,Bron reached 9K career assists last night. Mentality started early.,67,2191,545156,547347,carousel,FALSE
CompanyJ_5045,"Sheesh, coach  @brgridiron",26,2653,275805,278458,image,FALSE
CompanyJ_5046,The best sneakers from the @brkicks drop up ,44,62,15404,15466,video,FALSE
CompanyJ_5047,Mamba has Dirk's respect ,25,1862,395621,397483,image,FALSE
CompanyJ_5048,Coby White has MOVES.,21,801,102310,103111,video,FALSE
CompanyJ_5049,Hasn't stopped improving since he's been in the league ,55,2177,478766,480943,carousel,FALSE
CompanyJ_5050,Melo been hitting this for 17 years now ,40,2148,413495,415643,video,FALSE
CompanyJ_5051,Kelly Oubre hit the dagger for the Suns late and blew kisses to Blazers fans ,77,2136,308122,310258,video,FALSE
CompanyJ_5052,Uncle @DwyaneWade helping Bryce James get shots up at halftime of the Sierra Canyon game.  All in the family  @br_hoops,119,1147,241465,242612,video,FALSE
CompanyJ_5053,Classic Patriots stories never get old... @brgridiron,53,979,324030,325009,carousel,FALSE
CompanyJ_5054,Messi was really watching Messi highlights at the gym. Elite  @brfootball (via @valenjure),90,1726,401080,402806,image,FALSE
CompanyJ_5055,Unforgettable  years in the Association.,40,7775,622965,630740,carousel,FALSE
CompanyJ_5056,New Orleans has been good to @1ngram4,37,2166,303538,305704,carousel,FALSE
CompanyJ_5057,2016 was the wildest year of the decade  @brfootball,52,1697,295605,297302,carousel,FALSE
CompanyJ_5058,Zion show starting soon?,24,1723,297966,299689,image,FALSE
CompanyJ_5059,"As far back as Josh Allen can remember, hes wanted to be part of the Bills Mafia  New #GridironHeights",102,175,50582,50757,video,TRUE
