Username,Message,Character Count,Retweet Count,Like Count,Total Actions,Type
CompanyJ_1,The New Year s Party we want to see ,36,1169,4512,5681,video
CompanyJ_2,This kid couldn t believe how close he was to Steph via NBA ,60,1675,14857,16532,video
CompanyJ_3,Rockets ball movement ,22,656,3554,4210,video
CompanyJ_4,Jerami Grant Oh man ,20,1068,6986,8054,video
CompanyJ_5,James Harden joins Kobe Bryant and MJ as the 3rd player in last 30 years to score at least 400 points in 10 game span per Elias Sports Bureau ,142,4555,15092,19647,photo
CompanyJ_6, 9M 139 seconds 3 knockdowns That s crazy Floyd via misterkaikai ,65,1446,6440,7886,video
CompanyJ_7,Harden is in MVP form ,22,1044,5795,6839,photo
CompanyJ_8,Josh Okogie s bounce ,21,322,2272,2594,video
CompanyJ_9,Oregon FB celebrating with some Pretty Ricky NSFW via BradyBreeze ,66,638,3183,3821,video
CompanyJ_10,You good Klay ,14,721,6899,7620,video
CompanyJ_11,Might as well preview Cavs vs Warriors in the Finals for the next 30 years BestOf2018 ,86,916,3573,4489,video
CompanyJ_12,Russ signs off and wishes everyone a Happy New Year and gives away his shoes to a lucky fan ,92,1117,8306,9423,video
CompanyJ_13,Happy New Year East Coast ,26,577,6208,6785,video
CompanyJ_14,Happy New Year West Coast ,26,1138,6940,8078,video
CompanyJ_15,Jimmy Butler made his NBA debut on this day in 2012 His road to get there was incredible No 73 SG in Texas No D I offers Went to JuCo Faxed acceptance to Marquette from McDonald s Had no idea he was an NBA prospect ,215,9112,52260,61372,photo
CompanyJ_16,40 8 PPG over his last 10 games ,32,3097,19046,22143,photo
CompanyJ_17,Conor Jr s got hands via TheNotoriousMMA ,41,2030,13935,15965,video
CompanyJ_18,Dana White says rematch between McGregor and Khabib should happen in 2019 per TMZ_Sports ,89,1137,5023,6160,photo
CompanyJ_19,Shaq s light up jersey via SHAQ ,32,2778,12632,15410,video
CompanyJ_20,KD showed this fan so much love via jpruneau10 ,47,4143,32386,36529,video
CompanyJ_21,This is how Diego Costa wakes up his own brother via diegocosta ,64,1109,5054,6163,video
CompanyJ_22,Kentucky s Benny Snell Jr just gave the Wildcats a 17 7 lead How the star RB went from a 3 star recruit to helping put Kentucky football on the map ,148,185,1268,1453,photo
CompanyJ_23,UCF finally loses ,18,619,4954,5573,photo
CompanyJ_24,DeMarcus Cousins will consider spending another season with the Warriors per TheSteinLine ,90,1353,7712,9065,photo
CompanyJ_25,The mascot meeting did not go as planned via aasdanny ,54,6800,22945,29745,video
CompanyJ_26,The Bears remixed the Super Bowl Shuffle for 2019 GridironHeights playstation ,78,1175,4731,5906,video
CompanyJ_27,Dwayne Haskins becomes just the 6th QB in FBS history to throw 50 TDs in a season ,82,724,4419,5143,photo
CompanyJ_28,GIANNIS ,8,16765,60774,77539,video
CompanyJ_29,Dwayne Haskins and the Buckeyes win the Rose Bowl 28 23 ,56,742,4056,4798,photo
CompanyJ_30,Jamal Murray Wow ,17,943,5526,6469,video
CompanyJ_31,Tyler Trent a former Purdue student and Boilermakers superfan has died at 20 years old Tyler was an inspiration to all ,119,2627,17406,20033,video
CompanyJ_32,That was ridiculous Kawhi ,26,806,5329,6135,video
CompanyJ_33,Kawhi dropped a career high 45 PTS on the Jazz ,47,1593,9366,10959,video
CompanyJ_34,Kobe and Vanessa announce they re expecting their 4th baby girl ,64,4592,27964,32556,photo
CompanyJ_35,Giannis dunked Jon Leuer back to 2018 ,38,832,5279,6111,video
CompanyJ_36,Why d Plumlee do his own teammate like that ,44,6310,33618,39928,video
CompanyJ_37,Embiid wasn t too happy with Ben after this rebound ,52,719,4587,5306,video
CompanyJ_38,Pat Bev and Embiid got into it ,31,763,4693,5456,video
CompanyJ_39,Now Jimmy and Avery Bradley are getting into it ,48,720,4370,5090,video
CompanyJ_40,This Ben Simmons inbounds play ,31,6983,32468,39451,video
CompanyJ_41,Chelsea signs Christian Pulisic from Dortmund for 73 million The USMNT star will remain with BVB until this summer then join his new team ,138,1018,4468,5486,photo
CompanyJ_42,Another American joins the Premier League cpulisic_10 ,54,291,2189,2480,photo
CompanyJ_43,Should Kyler Murray scrap his MLB plans to try becoming the NFL s next superstar QB He should learn from Russell Wilson in making the call ,139,333,2725,3058,photo
CompanyJ_44,Lamelo getting into it on the Lakers practice court via zo2_ ,61,7386,41583,48969,video
CompanyJ_45,Legendary 5x5 for Nurkic ,25,1874,11245,13119,photo
CompanyJ_46,Griezmann meets Half man half amazing ,38,220,2750,2970,photo
CompanyJ_47,AB speaks amid turmoil surrounding Steelers Ben Roethlisberger and Mike Tomlin ,79,146,1132,1278,link
CompanyJ_48, Has the potential to be world class 20 year old Christian Pulisic s 73m transfer to Chelsea is the club s third most expensive signing ever but is it the right move ,166,204,1346,1550,photo
CompanyJ_49,Bronny spending some time with his new reptile friend via Therealtarxann ,73,1024,9994,11018,video
CompanyJ_50,Sunday 70 Subbed on 72 Goal Today 64 Subbed on 64 Goal Instant impact from romelulukaku9 ,89,401,2173,2574,photo
CompanyJ_51,Remember the girl who wrote to Steph Curry asking why his sneakers weren t available for girls She got a Christmas surprise from the 2x MVP ,140,1182,7015,8197,video
CompanyJ_52,Messi s first casualty of 2019 via fcbarcelona ,47,408,3210,3618,video
CompanyJ_53,The 2x league leader in interceptions raised the bar for cornerbacks From B R x fordtrucks PFHOF19 ,99,86,447,533,video
CompanyJ_54, ,1,2170,11228,13398,photo
CompanyJ_55,Jarvis Landry s recruiting efforts haven t gone unnoticed ,58,3984,24691,28675,photo
CompanyJ_56,After a convincing win over the Titans NFL analyst Shaun O Hara gives the Colts OLOTW for Week 17 fordtrucks ,109,26,173,199,video
CompanyJ_57,DSJ makes it look too easy ,27,384,3051,3435,video
CompanyJ_58, ChrisJohnson28 thinks it was rigged when John Ross broke his 4 24 40 time The combine was getting boring Full interview on SimmsAndLefkoe The Show ,148,703,2879,3582,video
CompanyJ_59,Waiters Island is BACK ,23,1013,5944,6957,video
CompanyJ_60,Young Dirk or Doncic ,21,959,7284,8243,photo
CompanyJ_61,Terry Rozier definitely doesn t watch TV These answers ,55,1312,7055,8367,video
CompanyJ_62,Jarrett Allen denies AD for the second time tonight ,52,907,6402,7309,video
CompanyJ_63,Embiid hit em with the big man euro ,36,2232,13923,16155,video
CompanyJ_64,Luka s reaction to seeing himself on the jumbotron ,51,5381,43974,49355,video
CompanyJ_65,Gordon Hayward had his best game of the season with 35 PTS against the Wolves ,78,1323,7356,8679,video
CompanyJ_66,Lakers fans booing Paul George at Staples via BDawsonWrites ,60,625,3369,3994,video
CompanyJ_67,NOOOOOOOO via Skubie3Mageza garystriewski ,42,3457,10084,13541,video
CompanyJ_68,Another huge game for Embiid 42 PTS 18 REBS 3 STLS 2 BLKS ,58,623,4442,5065,video
CompanyJ_69,Russ really hit Lance with the air guitar via NBATV ,52,2402,11378,13780,video
CompanyJ_70,PG is too hot this season ,26,2204,12134,14338,video
CompanyJ_71,Lonzo denies Russ Russ went 3 20 tonight and the Thunder still won ,67,1388,8875,10263,video
CompanyJ_72,Embiid put up 42 and 18 tonight ,32,499,3092,3591,photo
CompanyJ_73, Bring me The Brow ,19,3280,16713,19993,photo
CompanyJ_74,Today The champions vs the challengers ,39,173,1515,1688,photo
CompanyJ_75,The Steelers backed themselves into a no win situation again and now they have to trade AB ,91,568,3038,3606,photo
CompanyJ_76,Russ let the water cup know how he felt ,40,353,3354,3707,video
CompanyJ_77,DeAndre Hopkins pledges his playoff check to the family of Jazmine Barnes ,74,4894,21724,26618,photo
CompanyJ_78,The impossible ,15,159,1536,1695,photo
CompanyJ_79,Above the rim ,14,796,6796,7592,photo
CompanyJ_80,Brady Mahomes Luck Honey Badger isn t scared Tyrann Mathieu says there s no doubt the Texans can win the Super Bowl no matter who they face ,140,213,1028,1241,photo
CompanyJ_81,Danny Ainge on LeBron calling himself the GOAT Maybe he s taking the Donald Trump approach and trying to sell himself per 985TheSportsHub ,138,1566,6761,8327,photo
CompanyJ_82,Top 4 Western Conference All Star vote getters so far LeBron Steph D Rose Luka ,79,9914,48341,58255,photo
CompanyJ_83,Top 4 Eastern Conference All Star vote getters so far Giannis Kyrie Kawhi Embiid ,81,850,5056,5906,photo
CompanyJ_84,Rookie year Top 4 in Western Conference All Star votes ,55,1250,8733,9983,photo
CompanyJ_85,Theo Pinson couldn t believe AD s stat line ,44,549,3543,4092,video
CompanyJ_86,How did they not score via NBCSportsSoccer ,43,367,1769,2136,video
CompanyJ_87,Sergio Aguero with a DAGGER via NBCSportsSoccer ,48,428,1896,2324,video
CompanyJ_88,Some surprises in the West ,27,1074,5191,6265,photo
CompanyJ_89,Azzi Fudd the No 1 prospect in 2021 got her first scholarship offer in sixth grade She was one of the first young women ever invited to Steph Curry s SC30 Select Camp where she won the three point contest She also might be the next Maya Moore ,243,151,631,782,photo
CompanyJ_90,Brady playing WR in the playoffs via thecheckdown ,50,4211,27732,31943,video
CompanyJ_91,Hat trick vs Arsenal Equalizer vs Manchester City FIRMINO ,58,149,960,1109,photo
CompanyJ_92,Liverpool let their unbeaten streak slip to Manchester City Will they let the league slip too ,94,267,1107,1374,photo
CompanyJ_93,The Colts have some young stars on their O Line and it shows SimmsandLefkoe give Indianapolis this week s OLOTW award From B R x FordTrucks ,140,25,254,279,video
CompanyJ_94,Toronto s trade for the Klaw was a gamble when it happened Sitting atop the Eastern Conference and MVP caliber play from Kawhi it may be worth it after all ,156,76,738,814,photo
CompanyJ_95, I m coming back 100x harder amp for all the people who doubt me and hate on me keep on doing it Bol Bol to have season ending surgery on left foot and will begin rehab process for 2019 NBA draft per ShamsCharania ,214,310,1890,2200,photo
CompanyJ_96,3x Super Bowl champion 7x Pro Bowler Does Richard Seymour deserve your 2019 Pro Football Hall of Fame vote PFHOF19 FordTrucks ,126,71,538,609,video
CompanyJ_97,Danny Ainge chimes in ,22,699,3778,4477,photo
CompanyJ_98,The reigning MVP is on an absolute scoring tear Rockets vs Warriors tonight should be fun ,90,329,1950,2279,video
CompanyJ_99,Kawhi makes his return to San Antonio tonight ,46,676,4292,4968,photo
CompanyJ_100,Tony Gonzalez Champ Bailey Ed Reed and Isaac Bruce headline the 2019 Pro Football HOF finalists Full list ,106,389,1548,1937,photo
CompanyJ_101,The tribute video the Spurs really want to show ,48,1143,5422,6565,photo
CompanyJ_102,Spurs tribute video for Kawhi Leonard and Danny Green ,54,2373,11213,13586,video
CompanyJ_103,Kawhi gets booed on 1st bucket and Danny Green couldn t hold back a smile ,74,1539,7925,9464,video
CompanyJ_104,DeMar is ready for the Raptors ,31,1500,7407,8907,video
CompanyJ_105,MVP chants for DeMar after the and 1 ,37,677,4093,4770,video
CompanyJ_106,Pop does not look pleased ,26,953,6891,7844,photo
CompanyJ_107,Spurs fans start traitor chant while Kawhi shoots FT s ,55,4527,19895,24422,video
CompanyJ_108,Kawhi was tryna see what DeMar and Kyle Lowry were chatting about ,66,1877,13072,14949,video
CompanyJ_109,DeMar DeRozan had the last laugh in San Antonio ,48,926,4463,5389,photo
CompanyJ_110,Nothing but respect between Kawhi and Pop ,42,2254,13679,15933,video
CompanyJ_111,Top ranked UConn falls to No 8 Baylor 68 57 snapping 126 game regular season winning streak ,92,1049,4501,5550,photo
CompanyJ_112,Clint Capela from 15 feet KD wasn t feeling it NSFW ,52,952,6636,7588,video
CompanyJ_113,Kawhi s mom was not having it with this Spurs fan via DavidShitler ,67,2555,11888,14443,video
CompanyJ_114,KD with a ridiculous shot that barely doesn t count ,52,770,4452,5222,video
CompanyJ_115,Jamal Murray BIG TIME ,22,777,4516,5293,video
CompanyJ_116,This Harden step back on Klay ,30,1536,6993,8529,video
CompanyJ_117,Can t guard this Harden forces OT ,34,2594,11096,13690,video
CompanyJ_118,JAMES HARDEN BIG TIME ,22,1900,6585,8485,photo
CompanyJ_119,Was KD not out of bounds here ,30,6809,28444,35253,video
CompanyJ_120,JAMES HARDEN FOR THE WIN ,25,13614,38264,51878,video
CompanyJ_121,James Harden had words for Draymond right after the game winner ,64,11429,42649,54078,video
CompanyJ_122,Wait a minute CP3 ,18,950,6617,7567,link
CompanyJ_123,James Harden wants it ,22,2350,11202,13552,photo
CompanyJ_124,Beard finishes with another 40 point triple double and he gives all the credit to his teammates via NBA ,104,1858,12798,14656,video
CompanyJ_125,James Harden calling his repeat MVP right after the game ,57,3420,17963,21383,video
CompanyJ_126,Pop still has respect for Kawhi ,32,894,7561,8455,photo
CompanyJ_127,He holds the league record for career receptions and receiving yards by a TE Is Tony Gonzalez a first ballot Hall of Famer PFHOF19 From B R x FordTrucks ,153,46,438,484,video
CompanyJ_128,Even Messi s accidental goals are a thing of beauty via FCBarcelona ,68,414,3286,3700,video
CompanyJ_129,Raptors Spurs Bucks Week 12 NBA Power Rankings ,47,77,791,868,photo
CompanyJ_130,13 years since the 2006 Rose Bowl arguably the greatest CFB game of all time All 3 top Heisman candidates played Highest rated BCS game in TV history Vince Young 467 yards 3 TDs 0 TOs inc game winner with 19 left 62 players later appear in at least 1 NFL game ,260,3624,13109,16733,photo
CompanyJ_131,This angle of Harden s game winner via colinfraser IG ,54,3289,17314,20603,video
CompanyJ_132,QB Justin Fields is finalizing transfer from Georgia to Ohio State per YahooForde Fields was one of the country s most coveted transfers ,137,1293,4436,5729,photo
CompanyJ_133,2018 AP NFL All Pro First Team Offense QB Patrick Mahomes RB Todd Gurley WR DeAndre Hopkins Michael Thomas TE Travis Kelce Flex Tyreek Hill ,140,1752,8956,10708,photo
CompanyJ_134,Leighton Vander Esch s wolf hunting photo helped get him drafted in the first round by the Cowboys His team leading tackles are helping make him a star ,152,168,1006,1174,photo
CompanyJ_135,His reaction to meeting Messi and Luis Suarez is what it s all about via FCBarcelona ,85,438,3499,3937,video
CompanyJ_136,D Rose on getting the third most All Star votes in the West via JonKrawczynski I don t sell myself to people I don t have an Instagram It comes from me being in people s minds for some reason and people really caring ,217,10252,60359,70611,photo
CompanyJ_137,Club Dub was open for business 12x this season and Chicago is hoping it s not over yet ,87,1505,6998,8503,video
CompanyJ_138,Trevor Lawrence is only a freshman but scouts and coaches say he has the once in a generation talent to knock Alabama off its throne ,133,290,2119,2409,photo
CompanyJ_139,On this day in 2003 Michael Vick became the youngest QB ever to win a playoff game Will Lj_era8 break his record via NFLThrowback ,130,3749,15818,19567,video
CompanyJ_140,Jimmy Butler has aggressively challenged Sixers coach Brett Brown about his role in the offense per wojespn ,108,1613,7920,9533,photo
CompanyJ_141,D Rose reflects on the initial results of this year s All Star voting ,70,1243,7737,8980,photo
CompanyJ_142, ChrisJohnson28 shared an epic story on one of the times LenDale White was late to a Titans meeting Watch the full interview via SimmsAndLefkoe ,144,57,374,431,video
CompanyJ_143,All his boys were hype via dawwkins Instagram ,46,5867,29232,35099,video
CompanyJ_144, Won 9 of 10 5th in PPG Career year for Luck This offense makes the Colts dangerous HULU ,89,143,785,928,video
CompanyJ_145,An absolute MISSILE from 40 plus via victorrada10 IG ,53,394,2836,3230,video
CompanyJ_146, I d kill him Giannis on if he could beat TheRock in a wrestling match via Bucks ,81,900,6651,7551,video
CompanyJ_147,Kuz trying to get some more foul calls via kylekuzma ,53,3418,21384,24802,photo
CompanyJ_148,Luka steps back from everywhere via dallasmavs ,47,596,4179,4775,video
CompanyJ_149,Go ahead DIPO ,14,195,1518,1713,video
CompanyJ_150,Giannis wants to go 1 on 1 with The Great One ,46,900,6419,7319,photo
CompanyJ_151,Grizzlies turned Bird Box into a game for courtside seats ,58,307,1759,2066,video
CompanyJ_152,Luka right before the half via NBA ,35,3205,19039,22244,video
CompanyJ_153,This ref wasn t having it with Brogdon ,39,225,2365,2590,video
CompanyJ_154,Dominating the first week of 2019 like Via nbagleague ,54,224,1452,1676,video
CompanyJ_155,LAVINE FROM DEEP TO FORCE OT ,29,671,3842,4513,video
CompanyJ_156,Everyone at TD Garden wanted Dirk to hit a 3 but he fell just short ,68,2711,17680,20391,video
CompanyJ_157,Kris Dunn on a big man Wow ,27,489,2519,3008,video
CompanyJ_158,DIPO CALLED GAME ,17,1774,7677,9451,video
CompanyJ_159,If only this LaVine shot counted ,33,1027,6042,7069,video
CompanyJ_160,The Bulls Pacers ending was WILD ,33,764,3700,4464,video
CompanyJ_161,Collison bringing the flop back in 2019 ,40,383,2587,2970,video
CompanyJ_162,Luka signed a pair of shoes and gave them away to a young fan brkicks via jack_shuster IG ,90,697,9152,9849,video
CompanyJ_163,KCP nearly jumps into Lakers owner Jeanie Buss while chasing after ball ,72,155,1722,1877,video
CompanyJ_164,Lakers fall to 1 4 without The King ,36,1736,9282,11018,photo
CompanyJ_165,Steelers to consider trades for Antonio Brown before start of free agency will ask for a lot per RapSheet ,106,1503,8136,9639,photo
CompanyJ_166,Triple Double for Kyle Anderson 17 assists for Kris Dunn Don t ,63,432,3574,4006,photo
CompanyJ_167,The journey to Atlanta starts today NFLPlayoffs TurboTax ,57,94,593,687,video
CompanyJ_168,Oblak was not having it from AntoGriezmann via Atleti ,54,277,2433,2710,video
CompanyJ_169,He went behind the back in a high school game via wdbj7 IG ,59,5200,26484,31684,video
CompanyJ_170,LaMelo and SPIRE brought the show to Kentucky last night ,57,981,5964,6945,video
CompanyJ_171,With two games slated for Wildcard Saturday AdamLefkoe has the offense deciding these matchups ,95,40,303,343,video
CompanyJ_172, FAKE FIELD GOAL TD via NCAA_FCS ,33,310,2210,2520,video
CompanyJ_173,Lavar warming up to play MJ ,28,10405,48253,58658,video
CompanyJ_174,He really kicked it for a strike via gavin wilsonn Instagram ,61,1032,7822,8854,video
CompanyJ_175,Andrew Luck and JJ Watt missed the entirety of the 2017 season Their returns helped lead the Colts and Texans to the Wildcard Both comebacks historic but now only one of them can move on ,187,527,4219,4746,photo
CompanyJ_176,Kira Lewis is too young to be this kinda problem ,49,499,2719,3218,video
CompanyJ_177,Uber driver was talking smack about the Chargers to their RB Melvin Gordon Via Chargers ,88,17380,69203,86583,video
CompanyJ_178,Jake is a high school wrestler with a physical disability This week a senior wrestler volunteered to a match with him and the result is incredible via brookemcgriff16 dillon_keane ,180,1943,9680,11623,video
CompanyJ_179,Houston s No 1 hypeman via thecheckdown ,40,732,3681,4413,link
CompanyJ_180,3 defenders No problem for TYHilton13 via NFL ,46,435,2727,3162,photo
CompanyJ_181,OBJ catching passes from a new QB ,34,2866,18409,21275,video
CompanyJ_182,JJ SWATT sighting via NFL ,26,192,1761,1953,photo
CompanyJ_183,Marvin Williams on the breakaway and Shaqtin ,45,407,2736,3143,video
CompanyJ_184,ALL INDY Luck 2 TDs and the Colts jump to 21 0 halftime lead vs Texans ,71,380,2454,2834,photo
CompanyJ_185,Miles Bridges Windmill ,23,654,4245,4899,video
CompanyJ_186,Odell s calling his shot ,25,1330,10360,11690,photo
CompanyJ_187,Down go the Jayhawks Iowa State takes down No 5 Kansas 77 60 ,61,828,4597,5425,photo
CompanyJ_188,One year ago today Melo gave us one of the greatest interviews ever NSFW ,73,10962,44472,55434,video
CompanyJ_189,Kemba finishing package ,24,399,2498,2897,video
CompanyJ_190,Luck and the Colts punch the Texans out of the playoffs ,56,2335,7947,10282,video
CompanyJ_191, BEAT THE TRAFFIC This Colts fan in Houston was letting everyone have it via DEExGUILL ,87,3893,13982,17875,video
CompanyJ_192, ,1,919,5558,6477,photo
CompanyJ_193,Luka checked in with a cameraman after bad collision ,53,1864,17607,19471,video
CompanyJ_194,There s a pigeon flying around during the Spurs game Somebody call Manu ,72,565,3842,4407,video
CompanyJ_195,The Bucks arena played Kawhi s laugh after Raptors turnover ,60,13949,53487,67436,video
CompanyJ_196,Zion went 360 via CBSSports ,28,9641,33971,43612,video
CompanyJ_197,Zion s 360 dunk had Cameron Indoor Stadium LIVE via alee923 IG ,63,8892,38033,46925,video
CompanyJ_198,Spida iced the game then appeared to tell Andre Drummond You did this This is your fault Cold blooded h t VinceGoodwill ,120,2071,10966,13037,video
CompanyJ_199,Russ to Doug on 4th down CLUTCH via NFL ,40,789,4333,5122,photo
CompanyJ_200,Someone get Joel a straw for his apple juice via NBCSPhilly ,60,417,3526,3943,video
CompanyJ_201,Dak PICKED in the end zone K J Wright via NFL ,46,365,2736,3101,photo
CompanyJ_202,KD s face when the announcer said infectious disease They played Bleeding Love too ,83,2329,13123,15452,video
CompanyJ_203,Dak rushes for the 1st down BIG TIME via NFL ,45,1552,5375,6927,photo
CompanyJ_204,Dak powers the Cowboys to a win over the Seahawks ,50,2044,5765,7809,video
CompanyJ_205,JaMychal Green yells Man I hate this dude after getting called for a foul on LaMarcus Aldridge ,95,1200,8291,9491,video
CompanyJ_206,Dak 226 yards 2 TD Zeke 169 yards TD Coop 7 catches 106 yards The young stars showed up in their first playoff win ,115,3075,10724,13799,photo
CompanyJ_207,Embiid wants Simmons to shoot ,30,468,3894,4362,photo
CompanyJ_208,Playoff Dak in full effect ,27,1185,4697,5882,photo
CompanyJ_209,Steph tried Harden s step back and got called for a travel ,59,7919,36536,44455,video
CompanyJ_210,Stephen Curry has passed Kyle Korver for the fourth most threes in NBA history ,79,1737,11071,12808,photo
CompanyJ_211,Steph splashed 10 triples as the Warriors and Kings set the all time record for threes in a game 41 ,100,1200,6635,7835,video
CompanyJ_212,Bears have been dominant but AdamLefkoe got Playoff Nick Foles making magic happen to end Wild Card Weekend ,108,44,298,342,video
CompanyJ_213,Steph thinks he might ve gotten away with the double step back if he was somebody different via anthonyVslater ,111,2452,14844,17296,video
CompanyJ_214,Young Flash Zaire Wade s game is too smooth ,44,1827,9313,11140,video
CompanyJ_215,This young fan wrote Cowboys WR Allen Hurns a letter after his devastating injury vs Seattle via SlaterNFL mcswainkl ,117,1097,6988,8085,photo
CompanyJ_216,Lamar Jackson becomes the youngest QB ever to start a playoff game while this could be Philip Rivers last chance at a Super Bowl run Who you got the rookie or the vet ,167,444,4208,4652,photo
CompanyJ_217,LaMelo and SPIRE are must see entertainment ,44,1223,6772,7995,video
CompanyJ_218,Curry thought he could get away with it ,40,2225,9818,12043,video
CompanyJ_219,That uncle who s been talking about the Cowboys championship run since 96 via cynthiaokk ,89,8426,29266,37692,video
CompanyJ_220,The Ravens are losing by the biggest deficit 12 0 since Lamar took over as QB Jackson 2 8 17 yards INT ,103,265,1733,1998,photo
CompanyJ_221, I m here when you need me ,27,1236,7559,8795,photo
CompanyJ_222,Waiting to get called in like ,30,599,3402,4001,photo
CompanyJ_223,100 years from now Rivers and Gates will still be making plays Unreal connection via Chargers ,94,452,3445,3897,photo
CompanyJ_224,From fumble to Ravens touchdown to Chargers touchdown ,54,279,1783,2062,photo
CompanyJ_225,Not even the Ravens coaches are catching today via thecheckdown ,64,762,4617,5379,photo
CompanyJ_226, When you go through life everything s not gonna be perfect D Rose speaks to a young fan with Leukemia pregame via Timberwolves ,128,12903,50109,63012,video
CompanyJ_227,LAMAR via NFL ,14,2153,12053,14206,photo
CompanyJ_228,Lamar and King Crab keeping the Ravens alive via thecheckdown ,62,260,1658,1918,photo
CompanyJ_229,Philip Rivers and the Chargers fry the Ravens 23 17 ,52,1184,4475,5659,video
CompanyJ_230,Golden Tate was not letting go of that ball via thecheckdown ,61,549,4611,5160,video
CompanyJ_231,Coach Harbaugh let Lamar work through the growing pains ,56,864,4469,5333,photo
CompanyJ_232,D Wade and Vince warming up two hours before game time Nobody else is out here via BenStinar ,93,992,7291,8283,video
CompanyJ_233,D Wade s no look pass to DJJ ,29,2658,11614,14272,video
CompanyJ_234,Breaking Timberwolves have fired Tom Thibodeau per ShamsCharania and JonKrawczynski ,84,1317,4410,5727,photo
CompanyJ_235, But we just blew out the Lakers ,33,785,5315,6100,photo
CompanyJ_236,NICK FOLES ,11,1093,4063,5156,photo
CompanyJ_237,Foles finds Tate CLUTCH via thecheckdown ,41,702,3012,3714,video
CompanyJ_238,What a throw Mtrubisky10 via NFL ,33,101,921,1022,photo
CompanyJ_239,HE MISSED THE KICK ,19,2975,13520,16495,status
CompanyJ_240,Playoff Foles keeps the Eagles season alive ,44,4012,11139,15151,video
CompanyJ_241,All of Chicago ,15,13651,43040,56691,photo
CompanyJ_242,Cody Parkey s potential game winning FG hits crossbar twice as Eagles advance to Divisional Round via NFL ,106,2244,8477,10721,photo
CompanyJ_243,Can t wait for the Divisional Round ,36,1177,3924,5101,photo
CompanyJ_244,Coach Thibs time in Minnesota is up ,36,182,1163,1345,video
CompanyJ_245,D Wade x Trae Young jersey exchange via NBA ,44,765,6618,7383,video
CompanyJ_246,Gilbert Arenas was one of the coldest in the game at the height of his powers Agent Zero turns 37 today ,104,5818,25289,31107,video
CompanyJ_247,Millidelphia ,13,833,4812,5645,photo
CompanyJ_248,More accomplishments for Flash OneLastDance ,44,1687,6150,7837,photo
CompanyJ_249,The real reason Cody Parkey missed the kick via jaydotnice IG ,62,20917,82180,103097,video
CompanyJ_250,Crawford still got it ,22,987,6879,7866,video
CompanyJ_251,Beasley told the ref he wanted to fight KAT then the ref gave KAT a tech ,73,3697,20322,24019,video
CompanyJ_252,It appears Cody Parkey s final kick was actually tipped by Treyvon Hester ,74,1926,8044,9970,photo
CompanyJ_253,Kemba dropped 18 points in the last 6 minutes of the game ,58,1058,6367,7425,video
CompanyJ_254,This angle of the Bears field goal hitting both posts via aj_shaba95 IG ,72,1821,11424,13245,video
CompanyJ_255, 30 40 NFL players One of the best QB prospects ever An underdog that KNOWS it can win The third title fight between Alabama and Clemson might be the best one yet ,163,172,1007,1179,photo
CompanyJ_256,Pogba with a touching message to a 14 year old Juventus youth player who is back on the field after beating cancer via paulpogba ,129,164,1520,1684,video
CompanyJ_257,On this day in 1972 the Lakers defeated the Atlanta Hawks for their 33rd straight win It is still the longest win streak in major professional sports ,150,657,4076,4733,photo
CompanyJ_258,The Mamba offers his words of wisdom even though he s an Eagles fan ,68,1226,9998,11224,photo
CompanyJ_259,Could Trevor Lawrence be the best NFL prospect ever ,52,840,5707,6547,photo
CompanyJ_260,True love via TeamJuJu ,23,668,6208,6876,video
CompanyJ_261,The legendary tonyhawk breaks down some of his best moves via SkateJam ,71,317,1629,1946,video
CompanyJ_262,The NFL officially changes Cody Parkey s missed field goal to a blocked kick by Treyvon Hester via Eagles ,106,2643,11623,14266,photo
CompanyJ_263,Neymar loves a trip to the barber ,34,486,4046,4532,photo
CompanyJ_264,Derrick Rose to people who believe he can t keep playing at his current level without Thibs Kill yourself via malika_andrews ,125,8697,34889,43586,video
CompanyJ_265,Ohio State s Dwayne Haskins declares for the 2019 NFL Draft Potential 1st QB off the board ,91,1422,9569,10991,photo
CompanyJ_266,18 year old American Tim Weah has joined Celtic on loan from PSG for the rest of the season ,92,157,1466,1623,photo
CompanyJ_267,Lamar Jackson turns 22 today with an incredible resume 51 TDs in a college season Youngest Heisman winner ever 6 2 in the NFL as 32nd pick Last rookie QB standing Youngest playoff starter ever ,193,2986,15382,18368,photo
CompanyJ_268,Everyone wants to dance like Lance ,35,1719,8636,10355,video
CompanyJ_269,Clemson covered as underdogs the last two times they faced Bama for the title br_betting ,89,67,532,599,photo
CompanyJ_270, StephenCurry30 had these high school basketball teams hype after surprising them with 250 pairs of the Curry 6 New episode of Sneaker Shock ,141,128,684,812,video
CompanyJ_271,Alabama vs Clemson rematch is a showcase of future NFL talent nfldraftscout ,76,140,1046,1186,video
CompanyJ_272,Packers to hire Titans OC Matt LaFleur as next head coach per RapSheet ,71,535,2858,3393,photo
CompanyJ_273,DeMar and Coach Casey reunite via NBA ,38,2310,20313,22623,video
CompanyJ_274,Julio Jones coaching Bama WR Jerry Jeudy pregame via SECNetwork ,64,1384,9566,10950,video
CompanyJ_275, BAMA CLEMSON Here we go NationalChampionship ,46,929,4236,5165,photo
CompanyJ_276,PICK 6 TO START US OFF NationalChampionship ,44,593,2795,3388,photo
CompanyJ_277,62 yard dime from Tua This is fun NationalChampionship ,55,434,2179,2613,photo
CompanyJ_278,THIS GAME 21 PTS in less than 5 mins NationalChampionship ,58,721,3626,4347,photo
CompanyJ_279,Fan gets removed by police after storming the field via MartySmithESPN ,71,913,4015,4928,video
CompanyJ_280,Ruled just short NationalChampionship ,38,49,581,630,link
CompanyJ_281,The Brow breaks out the Shammgod ,33,2610,12486,15096,video
CompanyJ_282,HARDEN DROPPED HIM ,19,26268,73690,99958,video
CompanyJ_283, Remember Jalen last year Keep throwing picks and that s about to be you NationalChampionship ,94,1853,6566,8419,photo
CompanyJ_284,Dirk s pump fake is timeless ,29,1234,8463,9697,video
CompanyJ_285,Luka meet fans Fans meet Luka ,30,230,2922,3152,video
CompanyJ_286,Jalen Hurts walking into the locker room at the half NationalChampionship ,74,1377,5827,7204,photo
CompanyJ_287,Every team needs a vet like Al Horford ,39,806,6904,7710,video
CompanyJ_288, NationalChampionship ,22,610,3507,4117,photo
CompanyJ_289,Another Luka step back Another victim ,38,2872,13524,16396,video
CompanyJ_290,The real reason Bama s down 21 NationalChampionship ,52,12209,37295,49504,photo
CompanyJ_291,Trevor Lawrence is now 14 23 for 275 passing yards and 2 TDs NationalChampionship ,82,519,3218,3737,photo
CompanyJ_292,Kuz had Luka jumping ,21,1021,5470,6491,video
CompanyJ_293,ROSSED NationalChampionship ,28,3059,11030,14089,photo
CompanyJ_294,Is Bama gonna make a comeback ,30,13482,45711,59193,video
CompanyJ_295,Jalen has checked into the game NationalChampionship ,53,245,2856,3101,photo
CompanyJ_296, Well ,6,904,8717,9621,link
CompanyJ_297,Fox told Vucevic not to jump with him ,38,1930,8039,9969,video
CompanyJ_298,Clemson adds its 2nd title to the Dabo Era NationalChampionship ,64,1629,6686,8315,photo
CompanyJ_299,There s a new dynasty in college football ,42,4698,19268,23966,video
CompanyJ_300,SUNSHINE via ClemsonFB ,23,3436,18977,22413,video
CompanyJ_301,Clemson has Bama s number ,26,992,4987,5979,photo
CompanyJ_302,Didn t play like freshmen tonight ,34,1039,9591,10630,photo
CompanyJ_303,That Natty feeling Enjoy it Clemson fans via LouatTheState ,59,273,1848,2121,video
CompanyJ_304,Champions NationalChampionship ,31,719,5096,5815,photo
CompanyJ_305,20 32 347 passing yards 3 passing touchdowns Trevor Lawrence left Clemson fans starstruck ,90,2013,11573,13586,video
CompanyJ_306,Before last night Alabama s biggest loss under Nick Saban was 14 points Clemson beat them by 28 ,96,660,7029,7689,photo
CompanyJ_307,Career high for Capela He s been EATING ,40,313,2806,3119,photo
CompanyJ_308,Mbappe staying humble ,22,963,8984,9947,photo
CompanyJ_309,Which Harden ankle breaker was better ,38,3170,14340,17510,video
CompanyJ_310,They BOTH have blindfolds on BirdBoxChallenge via alan_anaya15 ,63,366,1925,2291,video
CompanyJ_311,8 years ago today Marshawn Lynch s Beast Quake one of the greatest runs ever via nflthrowback ,94,9297,37267,46564,video
CompanyJ_312,Jason Smith couldn t believe his eyes ,38,2853,21095,23948,video
CompanyJ_313,Are the Cavs stuck with Kevin Love NBA execs discuss his trade value if he has much at all How many teams are really looking for a dinosaur face up 4 man ,154,76,786,862,photo
CompanyJ_314,Trevor wants to fill up the trophy case ,40,274,3117,3391,photo
CompanyJ_315,Beard s so nonchalant with the ankles he snatches now It kinda caught me off guard a little bit how far Jamal Murray fell via KellyIkoNBA ,138,707,4464,5171,video
CompanyJ_316,Jayson Tatum reportedly told Celtics radio announcer Cedric Maxwell I d trade me too for Anthony Davis ,103,793,6196,6989,photo
CompanyJ_317,Arizona Cardinals are hiring USC OC Kliff Kingsbury as their next head coach per PSchrags ,90,2407,8564,10971,photo
CompanyJ_318,In under two months Kliff Kingsbury has been Fired as Texas Tech head coach Nov 26 Hired as USC OC Dec 5 Hired by Arizona Cardinals as head coach Jan 8 ,152,1496,7489,8985,photo
CompanyJ_319,From the sidelines to the gridiron Mimi Britt swapped the pom poms for a football and became the first girl in her school s history to score a TD ,146,489,1943,2432,video
CompanyJ_320,The Tampa Bay Buccaneers are finalizing a deal to make Bruce Arians their new head coach per AdamSchefter ,106,434,2597,3031,photo
CompanyJ_321,Kliff Kingsbury to USC once NFL teams started calling ,54,745,4938,5683,video
CompanyJ_322,7 years ago today Tim Tebow threw for a career high 316 yards 2 TDs and led the Broncos to a 29 23 OT playoff win over Big Ben and the Steelers ,144,3160,15657,18817,photo
CompanyJ_323,Zion is dunking everything ,27,1098,8871,9969,video
CompanyJ_324,Where does Embiid s skill set rank among big men ,49,272,2368,2640,photo
CompanyJ_325,Tonight could be Vince Carter s last trip to Toronto Never forget his 7 years up North 5x All Star 1999 Rookie of the Year Helped the Raptors to their first ever playoff appearance in 2000 Threw down arguably the most memorable jam ever in the 2000 Dunk Contest ,262,1458,6520,7978,photo
CompanyJ_326,The top playoff seeds spent the bye week trying to not freak out GridironHeights playstation ,93,1887,6506,8393,video
CompanyJ_327,Raptors fans give Vince a standing ovation when he checks in and he nails a three ,82,3575,22863,26438,video
CompanyJ_328,Not a bad night for Zion 30 points 10 boards 5 assists 4 steals First Duke freshman in history to record 30 10 5 ,113,2087,10956,13043,photo
CompanyJ_329,RJ Barrett s step back is too smooth via theACCDN ,50,369,1985,2354,video
CompanyJ_330,Sixers rookie Landry Shamet hit 8 threes tonight so Embiid had to check his temperature ,88,1835,11628,13463,video
CompanyJ_331,Boogie plans to make his season debut against the Clippers on Jan 18 ,69,1105,5686,6791,link
CompanyJ_332,360 via CBBonFOX ,17,110,1076,1186,video
CompanyJ_333,JoJo took this kid s seat but he made it up to him via frankmurphy2009 ,71,407,3962,4369,video
CompanyJ_334,Prayers up for Nerlens Noel The Thunder big man caught an elbow hit his head and had to be stretchered off ,107,6623,31597,38220,video
CompanyJ_335,Joker FTW ,10,310,2359,2669,video
CompanyJ_336,Jamal s reaction to a fan running on the court ,47,1051,6821,7872,video
CompanyJ_337,Fox HUSTLE ,11,441,2894,3335,video
CompanyJ_338,Russ went for the win twice ,28,2296,16297,18593,video
CompanyJ_339,32 year old Ryan Saunders son of the late Flip Saunders became the Timberwolves interim head coach after Thibs was fired on Sunday Tonight he won his first game ,161,4672,38038,42710,video
CompanyJ_340,What a game for Wiggins 40 PTS 10 REBS 4 ASTS ,46,416,3307,3723,video
CompanyJ_341,For Flip via Timberwolves ,26,478,3883,4361,video
CompanyJ_342,Fox hit em with the ,20,591,6105,6696,video
CompanyJ_343,Kelly Oubre with the putback dagger ,36,666,4486,5152,video
CompanyJ_344,Manny Pacquiao and Floyd Mayweather meet again via LAClippers ,62,1913,10660,12573,video
CompanyJ_345,You good Klay ,14,703,5082,5785,video
CompanyJ_346,Mudiay knew what he did ,24,424,3951,4375,video
CompanyJ_347,The NFL and NFLPA release statement saying there s no evidence Eric Reid was targeted that his tests were randomly generated ,125,928,4162,5090,link
CompanyJ_348,They re using the Royals stadium to play Mario Kart via TomKCTV5 ,65,3129,18564,21693,video
CompanyJ_349,Klay Thompson last night 43 PTS Shot 18 for 29 Seven 3 s Took ONLY FOUR dribbles ,81,4290,27791,32081,photo
CompanyJ_350,This extreme bike course includes a 780 foot drop from 3 606 feet via redbull Redbullbike ,90,110,643,753,video
CompanyJ_351,This whole play via mpatathletics ,34,1010,6231,7241,video
CompanyJ_352,Catch and shoot at its best ,28,2363,15591,17954,photo
CompanyJ_353,Draymond is making sure young guys don t break the NBA s No 1 sneaker rule If you re out there playing against Harden in his shoe he s got you dominated already Inside the league s hidden sneaker politics ,205,213,1389,1602,photo
CompanyJ_354,Kyler Murray is reportedly leaning toward entering the 2019 NFL Draft Details on this week s sticktofootball ,109,2310,9490,11800,photo
CompanyJ_355,The best pre game routine in the NHL via PKSubban1 ,51,536,4652,5188,video
CompanyJ_356,High five via Instagram billybjork lukas_idcaye grabrahamson ,61,824,4289,5113,video
CompanyJ_357,Nerlens Noel who suffered a concussion in Tuesday night s game has been released from the hospital and placed in NBA s concussion protocol ,139,435,4019,4454,photo
CompanyJ_358,Manchester City s last two games 9 0 7 0 ,41,267,2209,2476,photo
CompanyJ_359,Steph Curry is launching an Underrated Tour to find overlooked high school prospects Curry was a 3 star recruit ranked 256th overall in the 2006 class ,151,2828,13516,16344,photo
CompanyJ_360,Pat McCaw plans to sign a deal with the Raptors per wojespn ,60,338,2773,3111,photo
CompanyJ_361,Where will Jalen Hurts land via br_betting ,43,616,3393,4009,photo
CompanyJ_362,This is just silly from Tatum ,30,2631,13521,16152,video
CompanyJ_363,Bucks vs Rockets tonight Who has the better MVP case ,53,129,1366,1495,photo
CompanyJ_364,This sequence is Ben Simmons game in a nutshell ,48,1379,9756,11135,video
CompanyJ_365,The New York Jets are expected to hire former Dolphins HC Adam Gase as their new head coach per AdamSchefter ,109,219,1040,1259,photo
CompanyJ_366,This Steelers Super Bowl XLIII hero knew they were going to win so he snuck his video camera onto the field at halftime Watch a new SimmsandLefkoe The Show ,156,288,1403,1691,video
CompanyJ_367, WashWizards this kid needs a contract via NBA ,47,856,5419,6275,video
CompanyJ_368,Vince Carter took an elbow to the face and was heated ,54,578,3345,3923,video
CompanyJ_369,You simply cannot score on AD ,30,2093,10777,12870,video
CompanyJ_370,Luka getting fouled on the stepback now Still won t miss it ,60,1374,8305,9679,video
CompanyJ_371,Beard Unguardable via NBA ,26,1569,7875,9444,video
CompanyJ_372,AD is actually a point guard ,29,588,3825,4413,video
CompanyJ_373,Oubre slapped the floor then got scored on by Luka ,51,7751,45467,53218,video
CompanyJ_374,The Beard has been on a tear lately ,36,839,4175,5014,photo
CompanyJ_375,The mascots are on one tonight ,31,326,1799,2125,video
CompanyJ_376,Oakland A s expect Kyler Murray to declare for the NFL Draft per susanslusser ,78,2931,10474,13405,photo
CompanyJ_377,The only way to stop Harden ,28,2287,10782,13069,video
CompanyJ_378,Greek Freak and the Bucks pick up the win 27 PTS 21 REBS 5 ASTS ,64,455,3068,3523,video
CompanyJ_379,Who did it better Harden or Doncic ,35,212,1897,2109,video
CompanyJ_380,Zo on both ends via Lakers ,27,5558,27826,33384,video
CompanyJ_381,Dame switched mid air ,22,1110,5773,6883,video
CompanyJ_382,Harden is never trying to hear Sicko Mode again ,48,2634,9138,11772,video
CompanyJ_383,Relax buddy ,12,242,2708,2950,video
CompanyJ_384,New career high 41 PTS for Kuz Still a full quarter to play via NBA ,68,2682,15566,18248,video
CompanyJ_385,Kuz got all the buckets tonight 4 1 in 3 quarters ,50,1921,8829,10750,video
CompanyJ_386,Kyle Kuzma couldn t be stopped tonight ,39,1641,8108,9749,photo
CompanyJ_387,These fans traveled from Pakistan to see Giannis and all they wanted was photo proof of how huge his hands are via Bucks ,121,3812,34705,38517,video
CompanyJ_388,Blake Griffin recorded zero rebounds against the Lakers on Wednesday It was the first time in his 567 game career ,114,1198,10347,11545,photo
CompanyJ_389,Raheem Sterling wrote a letter to Ethan Ross a young Manchester City fan whose grandmother reached out to Sterling after her grandson suffered racial abuse via brfootball ,171,738,3123,3861,photo
CompanyJ_390,Colin Kaepernick should be on an NFL roster according to 95 of players surveyed ,80,4403,17233,21636,photo
CompanyJ_391,Lakers players shared their most common celebrity look alike can t unsee ,73,6429,27264,33693,video
CompanyJ_392,The Rams have Gurley Goff and McVay but Robert Woods might be the key to their playoff success I m probably the most complete receiver in the NFL ,146,187,1774,1961,photo
CompanyJ_393,Harden on if he saw Giannis passing the ball ahead of time Hell no That s t hurt via jessec1ark ,96,3987,25461,29448,video
CompanyJ_394,NBA All Star Fan Voting Update Wade D Rose among starters LeBron Giannis still leading ,87,760,4220,4980,photo
CompanyJ_395,Have the Cardinals found the next Sean McVay in Kliff Kingsbury ,64,338,3313,3651,video
CompanyJ_396,Boogie will start at center immediately for the Warriors when he returns on Jan 18 ,83,2374,13901,16275,photo
CompanyJ_397,Steelers owner says it would be hard to envision AB being on the team when training camp comes around in July per gerrydulac ,125,760,3772,4532,photo
CompanyJ_398,At least he was honest ,23,958,8133,9091,photo
CompanyJ_399,Kyrie didn t stand a chance ,28,3482,16158,19640,video
CompanyJ_400,3 time Grand Slam winner and British tennis great Andy Murray plans to retire at Wimbledon this year ,101,541,2154,2695,photo
CompanyJ_401,The disrespect Ovechkin threw him right into the bench via Capitals ,68,1069,4964,6033,photo
CompanyJ_402,Smart met Bam AT THE RIM ,25,590,3503,4093,video
CompanyJ_403,Tarik Cohen tried it but then ended up getting mixed by a fan at the gym via z_aiamerza2 nathan_mihulet ,104,1782,8826,10608,video
CompanyJ_404,The Miami Heat bench couldn t believe Tyler Johnson s tongue injury ,68,168,1499,1667,video
CompanyJ_405,D Wade x Terry Rozier jersey swap ,34,891,7426,8317,video
CompanyJ_406,DeMar DeRozan went reverse on OKC ,34,605,3699,4304,video
CompanyJ_407, Basketball grew me Andre Ingram on how basketball changed his life via SouthBayLakers ,87,872,4810,5682,video
CompanyJ_408,Jaylen Brown and Marcus Morris had to get separated during a timeout via ahubbtho IG ,85,4794,22708,27502,video
CompanyJ_409,SWIPA D ,8,678,4687,5365,video
CompanyJ_410,Jokic with a full court one handed DIME ,40,1825,13458,15283,video
CompanyJ_411,JA MORANT WENT VINCE ON EM via MSURacers ,41,2259,7516,9775,video
CompanyJ_412,Spurs hit 14 straight threes against the Thunder ,49,2558,10095,12653,video
CompanyJ_413,Ferguson 3 White answer What a 4Q ,34,438,2897,3335,video
CompanyJ_414,LMA 49 PTS 6 REB 3 BLK RUSS 24 PTS 13 REB 24 AST DOUBLE OT here we come ,72,1541,9785,11326,photo
CompanyJ_415,50 BURGER ,10,305,2084,2389,photo
CompanyJ_416,Did PG warrant a technical here in 2OT ,39,1515,13441,14956,video
CompanyJ_417,WHAT A BLOCK BY WHITE ,22,534,2756,3290,video
CompanyJ_418,Final score Spurs 154 Thunder 147 in double OT SA hit 14 straight 3 s to start the game Four OKC players drop 20 PTS LMA goes for a 50 piece Brodie records 24 PTS and 24 AST Game of the year ,191,3895,16623,20518,photo
CompanyJ_419,LaMarcus Aldridge dropped a career high 56 PTS in 2OT win over the Thunder ,75,951,5487,6438,video
CompanyJ_420,LMA with a career high 56 in the win over the Thunder ,54,964,7422,8386,photo
CompanyJ_421,Spurs shooting from three last night Most consecutive made to start a game 14 in 20 years Highest 3 point percentage by any team with 15 attempts 84 2 ,151,556,4187,4743,photo
CompanyJ_422,3 years ago today Messi became the first player ever to win five Ballons d Or ,78,236,1956,2192,photo
CompanyJ_423,Front row seats to the poster via Frankie_Vision ,49,565,3281,3846,video
CompanyJ_424,Drew Brees is the NFL s all time passing leader but never gets included in the GOAT conversation Is he the most underrated QB in history ,137,5834,22351,28185,video
CompanyJ_425,The Sixers are retiring the late Moses Malone s number 3x MVP 1983 Finals MVP 13x All Star 9th in points 1st in off rebounds 3rd in total rebounds One of the NBA ABA s most underrated icons ,190,2138,13514,15652,photo
CompanyJ_426,In 2001 Randy Moss wore custom Jordan 11s in the Divisional Round of the playoffs brkicks 2 catches 121 yards 2 TD via NFLThrowback ,132,6958,31412,38370,video
CompanyJ_427,Gasol wanted no part of Noah s dap h t JohnMartin929 ,53,346,2635,2981,video
CompanyJ_428,The Saints had one of the worst defenses of all time from 2012 to 2016 Players tell us how New Orleans built a defensive juggernaut to match its explosive offense ,163,264,1469,1733,photo
CompanyJ_429,FSU coach Leonard Hamilton on Zion The most phenomenal talent in the ACC since Michael Jordan via Warchant Michael Jordan college stats 17 7 PPG 5 0 RPG 1 8 APG 1 7 SPG in 30 8 MPG Zion Williamson so far 20 9 PPG 9 5 RPG 2 4 APG 2 2 SPG 1 9 BPG in 26 3 MPG ,257,1101,5333,6434,photo
CompanyJ_430,Zeke led the NFL in rushing yards this season 1 434 but will it be enough to get past the Rams From B R x Hulu ,111,103,661,764,video
CompanyJ_431,Terry Rozier grew up idolizing D Wade Last night they swapped jerseys ,70,1675,11203,12878,photo
CompanyJ_432,They put Shaq in the GlassMovie trailer ,40,1699,5014,6713,video
CompanyJ_433,Steph is only a few shots away from the third most threes ever He s on pace to destroy the record books ,104,1124,5605,6729,video
CompanyJ_434,Luka is clearly the best rookie right now HowardBeck cautions not to judge this class too early ,96,428,2864,3292,video
CompanyJ_435,Kobe called Tony Allen the best defender he ever faced and said he never ONCE asked for help Happy 37th to The Grindfather ,123,4314,26854,31168,photo
CompanyJ_436,Bill Belichick wins when it matters the most From B R x hulu ,61,128,876,1004,video
CompanyJ_437,Kevin Hart trying to get handles like CP3 via dribble2much IG ,62,3592,20515,24107,video
CompanyJ_438,Bron recovering in an oxygen chamber This man is dedicated ,59,2607,17416,20023,video
CompanyJ_439,No one was more hyped to get a 22wiggins jersey on XMas Wiggins made sure to meet her before the game via Timberwolves ,119,507,4371,4878,video
CompanyJ_440,Kawhi is an automatic bucket goes for 3 straight in less than a minute ,71,436,3159,3595,video
CompanyJ_441,Dipo dunked on Hezonja like he wasn t there via NBA ,52,1114,7464,8578,video
CompanyJ_442,Cam knows from experience ,26,2256,9312,11568,photo
CompanyJ_443,Simmons shot is dropping on the regular now ,44,459,3588,4047,video
CompanyJ_444,KAT added a lil extra got Dirk heated ,38,265,2670,2935,video
CompanyJ_445,TJ tried helping Jimmy after he got elbowed Butler wasn t having it ,68,565,3955,4520,video
CompanyJ_446, Oh my god Did Kawhi actually feel something ,45,1316,8872,10188,video
CompanyJ_447,Sabonis POSTER Oh my via NBA ,29,338,2673,3011,video
CompanyJ_448,Harden warming up the tricky steps ,35,88,751,839,video
CompanyJ_449,Harden had Osman hypnotized ,28,862,4189,5051,video
CompanyJ_450,John Collins contested fadeaway FOR THE WIN ,44,631,3442,4073,video
CompanyJ_451,This ref wasn t ready for Dipo s pass ,38,549,3790,4339,video
CompanyJ_452,Colts let Luck practice with his cousins Via thecheckdown ,58,1696,10142,11838,photo
CompanyJ_453,Rose told Doncic to SIT DOWN ,29,3473,15754,19227,video
CompanyJ_454,Luka is not a normal rookie Wow ,32,12442,58781,71223,video
CompanyJ_455,NOTHING FRIENDLY ABOUT YOUR NEIGHBORHOOD SPIDA MITCHELL via utahjazz ,69,2079,11356,13435,video
CompanyJ_456,Steph knocked over Jerebko on the celebration ,46,541,4075,4616,video
CompanyJ_457,Might as well give the 19 year old ROY now ,43,2250,13287,15537,photo
CompanyJ_458,Kuz knew it was over ,21,1156,6928,8084,photo
CompanyJ_459,Steph joins the top 3 already and he s only 30 ,47,1477,6756,8233,photo
CompanyJ_460,KD shook Lauri and Boogie was HYPED ,36,740,5747,6487,video
CompanyJ_461, I don t like the word soft Jimmy Butler responds to Ben Simmons calling 76ers too soft after loss to Hawks via JessicaCamerato ,128,610,4655,5265,video
CompanyJ_462,DWade and Gabrielle Union were out their seats for Zaire s poster ,66,7297,45340,52637,video
CompanyJ_463,Curry and KD might recruit Lopez after this celly ,50,920,8616,9536,video
CompanyJ_464,Scotty Pippen Jr just committed to Vanderbilt He s gonna be a problem next season ,82,3193,19776,22969,video
CompanyJ_465,50 years ago today Joe Namath led the Jets to a 16 7 win in Super Bowl III after guaranteeing victory Namath was named MVP despite not throwing a TD pass in the game or any passes in Q4 The Jets remain the only team to win a Super Bowl after scoring only 1 TD ,260,277,1575,1852,photo
CompanyJ_466,Rams Cowboys will come down to which defense can best contain the other s lethal running backs via SimmsAndLefkoe ,114,86,573,659,video
CompanyJ_467,6 2 Spida climbed over 7 2 JaVale ,34,1162,9370,10532,photo
CompanyJ_468,Is ketchup the secret fuel to Mahomes MVP caliber season ,57,366,3684,4050,video
CompanyJ_469,No more wild antics in the playoffs AdamLefkoe is riding with the home crowd today ,83,40,288,328,video
CompanyJ_470,PSG can t be stopped via brfootball ,36,149,1462,1611,photo
CompanyJ_471,Mac McClung AT THE BUZZER James Akinjo with 3 seconds left in OT Hoyas win in Double OT 96 90 ,94,3810,19335,23145,video
CompanyJ_472,89 TDs between them this year Will Mahomes or Luck light up the divisional round ,81,184,2362,2546,photo
CompanyJ_473,He waited 5 hours to attempt a 43 yard FG this was the result via GooseIsland ,78,2333,13166,15499,video
CompanyJ_474,Steve Balmer was looking for the handshake but Blake ran away ,62,1668,8050,9718,video
CompanyJ_475,CAM REDDISH DAGGER via CBSSports ,33,6333,19370,25703,video
CompanyJ_476,Was he even going for the ball ,31,2031,9423,11454,photo
CompanyJ_477,Chiefs READY via thecheckdown ,30,261,2086,2347,photo
CompanyJ_478,CANT TOUCH HIM via thecheckdown ,32,363,2817,3180,video
CompanyJ_479,Cheetah makes fast players look slow via NFL ,45,1225,8212,9437,photo
CompanyJ_480, Cam it s like that ,20,356,3255,3611,photo
CompanyJ_481,Mahomes takes it himself for 6 via NFL ,39,205,1797,2002,photo
CompanyJ_482,Blake and Pat Bev had some words at the end of the game ,56,737,4962,5699,video
CompanyJ_483,Blake Griffin today against his former team 44 PTS 13 23 FG 5 13 3PT W ,71,1154,6239,7393,video
CompanyJ_484, jtimberlake might have to give himself a 10 Day ,49,436,3329,3765,video
CompanyJ_485,Mahomes side arm throw is unstoppable via NFL ,46,675,5172,5847,photo
CompanyJ_486,Devin Booker pledges 2 5M donation to Arizona children amp families in need via Suns ,85,3724,22058,25782,video
CompanyJ_487,What a throw from Luck What a finish by Hilton via NFL ,55,237,2525,2762,photo
CompanyJ_488,Mahomes and the Chiefs move on to the AFC Championship ,55,4011,16098,20109,video
CompanyJ_489,ONE WIN FROM THE SUPER BOWL ,28,897,5962,6859,photo
CompanyJ_490,Tatum you good ,15,424,2347,2771,video
CompanyJ_491,These HS girls went D Wade amp Bron on the alley oop via aurorasports ,70,2122,8400,10522,video
CompanyJ_492,Bron in the house for Cowboys Rams via thecheckdown ,52,1171,7924,9095,video
CompanyJ_493,Kyrie you really don t have to do them like that ,49,1228,6715,7943,video
CompanyJ_494,A different look at Cam Reddish s game winner via gulfcoastballa IG ,68,270,1697,1967,video
CompanyJ_495,Tough day for Adam Vinatieri ,29,1470,9328,10798,video
CompanyJ_496,Don t give Cooper any space He ll burn you via thecheckdown ,60,926,5185,6111,photo
CompanyJ_497,10 carries 65 yards TD CJ Anderson is a TRUCK via thecheckdown ,63,348,2789,3137,photo
CompanyJ_498,Anderson s balling but Gurley is still Gurley House call Via NFL ,65,690,4525,5215,photo
CompanyJ_499,Kyrie was frustrated with Gordon Hayward and Celtics last shot ,63,1364,7205,8569,video
CompanyJ_500,Russ had Belinelli on skates ,29,2394,8775,11169,video
CompanyJ_501,Another look at Kyrie in the huddle before Celtics last shot Irving appeared to disagree with Brad Stevens call ,112,1361,7679,9040,video
CompanyJ_502,Karl Anthony Towns had 27 PTS and 27 REB tonight That hasn t been done in 45 years ,83,2351,17065,19416,photo
CompanyJ_503,This has been a WILD year for C J Anderson Cut by Broncos Benched and waived by Panthers Waived by Raiders without one snap Signed by Rams as Gurley insurance Averaged 149 5 yards for L A Playoff hero ,201,4782,33911,38693,photo
CompanyJ_504,Rams advance to the NFC Championship ,37,977,4697,5674,photo
CompanyJ_505,Bron in the Rams locker room after the W via OgboOkoronkwo ,59,3680,20602,24282,video
CompanyJ_506,Blake s last like ,18,2864,25259,28123,photo
CompanyJ_507,This Cowboys fan really threw his jersey straight into the fire via oscar_02213 ,80,3157,10093,13250,video
CompanyJ_508,T O has seen enough ,20,1828,6580,8408,photo
CompanyJ_509, YG roasts PostMalone after the Cowboys loss ,45,14016,59971,73987,video
CompanyJ_510,Kyrie knows from experience ,28,644,4805,5449,photo
CompanyJ_511,Snoop Dogg commentating NHL is the best thing you ll hear today via jbillinson ,79,16615,49008,65623,video
CompanyJ_512,The underdog Eagles are motivated and red hot AdamLefkoe is rolling with the Birds ,83,82,493,575,video
CompanyJ_513,Philip Rivers played through a torn ACL when he matched up with Tom Brady in the 2007 AFC Championship Will he finally get his first win vs Brady today via nflthrowback ,169,1033,6901,7934,video
CompanyJ_514,20 years ago today Michael Jordan retired for the second time after his sixth title He said there was a 99 9 percent chance he d never come back ,145,999,7243,8242,photo
CompanyJ_515,Kyle Korver passed Jason Terry to become fourth all time in 3 pointers last night Incredible career continues ,110,1312,12556,13868,video
CompanyJ_516,Rivers has been no match for Brady From B R x hulu ,51,171,999,1170,video
CompanyJ_517,History Sarah Thomas will become the first first woman to officiate an NFL playoff game in Chargers Patriots ,109,3244,19612,22856,photo
CompanyJ_518,The Pogba Rashford connection via NBCSportsSoccer ,50,501,2384,2885,video
CompanyJ_519,De Gea today DaveSaves ,23,368,1574,1942,photo
CompanyJ_520,His face via mrileygroup ,25,1280,10736,12016,video
CompanyJ_521,Messi becomes the first player ever to score 400 La Liga goals He s only the second player to score 400 in Europe s top 5 leagues ,130,1006,3865,4871,video
CompanyJ_522,Phillies are clear cut favorite to sign Bryce Harper after meeting per BNightengale ,84,1056,3490,4546,photo
CompanyJ_523,20 seconds of absolute dominance from Joel Embiid ,50,3829,18310,22139,video
CompanyJ_524,JoJo knows what he did ,23,322,2719,3041,video
CompanyJ_525,The Patriots have had the ball four times They ve scored four touchdowns ,73,1524,8102,9626,photo
CompanyJ_526,A rookie Sony Michel isn t your average one Flyguy2stackz just scored his 3rd of the game ,90,557,2712,3269,photo
CompanyJ_527,199 more yards 18 more 1st downs 28 more points The Patriots are mauling the Chargers ,86,1036,5032,6068,photo
CompanyJ_528,KAT went above and beyond for this fan with Leukemia via Timberwolves ,70,1460,7519,8979,video
CompanyJ_529,Knox really tried to sell the steal as a foul ,46,86,1320,1406,video
CompanyJ_530,This was Gronk s 69th career playoff catch Classic via NFL ,59,969,9011,9980,photo
CompanyJ_531,Beal is UNCONSCIOUS ,20,1180,8387,9567,video
CompanyJ_532,This almost worked ,19,620,6586,7206,video
CompanyJ_533,Did Knox break out Harden s double step back ,45,1486,9170,10656,video
CompanyJ_534,Klay been practicing to be a Warrior all his life via NBCSAuthentic ,68,1380,7739,9119,video
CompanyJ_535,Brady moves to 8 0 against Rivers as the Pats advance to the AFC Championship ,78,1340,4733,6073,photo
CompanyJ_536,The breakout superstar The 41 year old icon A shot at the Super Bowl Next week will be fun ,91,5207,31533,36740,photo
CompanyJ_537,Bring out the brinks truck for Nick via thecheckdown ,53,1018,6649,7667,photo
CompanyJ_538,This is via Vol_Hoops ,22,7306,33196,40502,video
CompanyJ_539,Nick Foles and the Eagles are clicking early via NFL ,53,377,2560,2937,photo
CompanyJ_540,Playoff Foles is in full effect so far 8 9 for 113 passing yards 2 TD ,70,605,4581,5186,photo
CompanyJ_541,Kyler Murray wants a 15M contract from A s to stick with baseball otherwise he ll enter NFL Draft tomorrow per MikeLeslieWFAA ,126,8600,35419,44019,photo
CompanyJ_542,Brees made sure the Saints didn t end the drive without a TD via NFL ,69,260,2391,2651,photo
CompanyJ_543,Greek Freak x Half Man Half Amazing jersey swap ,48,1148,9594,10742,video
CompanyJ_544,Eagles secondary ,17,3579,13011,16590,video
CompanyJ_545,That s why they call him Cantguardmike 10 catches 140 yards 1 TD ,65,2605,10777,13382,photo
CompanyJ_546,HE MISSED THE KICK PHIvsNO,26,238,2123,2361,status
CompanyJ_547,2nd pick of the night for Foles Has the Philly magic run out ,61,348,1766,2114,photo
CompanyJ_548, PHIvsNO ,9,2545,10725,13270,photo
CompanyJ_549,Saints advance to the NFC Championship ,39,4424,9444,13868,video
CompanyJ_550,McVay and Goff vs Payton and Brees Winner heads to the Super Bowl See you next week ,84,1112,6327,7439,photo
CompanyJ_551,Giants fans ecstatic ,21,1436,4676,6112,video
CompanyJ_552,We know Marcus Peters is ready for Sean Payton and the Saints via LindseyThiry ,79,3087,8452,11539,video
CompanyJ_553,That was dirty Luka ,20,3617,18983,22600,video
CompanyJ_554,Rematch in NOLA Who ya got ,27,371,2550,2921,photo
CompanyJ_555,AB no longer has the Steelers in his bio h t Alex_Kozora ,57,2116,9646,11762,photo
CompanyJ_556,James Harden went 1 17 from three tonight He still had 38 PTS 15 16FT ,70,4364,24946,29310,photo
CompanyJ_557,Kamara and Ingram committed to the troll via diannaESPN ,56,3369,12625,15994,video
CompanyJ_558,Clutch Curry ,13,2408,10055,12463,video
CompanyJ_559,Oh no Harrison Barnes comes up not so clutch against his former team ,69,835,6888,7723,video
CompanyJ_560,Light work for Steph 48 PTS 11 threes 6 REBS 5 ASTS ,52,1101,4793,5894,video
CompanyJ_561,Steph gave DezBryant a signed jersey via anthonyVslater ,56,540,3920,4460,video
CompanyJ_562,She really killed this via uclagymnastics ,42,5911,31777,37688,video
CompanyJ_563,Kuz went airborne ,18,944,6249,7193,video
CompanyJ_564,Sheesh The_ColeAnthony NSFW ,28,1682,9763,11445,video
CompanyJ_565,Ingram rose above Tristan ,26,811,4811,5622,video
CompanyJ_566,With their loss to the Cavs at home tonight the Lakers are now 3 7 without LeBron ,82,1316,7857,9173,video
CompanyJ_567,Rob Pelinka doesn t look too happy after loss to the Cavs via LoJoMedia ,72,1649,8632,10281,video
CompanyJ_568,Messi and Ronaldo are the only two players to score 400 goals in Europe s top 5 leagues ,88,587,4149,4736,photo
CompanyJ_569,Breaking down the conference title round Best QB Patrick Mahomes Best RB Todd Gurley Best DEF Saints Fewest weaknesses Patriots MikeTanier s Monday Morning Digest ,163,171,1208,1379,photo
CompanyJ_570,Doug Pederson greets every Eagles player as they leave the locker room one last time this season via JamieApody ,112,1734,16841,18575,video
CompanyJ_571,Last night was the Cavs first win since December 18 ,52,1390,15457,16847,photo
CompanyJ_572,Still has no mercy on his kid two years later via S_Kagawa0317 ,63,1043,5183,6226,video
CompanyJ_573,Before tearing his Achilles J J Barea did jumping high fives during Mavs introductions Luka did one solo last night ,116,1633,15349,16982,video
CompanyJ_574,Brady is different in the postseason From B R x hulu ,53,513,2260,2773,video
CompanyJ_575,DIGGS SIDELINE TOUCHDOWN The Minneapolis Miracle took place one year ago today via NFL ,87,2845,14152,16997,photo
CompanyJ_576,Kemba Walker might always come up in trade rumors but he thinks Charlotte is perfect for me and he wants to build the first career long legacy there ,149,255,1633,1888,photo
CompanyJ_577,He launched it with no regard via lil_hoot_22 Instagram ,56,292,3047,3339,video
CompanyJ_578,Is AB headed to the Niners ,27,1186,6196,7382,photo
CompanyJ_579,2018 Heisman winner Kyler Murray declares for the NFL Draft ,60,4426,24598,29024,photo
CompanyJ_580, ,1,1701,10145,11846,photo
CompanyJ_581,Kyler Murray has a chance to be the first athlete ever picked in Round 1 of the MLB and NFL drafts via EliasSports ,115,1391,6811,8202,photo
CompanyJ_582,Messi s dog is literally the biggest member of his family via leomessi Instagram ,81,1379,10617,11996,photo
CompanyJ_583,6 1 Fran Belibi threw down the first alley oop in girls HS history Now she wants to inspire other female hoopers Raider_SN ,123,1292,5616,6908,video
CompanyJ_584,This Drew Brees pregame speech via NFLFilms ,44,12582,45012,57594,video
CompanyJ_585,Kyler Murray chose the gridiron over the baseball diamond but did he make the right choice Only time will tell ,111,300,1978,2278,video
CompanyJ_586,The Cavs 3 1 comeback will live forever in history ,51,1865,9883,11748,photo
CompanyJ_587,Tony Parker s family flew all the way from France to surprise him in his return to San Antonio tonight via KSATRJ ,114,2765,20468,23233,video
CompanyJ_588,Former Saints safety Steve Gleason who has ALS had a pep talk with Malcolm Jenkins after the Eagles loss yesterday Amazing via JClarkNBCS h t thecheckdown ,155,679,4834,5513,video
CompanyJ_589,Spurs fans gave Tony Parker a ton of love during his tribute video ,67,4610,19350,23960,video
CompanyJ_590,Scary Terry took on two Nets defenders ,39,1368,6809,8177,video
CompanyJ_591,Standing ovation for Tony Parker from the Spurs crowd ,54,649,4228,4877,video
CompanyJ_592,Mavericks have engaged in talks with Suns and Magic for potential Dennis Smith Jr trade packages per wojespn ,109,562,2719,3281,photo
CompanyJ_593,Another 30 point game for The Beard He s got 36 points AT HALFTIME ,67,1704,9787,11491,photo
CompanyJ_594,DOWN GOES DUKE Syracuse upsets No 1 Duke 95 91 Tyus Battle 32 PTS 4 REBS 4 ASTS ,80,2908,9888,12796,photo
CompanyJ_595, Kyrie s leaving Celtics are getting blown out by the Nets and Brooklyn fans aren t holding back ,97,3642,15875,19517,video
CompanyJ_596, Cuse locker room is LIVE after taking down No 1 Duke via Cuse_MBB ,67,668,3401,4069,video
CompanyJ_597,Joe Ingles told Blake Griffin he was a flopper to his face ,59,1650,12220,13870,video
CompanyJ_598,The Beard continues his historic scoring tear ,46,1066,4684,5750,photo
CompanyJ_599,57 PTS for The Beard This man is unstoppable ,45,5225,22015,27240,video
CompanyJ_600,57 points It all makes sense ,29,1503,11696,13199,photo
CompanyJ_601,Tony Parker and Pop share a moment after the game ,50,1197,9779,10976,video
CompanyJ_602,Harden in 2009 9 9 PPG 3 2 RPG 1 8 APG vs Harden in 2019 33 5 PPG 5 8 RPG 8 0 APG ,82,6167,28055,34222,photo
CompanyJ_603,Joe Ingles blows a kiss to Pistons fans after sealing the win ,62,4878,34902,39780,video
CompanyJ_604,BOBAN via NBATV ,16,1148,8350,9498,video
CompanyJ_605,Pat Bev got a tech for taking AD s shoe and bringing it to the Clippers bench ,78,1058,6968,8026,video
CompanyJ_606,40 point games from MVPs LeBron 2013 1 Durant 2014 14 Steph 2015 3 Steph 2016 13 Russ 2017 18 Harden 2018 11 James Harden has 14 right now ,139,1260,7907,9167,photo
CompanyJ_607,Elementary school kids made a Lego Tom Brady mural that changes as you move via liamwbz ,88,4570,25062,29632,video
CompanyJ_608,High praise for KMbappe from the man himself ,45,646,4602,5248,photo
CompanyJ_609,In 2006 Drew Brees suffered a devastating shoulder injury and wasn t sure if he d ever play again Today he turns 40 with the most passing yards in NFL history ,159,2178,14840,17018,photo
CompanyJ_610,She had him wobbly via arianadossantos10 IG ,44,13847,56526,70373,video
CompanyJ_611,TCU brought in a cop to surprise this walk on with a scholarship via TCUBasketball ,83,3319,18942,22261,video
CompanyJ_612,Kyrie clears the air ,21,734,6703,7437,photo
CompanyJ_613,Revisiting the REAL story of the Clippers Rockets raid a year later GameOfZones ,80,655,2671,3326,video
CompanyJ_614,Joel Embiid makes rooks pick him up a MEGA Chick fil A order of four spicy chickens four fries and four shakes before every flight ,131,928,6626,7554,photo
CompanyJ_615,Neymar stops security from taking away a pitch invader gives him the photo via RamboFYI ,88,1117,7246,8363,video
CompanyJ_616,Clemson was treated to a McDonalds fast food cheat day at the White House ,74,1602,10185,11787,video
CompanyJ_617,Phillies have visions of signing Bryce Harper Dallas Keuchel and Craig Kimbrel this offseason per BNightengale ,111,753,3946,4699,photo
CompanyJ_618,Chef Huncho ,12,5450,24617,30067,photo
CompanyJ_619,Brady vs Mahomes Brees vs Goff Is this weekend a passing of the torch moment via SimmsandLefkoe ,96,171,1053,1224,video
CompanyJ_620,Nick Foles loses his powers at the GridironHeights Elimination Club PlayStation ,80,1979,7548,9527,video
CompanyJ_621,Indiana fans chanted John Wall hates you at Kelly Oubre ,56,1226,7884,9110,video
CompanyJ_622,Panthers owner says Cam Newton could sit out 2019 season in order to heal sore shoulder per AdamSchefter ,105,999,4068,5067,photo
CompanyJ_623,TJ McConnell gave his former teammate a love tap after scoring on him ,70,1069,9117,10186,video
CompanyJ_624,Oct 28 2008 Derrick Rose scores 11 points in his first NBA game Jan 15 2019 Derrick Rose scores his 10 000th point ,115,3980,20043,24023,photo
CompanyJ_625,OKAY KLAY ,10,964,7607,8571,video
CompanyJ_626,The Sixers beat the Wolves by 42 Jimmy looks pleased ,53,4330,30416,34746,video
CompanyJ_627,The Warriors just hit 10 threes in a quarter and dropped 51 points Most 3 pointers in Dubs history ,99,2610,11116,13726,video
CompanyJ_628,Draymond not holding back on the ref ,37,744,5868,6612,video
CompanyJ_629,Joel Embiid Troll King ,23,797,6198,6995,photo
CompanyJ_630, MELOD1P with the casual half court pull up ,44,1968,9770,11738,video
CompanyJ_631,Steph s range is disrespectful ,31,3871,18575,22446,video
CompanyJ_632,Warriors 142 Nuggets 111 There s a new No 1 in the West ,56,1181,7544,8725,photo
CompanyJ_633,Ohio State backup QB Tate Martell expected to announce transfer to University of Miami per VinceSapienza ,105,1610,6384,7994,photo
CompanyJ_634,Klay couldn t wait for the end of the interview to text Zaza about winning their dunk competition via anthonyVslater ,117,470,4361,4831,video
CompanyJ_635,Joel Embiid s 2018 19 so far 27 PPG 13 3 RPG The only Sixers player to finish a season with 27 PPG and 13 RPG Wilt Chamberlain h t statmuse ,140,460,3568,4028,photo
CompanyJ_636,Luka s rookie season is being compared to some of the greats Could it end up being even better than LeBron s ,109,415,4036,4451,photo
CompanyJ_637,Klay had a dunkfest last night ,31,509,4260,4769,video
CompanyJ_638,26 years ago today Shaq and Jordan gave us an instant classic Diesel 29 PTS 24 RES 5 BLK Jordan 64 PTS 6 REB 5 STL Magic 128 Bulls 124 ,135,3725,19433,23158,photo
CompanyJ_639,This shot via NENebraskaSport CedarCoNews ,42,323,1918,2241,video
CompanyJ_640,Alex Morgan s 2018 was absolute ,32,330,2768,3098,photo
CompanyJ_641,Swaggy and Agent Zero hooping at home via no chill gil instagram ,65,4046,17902,21948,video
CompanyJ_642,One for the record books ,25,366,2337,2703,photo
CompanyJ_643,Jalen Hurts announces transfer to Oklahoma University ,54,11513,51384,62897,photo
CompanyJ_644,Straight embarrassed his opponent with Mbappe via Lokelani_FIFA ,64,4742,23250,27992,video
CompanyJ_645,Three months into the season Gordon Hayward is struggling to return to his previous All Star level of play I m still not as confident as I want to be Can he find his way back and still be worth his 128M contract ,212,97,884,981,photo
CompanyJ_646,Ronaldo wins wherever he goes ,30,623,2608,3231,photo
CompanyJ_647,Jalen Hurts next in line for the Heisman Trophy ,48,1003,5595,6598,photo
CompanyJ_648, Who s ARod That s the guy that JLo is dating via AROD ,55,2934,15583,18517,video
CompanyJ_649,Western Illinois DT Khalen Saunders is 320 lbs and can backflip via AdamSchefter ,81,2300,11973,14273,video
CompanyJ_650,AB and Emmanuel Sanders won t hold back ,40,1360,7261,8621,photo
CompanyJ_651, ,1,5787,38535,44322,photo
CompanyJ_652,A fight broke out then LaMelo pulled up from halfcourt to seal the win Last night s SPIRE game had it all ,106,3945,20795,24740,video
CompanyJ_653,Tate Martell went 45 0 in high school Now the former Ohio State QB is joining two of his former teammates at University of Miami ,129,1029,5023,6052,video
CompanyJ_654,The most Belichick response ever via Patriots ,46,1446,6983,8429,video
CompanyJ_655,Steven Jackson got a glimpse of life as a Patriot before an AFC Championship Game and Bill Belichick had a surprise for him New SimmsAndLefkoe The Show ,152,146,1011,1157,video
CompanyJ_656,OH MY ,6,7054,31930,38984,video
CompanyJ_657, That should be illegal right there Kyrie with the left via NBA ,64,1141,8202,9343,video
CompanyJ_658,Luka throws it down ,20,1060,8872,9932,video
CompanyJ_659,Wonder what Boogie and AD laughing about Via NBCSWarriors ,58,288,2528,2816,video
CompanyJ_660,Giannis owned Gasol on both ends of the floor ,46,1458,6053,7511,video
CompanyJ_661,Klay s pregame ritual could not be more Klay via NBCSWarriors ,62,578,4501,5079,video
CompanyJ_662,Harden s 50th point put him on SKATES ,38,1782,7458,9240,video
CompanyJ_663,KAWHI NOT via Raptors ,22,1101,6424,7525,video
CompanyJ_664,TALK TO EM KYRIE ,17,10907,38320,49227,video
CompanyJ_665, SDinwiddie_25 gets the post game shower after dropping 33 on the Rockets ,74,577,3791,4368,video
CompanyJ_666,Harden wasn t having it ,24,557,3838,4395,video
CompanyJ_667,Harden is the new King of 50 point games ,41,1561,8154,9715,photo
CompanyJ_668,Klay s a dunker now via warriors ,33,485,4422,4907,video
CompanyJ_669,Turns out it was more difficult than Kyrie envisioned ,54,6268,30329,36597,photo
CompanyJ_670,Kyrie made the right decision ,30,1647,9269,10916,video
CompanyJ_671,Ochocinco talking smack on defense now via ochocinco ,53,2876,13211,16087,video
CompanyJ_672,Steph with the finesse via NBA ,31,3195,17783,20978,video
CompanyJ_673,Stephen Curry just hit 6 threes in the third quarter Wow via NBCSWarriors ,74,1183,5471,6654,video
CompanyJ_674,Unbelievable performance by StephenCurry30 7 threes in 3rd quarter 41 PTS 9 17 from 3 ,86,1859,7100,8959,video
CompanyJ_675,Steph making sure he gets every three point record ,51,1228,6224,7452,photo
CompanyJ_676,In an era of GOAT debates Muhammad Ali s status is unquestionable The People s Champion was born on this day in 1942 ,117,2666,9932,12598,photo
CompanyJ_677,James Harden s last two games 58 PTS 57 PTS Total 115 PTS Only Kobe and MJ have scored more over a 2 game span 118 in the last 30 years ,136,1097,6467,7564,photo
CompanyJ_678,Jamie Vardy went through a whole training session dressed as Spider Man via brfootball ,87,1054,5673,6727,photo
CompanyJ_679, Franchise leader in points assists steals 12x All Star 3x Champ 2006 Finals MVP Happy 37th Birthday to DWade ,110,9529,36073,45602,video
CompanyJ_680,A boy with autism and cerebral palsy practices his dribbling as his younger brother cheers him on via Keystone_24 ,114,2243,15284,17527,video
CompanyJ_681,D Wade after going down 0 2 in the 2006 Finals 42 PTS W 36 PTS W 43 PTS W 36 PTS W Flash turns 37 today ,104,11534,54786,66320,photo
CompanyJ_682,Capped the spin off with a tomahawk poster via makeitrain222 ,61,576,3155,3731,video
CompanyJ_683,These six players have been with their respective franchises for at least a decade 10YearChallenge ,99,2699,13710,16409,photo
CompanyJ_684,Bill Self says top 10 recruit Quentin Grimes is probably the most well rounded young guard in Kansas history So why has his transition to college ball been so tough ,165,77,626,703,photo
CompanyJ_685,Pop says he doesn t know the answer when asked if he plans to coach the Spurs beyond this season per TheSteinLine ,114,469,3137,3606,photo
CompanyJ_686,If the NBA All Star Draft were today Bron and Giannis would be your captains Who should each take with their first pick ,120,332,2158,2490,photo
CompanyJ_687,A class of 2nd graders wrote letters of encouragement to Alshon Jeffery after the Eagles playoff loss Today he surprised them with a visit via JamieApody ,154,6103,35545,41648,video
CompanyJ_688,Knicks finding creative ways to lose ,37,3202,15655,18857,video
CompanyJ_689,Russ and his son Noah showed up to the game in matching fits Via NBA ,69,2787,26027,28814,video
CompanyJ_690,Miles Bridges Oh man ,21,2466,12855,15321,video
CompanyJ_691,Tony Parker taught Fox a lesson with his timeless spin move ,60,903,6430,7333,video
CompanyJ_692,He offered Giles a beer ,24,909,7292,8201,video
CompanyJ_693,The Nuggets bench couldn t believe Paul Millsap s putback dunk ,63,760,6152,6912,video
CompanyJ_694,Down goes Jim Boylen ,21,179,1429,1608,video
CompanyJ_695,Choosing between Drake and J Cole Tough decision via Suns ,58,143,1076,1219,video
CompanyJ_696,Sheesh Kris Dunn ,17,269,1991,2260,video
CompanyJ_697,Chuck has some advice for Kyrie You don t have to tell people you re a leader just be a leader via NBAonTNT ,108,744,4774,5518,video
CompanyJ_698,Spicy P FOR THE WIN ,20,812,4731,5543,video
CompanyJ_699,Michael Beasley tried entering the game with his practice shorts on ,68,2667,14077,16744,video
CompanyJ_700,Jokic went into his bag of tricks ,34,634,4167,4801,video
CompanyJ_701,Ja Morant is handing out POSTERS via MSURacers ,47,729,4096,4825,video
CompanyJ_702,Pure effort and hustle by the Brodie ,37,1175,7275,8450,video
CompanyJ_703,NBA s strongest man moving top speed in the hallways Watch out ,63,599,4985,5584,video
CompanyJ_704,Kuz is FEELING IT ,18,718,4767,5485,video
CompanyJ_705,Zo s last second foul on Russ had Luke Walton baffled ,54,339,2751,3090,video
CompanyJ_706,Bron s looking for some answers ,32,129,1038,1167,link
CompanyJ_707,Zo with unlimited confidence ,29,5640,31478,37118,video
CompanyJ_708,The Lakers young core TOOK OVER in OT ,38,6230,26171,32401,video
CompanyJ_709,Russ is shooting just 10 50 in two games vs the Lakers this season ,67,895,4377,5272,photo
CompanyJ_710,Giannis and the Bucks reign continues but the Warriors are closing in B R Week 14 Power Rankings ,97,58,885,943,photo
CompanyJ_711,Today s the day Boogie s back ,30,13898,54330,68228,photo
CompanyJ_712,Boogie s return could make the Warriors even more dominant but pump the brakes for now says HowardBeck ,103,127,901,1028,video
CompanyJ_713,Donovan Mitchell announces he will not participate in the All Star dunk contest this year I loved doing the dunk contest last year and it was a ton of fun but I also know it takes a lot of focus practice and preparation per E_Woodyard ,235,236,2526,2762,photo
CompanyJ_714,Nikola Jokic has been on a ridiculous tear PTS AST REB 21 9 9 W 23 9 8 W 19 15 14 W 26 6 13 W 39 6 12 W 24 4 13 L 29 10 11 W 18 10 14 W 23 4 10 L 40 8 10 W 17 8 4 L 18 11 8 W ,175,1341,9095,10436,photo
CompanyJ_715, We re getting a new offensive coordinator next year ,53,7437,28186,35623,video
CompanyJ_716,Had him walking on ice via RowanAthletics ,42,1583,5819,7402,video
CompanyJ_717,Hornets rookie Miles Bridges plans to compete in the All Star Dunk Contest per ChrisBHaynes This should be fun ,111,1651,7931,9582,video
CompanyJ_718,Handles in sync via mideoriyomi_ tahmalathorpe ninakokic_ ,58,993,4842,5835,video
CompanyJ_719,Patrick Mahomes has been unstoppable A Super Bowl appearance would cap off a historic season Hulu ,98,118,826,944,video
CompanyJ_720,Syracuse bound Joe Girard III is averaging 46 PPG and decimating scoring records slam_hs ,89,873,4454,5327,video
CompanyJ_721,Coach Cal says Jimmy Butler bullied KAT in Minnesota Jimmy s response When you have as much talent as Karl guys don t keep it real with him I do per Jackie MacMullan ,166,3349,16922,20271,photo
CompanyJ_722,Luka Doncic Early favorite for Rookie of the Year ,50,4433,17971,22404,video
CompanyJ_723,Larry Fitzgerald hit a hole in one at Seminole Golf Club while playing with Barack Obama ,89,954,7664,8618,photo
CompanyJ_724, athielen19 s kid already blessed with a cannon and great hands ,64,215,2567,2782,video
CompanyJ_725,Mike Tyson says he tried acid at 11 and grew up being hypnotized that he was a ferocious animal in wild interview with joerogan ,128,3487,17135,20622,photo
CompanyJ_726,This coach wins 2019 hype man of the year already via advosports h t thecheckdown ,82,1565,7653,9218,video
CompanyJ_727,Isaiah Thomas aiming for Feb 11 13 return for Denver Nuggets debut per wojespn ,79,409,3034,3443,photo
CompanyJ_728,Big Poppa back Via NBCSWarriors ,32,898,5890,6788,video
CompanyJ_729,Blake outside the perimeter is a regular now ,45,8233,45752,53985,video
CompanyJ_730,Jaren Jackson Jr tried shooting while sitting down it wasn t pretty ,68,203,2020,2223,video
CompanyJ_731,DLO WITH ICE IN HIS VEINS ,26,3679,16694,20373,video
CompanyJ_732,Kyrie went full Uncle Drew mode in the 4Q ,42,2173,9159,11332,video
CompanyJ_733,Clear the lane for Spida ,25,520,4571,5091,video
CompanyJ_734,Joe Ingles flamed former teammate Alec Burks by saying his shoes don t match ,77,349,3737,4086,video
CompanyJ_735, ,1,1427,7405,8832,video
CompanyJ_736,Anytime Steph makes these he s bound to go off via warriors ,60,5045,26392,31437,link
CompanyJ_737,BOOGIE IS BACK via NBCSWarriors ,32,3082,11802,14884,video
CompanyJ_738,Get used to this ,17,988,6968,7956,photo
CompanyJ_739,Just getting started Welcome back Boogie ,41,1016,6172,7188,photo
CompanyJ_740,Boogie came back with authority ,32,1132,6800,7932,video
CompanyJ_741,Boogie got a standing ovation after fouling out in his first game back ,71,2661,19044,21705,video
CompanyJ_742,Boogie looks ready to be the 4th Splash Bro ,44,3369,20716,24085,video
CompanyJ_743,Thor is not very good at soccer via chrishemsworth ,51,1634,7917,9551,video
CompanyJ_744,Boogie on his return Felt like a kid on Christmas this is probably one of the best days of my life per NickFriedell ,116,210,2364,2574,photo
CompanyJ_745,THAT ELBOW via brlive ,22,465,2214,2679,video
CompanyJ_746, You did amazing don t cry Serena Williams with the incredible show of sportsmanship after her match against 18 year old Dayana Yastremska via AustralianOpen ,158,691,4649,5340,video
CompanyJ_747,The Tuck Rule Game was 17 years ago today One pass ruled incomplete was the start of a Patriots postseason dynasty via nflthrowback ,132,1229,5554,6783,video
CompanyJ_748,Pogba s goal celebration for his newborn via brfootball ,56,336,2716,3052,photo
CompanyJ_749, or not you gotta show ID via Eurosport_UK ,43,521,4025,4546,video
CompanyJ_750,LeBron pulled up to watch Cassius Stanley throw down an in game 360 against Crossroads ,87,1261,11111,12372,video
CompanyJ_751, Two goals today Top scorer in the league this season 16 mosalah ,65,349,1459,1808,photo
CompanyJ_752,Two teams at the top of the East are interested in making a move for Bradley Beal but are the Wizards willing to part with their young star NBA executives weigh in on the trade market for the sharpshooter ,205,204,1380,1584,photo
CompanyJ_753,Who will finish with the most rushing yards on Championship Sunday ,67,92,486,578,status
CompanyJ_754,One month ago the Lakers were reportedly dangling Lonzo as a trade chip according to an NBA exec Things have changed in Los Angeles ,132,377,2860,3237,photo
CompanyJ_755,18 year old American Timothy Weah scores just 15 minutes into his Celtic debut ,79,569,4464,5033,photo
CompanyJ_756,DOWN GOES MICHIGAN Wisconsin hands No 2 Michigan its first loss of the season 64 54 including 26 points from Ethan Happ ,120,1046,7928,8974,video
CompanyJ_757,Todd Gurley is a touchdown machine and C J Anderson s emergence has made the Rams even more dangerous Hulu ,107,83,584,667,video
CompanyJ_758,Kemba went Tim Hardaway Sr on this crossover ,45,1442,7754,9196,video
CompanyJ_759,PAUL GEORGE TOO CLUTCH ,23,9950,34295,44245,video
CompanyJ_760,Raymond Felton thought PG had a headache PG was really just trying to make sure his line was straight ,102,7887,42318,50205,video
CompanyJ_761,PG 13 vs Jimmy Buckets for the game Doesn t get much better than this ,70,1629,6366,7995,video
CompanyJ_762,Russ and Embiid get into it every time they play ,49,1582,7506,9088,video
CompanyJ_763,Zion just destroyed all of Virginia in one sequence via CBSSports ,66,12566,44758,57324,video
CompanyJ_764,Timothe Luwawu Cabarrot gave Ben Simmons the COLDEST of shoulders ,66,1377,7944,9321,video
CompanyJ_765,Philly is 0 19 against OKC since that date ,43,929,4470,5399,photo
CompanyJ_766,This Chuck and Coach Calipari postgame exchange NSFW via ChristinaWBRC ,71,220,1533,1753,video
CompanyJ_767,Dick Vitale Were you a McDonald s All American Chuck No I eat at McDonald s ,76,1362,8296,9658,video
CompanyJ_768, ,1,766,4957,5723,photo
CompanyJ_769,PG and Terrance Ferguson hit the Blueface dance after the win ,62,2103,9267,11370,video
CompanyJ_770,Zion and Duke hand Virginia its first loss of the season ,57,694,3995,4689,photo
CompanyJ_771,This D Wade Chicago Bulls tribute vid ,38,2148,10599,12747,video
CompanyJ_772,Dwyane Wade s mom and sister in the house for one last game in Chicago ,71,931,5781,6712,video
CompanyJ_773,Luka couldn t believe he got ejected for this moment ,53,376,3118,3494,video
CompanyJ_774,Two years ago today Russell Westbrook got called for the most blatant walk of all time ,87,3629,18342,21971,video
CompanyJ_775,Marcus Smart got ejected for charging at DeAndre Bembry ,56,2097,8800,10897,video
CompanyJ_776,Texas really has Matthew McConaughey on the bench via KOCOCarson ,65,1329,9574,10903,video
CompanyJ_777,BUDDY FOR THE WIN ,18,4086,18056,22142,video
CompanyJ_778,The Buddy Hield breakout continues 35 PTS 13 22 FG 7 9 3PT Game winner ,71,2283,15889,18172,photo
CompanyJ_779,Giannis dropped 25 PTS and 13 REB in a win then got up extra shots postgame Mamba Mentality via fswisconsin ,108,806,5415,6221,video
CompanyJ_780,Kyrie s balance on this sequence was ridiculous ,48,1528,8419,9947,video
CompanyJ_781,This guy ,9,8855,39362,48217,photo
CompanyJ_782, KCP couldn t even hit rim ,27,1363,5754,7117,photo
CompanyJ_783,James Harden dropped 48 PTS Eric Gordon forced OT and stepped up in crunch time What a game ,92,1030,4514,5544,video
CompanyJ_784,James Harden in the past five days 57 PTS 58 PTS 48 PTS Unbelievable ,69,1913,9671,11584,photo
CompanyJ_785,Josh Hart tried to guard Harden with his hands behind his back ,63,708,5017,5725,video
CompanyJ_786,Zylan Cheatham went Dwight Howard on this poster ,49,4442,20817,25259,video
CompanyJ_787,Jokic was trying to cop digits from the bench ,46,1904,14349,16253,video
CompanyJ_788,CHAMPIONSHIP SUNDAY Here we go ,31,4023,20075,24098,photo
CompanyJ_789,If Mahomes is forced to throw 50 times Kansas City will lose Andy Reid must not abandon the run ,96,126,1059,1185,video
CompanyJ_790,James Harden has scored 163 points in his last three games Only Kobe and MJ have scored more over that span in the past 50 years per EliasSports ,145,1042,6254,7296,photo
CompanyJ_791,Andrew Regan a special needs student hit a buzzer beater and the crowd was loving it via CCHSUNIFIED15 ,103,8364,40905,49269,video
CompanyJ_792,Tom Brady is 24 4 in temperatures below 30 degrees per jayfeely My mind doesn t slow down in the cold but their bodies do ,122,1857,10549,12406,photo
CompanyJ_793,Dropped him HARD on the break via sergiooperezz Instagram ,58,309,2199,2508,video
CompanyJ_794,D Wade s boys surprised him during his Marquette ceremony via KRoseSharkey ,75,3694,23673,27367,video
CompanyJ_795,This Ja Morant dunk is mesmerizing via MSURacers ,49,6941,31254,38195,video
CompanyJ_796,Drew Brees getting the Saints LOCKED IN via Saints ,51,3992,19310,23302,video
CompanyJ_797,Tom Brady walked into the Patriots facility this week and called himself the baddest motherf ker on the planet per MikeGiardi ,126,5719,23620,29339,photo
CompanyJ_798,13 0 Still three to play ,25,358,3392,3750,photo
CompanyJ_799,Mark Ingram took him out via thecheckdown ,42,1573,8764,10337,photo
CompanyJ_800, Be respectful out here motherf ker KD wasn t playing when this fan took his hat NSFW via armando chavez_ IG ,109,5480,22389,27869,video
CompanyJ_801,You know why he s here ,23,744,4753,5497,photo
CompanyJ_802,Mahomes getting ready for the AFC Championship Game ,52,7385,34566,41951,photo
CompanyJ_803,Antonio Brown getting in reps with Kyler Murray and Hollywood Brown via AB84 ,77,2031,12999,15030,video
CompanyJ_804,Everybody at The Dome is feelin it via randirrousseau ,54,553,3034,3587,video
CompanyJ_805,TED GINN WIDE OPEN ,19,468,2956,3424,photo
CompanyJ_806,Drew Brees working in the pocket via NFL ,41,285,1643,1928,photo
CompanyJ_807,NO FLAG ,8,3993,14296,18289,photo
CompanyJ_808,Business as usual Greg Zuerlein nails it from 48 yards to tie the game ,71,485,3487,3972,photo
CompanyJ_809,OT about to be LOUD in the Superdome via thecheckdown ,54,245,1928,2173,photo
CompanyJ_810,Pick Choppa BIG TIME via thecheckdown ,38,1160,3859,5019,photo
CompanyJ_811,Gumbo s served Rams are going to the Super Bowl ,48,6034,14457,20491,photo
CompanyJ_812,LEGATRON 57 yards in OT against the Saints Greg Zuerlein is going down in the books ,84,1633,7804,9437,photo
CompanyJ_813,Rams went ALL IN to get to the Super Bowl Talib Trade Peters Trade Fowler Trade Suh 14M Shields Hadn t played since 2016 Cooks 50 5M guaranteed Gurley Highest paid RB ever Donald Biggest defensive deal ever ,207,5045,24397,29442,photo
CompanyJ_814,No one is happier for the Rams right now than YG NSFW via defjam ,65,4735,12524,17259,video
CompanyJ_815,Marcus Peters saying eat that Gumbo after the win via diannaESPN ,65,1144,3753,4897,link
CompanyJ_816,Mood in NOLA right now ,23,2159,6275,8434,photo
CompanyJ_817,Sean Payton says NFL officials told him they blew the call ,59,8197,29623,37820,photo
CompanyJ_818, I THINK WE AIN T DONE YET via RamsNFL ,39,2083,8850,10933,video
CompanyJ_819,57 yard game winning FG for Greg the Leg ,41,789,4918,5707,photo
CompanyJ_820,Choppa time in the RamsNFL locker room via tj_bchillen Instagram ,65,1501,3897,5398,video
CompanyJ_821,Brady and the Pats thought they were about to be up 14 0 Chiefs D said NO via thecheckdown ,91,606,3773,4379,photo
CompanyJ_822,How did Brady make this throw via thecheckdown ,47,979,6223,7202,photo
CompanyJ_823, I m going to the club like this Marcus Peters in full uniform after the game via DanWolken ,92,969,4711,5680,photo
CompanyJ_824,Perfect throw Perfect route Pats ain t playing via thecheckdown ,64,1221,4786,6007,photo
CompanyJ_825,NFL s highest scoring team gets shutout in the first half Pats lead 14 0 ,73,506,2426,2932,photo
CompanyJ_826,Gurley having too much fun out here ,36,4169,16028,20197,photo
CompanyJ_827,Mahomes and the Chiefs ARE BACK via thecheckdown ,49,650,4134,4784,photo
CompanyJ_828,So predictable ,15,1102,5679,6781,photo
CompanyJ_829,Mahomes sidearm Routine via NFL ,32,389,2813,3202,photo
CompanyJ_830,Patty Mahomes Big time plays ,29,485,3798,4283,photo
CompanyJ_831,STUFFED ,8,466,2760,3226,photo
CompanyJ_832,WHATTTTT ,9,570,3278,3848,status
CompanyJ_833,Did Edelman touch this via thecheckdown ,40,670,4009,4679,photo
CompanyJ_834,Julian Edelman didn t touch it still Patriots ball ,51,309,1585,1894,link
CompanyJ_835,BALL DON T LIE via thecheckdown ,32,3253,12224,15477,photo
CompanyJ_836, TOM WHO ,9,959,4514,5473,photo
CompanyJ_837,Momentum Swing via thecheckdown ,32,433,2445,2878,photo
CompanyJ_838,Sony Michel TD Pats re take the lead with 3 min to go via thecheckdown ,71,239,1164,1403,photo
CompanyJ_839,D Rose FOR THE WIN ,19,15247,50821,66068,video
CompanyJ_840,Damien Williams with THREE TDs this quarter via NFL ,52,601,3387,3988,photo
CompanyJ_841,Too much time for Tom Here we go ,33,736,3131,3867,photo
CompanyJ_842,Chris Hogan didn t catch it ,28,200,1560,1760,link
CompanyJ_843,GRONK STILL GOT IT ,19,633,2432,3065,photo
CompanyJ_844,We knew it was coming ,22,6945,19004,25949,photo
CompanyJ_845,Gronk with the biggest catch of the year for the Pats via NFL ,62,426,2208,2634,photo
CompanyJ_846,MAHOMES WOW ,12,1337,5964,7301,status
CompanyJ_847,CHIEFS MAKE IT TO FIELD GOAL RANGE via thecheckdown ,52,386,2410,2796,photo
CompanyJ_848,Championship Sunday gives us our second OT game of the day ,59,1492,6107,7599,photo
CompanyJ_849,The real winner of today s game ,32,8139,49049,57188,photo
CompanyJ_850,Patriots are headed to the Super Bowl ,38,1871,4577,6448,photo
CompanyJ_851,Brady silences the haters again ,32,14449,32789,47238,video
CompanyJ_852,Twitter watching the Pats advance to the Super Bowl for the 3000th time ,72,5671,20913,26584,video
CompanyJ_853,Brady and Belichick have done it again with their ninth AFC title 3rd in a row 4th in five years 5th in eight years Unprecedented via thecheckdown ,147,5501,17678,23179,photo
CompanyJ_854,Patrick Mahomes magical first season as a starter 50 TD No 1 82 QBR No 1 5 097 yards No 2 Chiefs 35 3 PPG No 1 MVP front runner He ll be back ,142,10111,47967,58078,photo
CompanyJ_855,Good luck RamsNFL Patriots ,27,726,4072,4798,photo
CompanyJ_856,D Rose game winner courtside via mcjonb Instagram ,50,3732,20403,24135,video
CompanyJ_857,One of the worst calls in recent memory is a huge stain on the NFL s credibility and on the Rams legitimacy as NFC champions ,125,1579,6355,7934,photo
CompanyJ_858,Nickell Robey Coleman post game Oh hell yeah I whacked his ass via rscheuermann2 ,81,2581,11474,14055,video
CompanyJ_859,Thank you MLK ,14,13027,34006,47033,video
CompanyJ_860,Time and time again the Patriots prove everyone wrong ,54,1321,6100,7421,video
CompanyJ_861, s still going ,15,5176,23627,28803,photo
CompanyJ_862,The Franchise ,14,3054,11787,14841,photo
CompanyJ_863,Several unnamed Eagles describe Carson Wentz as selfish and egotistical per thephillyvoice ,91,808,2551,3359,photo
CompanyJ_864,Multiple Eagles players have come to Carson Wentz defense ,58,803,3293,4096,photo
CompanyJ_865,High schooler Xavier Machuga suffered a brain aneurysm in May 2017 Last week he made his return to the court and scored via hockomocksports CHSDogsBball ,153,1075,6805,7880,video
CompanyJ_866,The NFL will consider making interference reviewable after last night s no call per MarkMaske ,94,1301,6785,8086,photo
CompanyJ_867,In 1997 Knicks coach Jeff Van Gundy accused Michael Jordan of conning other stars into friendship 22 years ago today MJ got his revenge with 51 points ,151,377,2595,2972,photo
CompanyJ_868,Mike Thomas wants answers ,26,1525,11132,12657,photo
CompanyJ_869,Sean McVay has an assistant coach just to keep him off the field via NFLFilms ,78,29058,118472,147530,video
CompanyJ_870,Russ had to let Frank know how good the pump fake was ,54,2305,11406,13711,video
CompanyJ_871, RAYMOND FELTON Knicks fans were chanting for their former point guard and Paul George joined in ,97,1019,6690,7709,video
CompanyJ_872,John Collins is super bouncy ,29,253,1956,2209,video
CompanyJ_873,FIFA Zlatan really choked out his opponent before scoring a goal via saschaabc Instagram ,89,758,4767,5525,video
CompanyJ_874, He s trying to hurt my rookie Luka got pushed into a camerawoman and this Mavs fan was furious ,96,1648,9600,11248,video
CompanyJ_875,Luka Doncic with his first career triple double He s the second youngest to do it Markelle Fultz ,97,1208,9391,10599,photo
CompanyJ_876,Giannis stared down Luka after putting him on a poster ,55,1383,7394,8777,video
CompanyJ_877,Hawks brought out the choir for intros via ATLHawks ,52,272,1598,1870,video
CompanyJ_878,Breaking The Rockets have agreed to trade Carmelo Anthony and cash to Chicago Bulls per wojespn ,96,2279,6916,9195,photo
CompanyJ_879,Melo won t play a game for the Bulls He will be released and become a free agent if he clears waivers per wojespn ,114,2850,10371,13221,link
CompanyJ_880, Melo s a free agent ,21,4377,22404,26781,photo
CompanyJ_881,In 2014 the Bulls pitched Melo on forming a superteam with D Rose and Joakim Today they traded released him for tax purposes Cold world ,136,2710,13017,15727,photo
CompanyJ_882,Lakers maintain interest in Melo but don t want to waive a guaranteed player to create roster spot If one opens the Lakers are a possible destination per wojespn ,162,654,2658,3312,photo
CompanyJ_883,30 point games for D Angelo Russell First three years 7 This season 8 ,70,3602,20849,24451,photo
CompanyJ_884,Fields Hurts and Martell It s been the year of the QB transfer in CFB says NFLDraftScout ,89,200,1361,1561,video
CompanyJ_885,Sean McVay changed his demeanor REAL quick via thecheckdown ,60,1497,14847,16344,video
CompanyJ_886,120 22 Torrey Smith shows absolutely no mercy on his kids in Madden via TorreySmithWR ,86,1084,6178,7262,video
CompanyJ_887,Which Melo was better ,22,5097,27519,32616,photo
CompanyJ_888,They really tried to end Baynes ,32,2936,15091,18027,video
CompanyJ_889,Kyrie always pulling out the playground moves ,46,2062,12461,14523,video
CompanyJ_890,Faried was too hyped about his first bucket with the Rockets Immediate tech ,76,1358,11889,13247,video
CompanyJ_891,TJ McConnell is not backing down from The Beard ,48,1026,7106,8132,video
CompanyJ_892,Corey Brewer pulling out all the stops to guard Harden ,55,2072,10331,12403,video
CompanyJ_893,Harden and Embiid got into it ,30,967,5464,6431,video
CompanyJ_894,Embiid told Harden to SIT DOWN ,31,3271,14769,18040,video
CompanyJ_895,Corey Brewer tryna take the MVP from Harden with this performance ,66,1219,6606,7825,video
CompanyJ_896,The most entertaining 30 pt blowout ever ,41,1191,8122,9313,photo
CompanyJ_897,Harden was really clipping his nails during the 30 point blowout via JClarkNBCS ,80,483,3670,4153,video
CompanyJ_898,I Have A Dream MLKDay ,22,1083,6388,7471,photo
CompanyJ_899,Klay is 7 7 from 3 and he s feelin it Just flashed the money sign at Floyd Mayweather ,86,1255,8282,9537,video
CompanyJ_900,This man really went 10 10 from three without missing Unreal ,61,2134,12802,14936,photo
CompanyJ_901,OH NO STEPH ,12,16931,65795,82726,video
CompanyJ_902,Klay was unconscious in LA ,27,978,5433,6411,photo
CompanyJ_903,Steph s spill was other worldly ,32,11235,38886,50121,video
CompanyJ_904,Saints vs Rams was recreated in Madden and the refs called pass interference via RoFlo ,87,7137,26821,33958,video
CompanyJ_905,13 years later Kobe Bryant s 81 point game is still mind blowing ,65,3977,12586,16563,video
CompanyJ_906,Stats from Kobe s 81 point game Trailed by 18 in the 3rd Dropped 55 in the 2nd half Outscored teammates by 40 PTS 28 46 FG 7 13 3PT 18 20 FT ,141,2576,9752,12328,photo
CompanyJ_907,July 2018 Usain Bolt begins a trial with an Australian soccer team January 2019 Usain Bolt retires from soccer after playing zero games via brfootball ,151,854,4712,5566,photo
CompanyJ_908,NFL security is investigating reports of Chiefs fans flashing a laser on Tom Brady s face during crunch time of AFC Championship per joedwinell WilliamKMBC ,156,2562,9374,11936,video
CompanyJ_909,Ochocinco s son ChadYoloJ has HANDS via ochocinco ,50,400,2841,3241,video
CompanyJ_910,That handshake via mannypacquiao ,33,8824,49660,58484,video
CompanyJ_911,Tim Howard announces his upcoming season will be his last ,58,780,7081,7861,photo
CompanyJ_912, ,1,1261,10284,11545,photo
CompanyJ_913,Drew Lock was asked about a math test he cheated on in the 9th grade during a draft interview per ChaseGoodbread ,113,1842,13857,15699,photo
CompanyJ_914,Saints fans during the game vs after via damediddyrusell ,57,4559,15848,20407,video
CompanyJ_915,Michael Banks has the heart of a Detroit Lion and has been a super fan for a lifetime Barry Sanders shocked him with a nomination for the ford Fans Hall of Fame ,161,186,1260,1446,video
CompanyJ_916,De Aaron Fox thought he was just trying out Resident Evil 2 Then we sent real zombies in to scare him RE_Games ,111,1325,5798,7123,video
CompanyJ_917,Baseball HOF s Class of 2019 Mariano Rivera Roy Halladay Edgar Martinez Mike Mussina HOF2019 ,93,1241,4090,5331,photo
CompanyJ_918,Memphis will begin listening to trade offers for franchise stars Marc Gasol and Mike Conley per wojespn ,104,862,4862,5724,photo
CompanyJ_919, khalenNOTkaylen is a 320 pound lineman and he backflips like it s nothing via Luke_Spinman ,92,3876,19607,23483,video
CompanyJ_920, Clear eyes full hearts PRO BOWL GridironHeights Playstation ,61,632,3067,3699,video
CompanyJ_921,The Answer wants to see Melo get another shot ,46,811,5377,6188,photo
CompanyJ_922,Russ had Dame stumblin ,23,2828,10844,13672,video
CompanyJ_923,Dirk still got it ,18,3598,26868,30466,video
CompanyJ_924,D Rose on his 2011 MVP season To be honest I think I m a better player now My IQ is higher and I think I got the complete package now ,134,3316,27176,30492,photo
CompanyJ_925,Luka ripped his jersey in half ,31,1772,13378,15150,video
CompanyJ_926,RUSS ,5,2007,9033,11040,video
CompanyJ_927,COOKED EM ,10,3619,21049,24668,video
CompanyJ_928,Booker and Dieng got in a fight and Booker told him to meet him in the tunnel ,78,2742,12808,15550,video
CompanyJ_929, ,1,950,6482,7432,photo
CompanyJ_930,Steph had to explain himself via latelateshow ,46,1210,5673,6883,video
CompanyJ_931,Russ on Evan Turner doing Rock The Baby celebration He can rock right back to Portland via SneakerReporter ,107,1574,7115,8689,video
CompanyJ_932,Serena Williams knocked out of Australian Open by Karolina Pliskova 6 4 4 6 7 5 Pliskova will face Naomi Osaka in the semifinals ,129,265,1359,1624,photo
CompanyJ_933,You can hear Russ and Nurkic fake laughing at each other ,57,2095,13429,15524,video
CompanyJ_934,Dieng told Booker to meet him in the hallway but after the game said it was just to exchange jerseys via sheltonsolum ,118,1917,13007,14924,video
CompanyJ_935,4 years ago today KlayThompson One quarter 37 PTS ,50,2579,15753,18332,video
CompanyJ_936,Gorgui Dieng fought off two security guards after being ejected to get near the Suns locker room where security restrained him again per Gambo987 ,146,371,2577,2948,photo
CompanyJ_937,Pogba joins the McGregor custom suit game via brfootball bokamotoESPN ,70,138,1594,1732,photo
CompanyJ_938,KAT on who would win in a fight I love Devin like a brother but I got Gorgui per ChristopherHine ,97,350,3721,4071,photo
CompanyJ_939,With legend Tim Howard retiring at the end of the season throwback to his World Cup record 15 saves against Belgium via FOXSoccer ,130,368,1960,2328,photo
CompanyJ_940,NFL hopeful Trace McSorley has scouts skeptical because of his size 6 0 205 pounds and lack of an elite arm But the Penn State QB who s broken 10 school records doesn t care How big is Drew Brees ,196,631,4145,4776,photo
CompanyJ_941,Several teams including Dallas have showed interest in acquiring Kemba Walker but Michael Jordan and the Hornets want to re sign him in free agency per ShamsCharania ,166,915,6430,7345,photo
CompanyJ_942, ,1,888,6916,7804,photo
CompanyJ_943,Anthony Davis doesn t intend to request a trade will wait until the off season to make a full evaluation of his future with the Pelicans per ShamsCharania ,155,686,3781,4467,photo
CompanyJ_944,KD opens The Durant Center in Maryland to help low income students get into college and graduate ,97,4588,19417,24005,photo
CompanyJ_945,Stoney Kersh built an entire museum in his house dedicated to the Dallas Cowboys Michael Irvin showed up to nominate him for the ford Hall of Fans ,147,123,505,628,video
CompanyJ_946,Kirby Smart showed up to Lakeview Centennial HS in style via lilcorivert IG ,76,212,968,1180,video
CompanyJ_947,18 year old American Tim Weah has played in 2 matches for Celtic and scored in both via brfootball ,99,339,3221,3560,photo
CompanyJ_948,Rick Holman is so dedicated to the Steelers that at 21 he sold everything he owned to afford season tickets Stoney Kersh has his own Cowboys Ring of Honor and his garage houses a room sized replica of Dallas Which superfan deserves a spot in the Ford Hall of Fans ,264,25,195,220,video
CompanyJ_949,Jamal Adams kept his Pats hate going at Pro Bowl practice via thecheckdown ,75,2167,11752,13919,link
CompanyJ_950,DeAndre Jordan has a new routine at the free throw line He s shooting 68 up from his career average 45 9 ,105,5001,32199,37200,video
CompanyJ_951,When Austin Rivers was a junior in HS he showed up to Celtics practice and challenged KG to a game of one on one via ChrisVernonShow ,133,4543,16454,20997,video
CompanyJ_952,Neymar left today s match with an injury to the same ankle that kept him out last season PSG face Manchester United in the Champions League Round of 16 in 20 days via brfootball ,178,110,585,695,photo
CompanyJ_953,Thon Maker s cousin Makur is a 7 footer with guard skills ,58,2107,12344,14451,video
CompanyJ_954,Lowry was persistent that he didn t foul Then he got T d up ,60,173,1493,1666,video
CompanyJ_955, ochocinco was HYPE getting WR draft prospect Riley Ridley ready for the combine New SimmsAndLefkoe The Show ,109,3799,12958,16757,video
CompanyJ_956,Prayers up for Dipo who had to be stretchered off the floor after an apparent leg injury ,89,3088,17024,20112,video
CompanyJ_957,Oladipo has a serious right knee injury and will have an MRI tomorrow ,70,395,2695,3090,link
CompanyJ_958,21 straight games with 30 points for The Beard and we still have another half to play 36 PTS 9 REBS ,100,2791,15377,18168,video
CompanyJ_959,Players around the league send their best wishes to Victor Oladipo ,67,892,4994,5886,video
CompanyJ_960,Pacers fear Dipo suffered a season ending knee injury that will require surgery per wojespn ,92,679,3589,4268,photo
CompanyJ_961,62 is the record for most points scored at MSG Harden has 49 heading into the 4th ,82,594,3770,4364,photo
CompanyJ_962,SHEESH ,7,7532,29088,36620,video
CompanyJ_963,D Antoni s reaction to this 8 second violation by Rivers ,57,488,4375,4863,video
CompanyJ_964,MSG chanting MVP for Harden Meanwhile Fiz just got ejected ,59,448,2624,3072,video
CompanyJ_965,PJ WYD ,7,1458,7139,8597,video
CompanyJ_966,Harden cooked up 61 at MSG ,27,9030,37234,46264,photo
CompanyJ_967,Harden scored 61 which means Melo s 62 point MSG record still stands ,69,2805,15572,18377,photo
CompanyJ_968,DeRozan gets blocked and the Sixers get the W ,46,518,3166,3684,video
CompanyJ_969,Reggie picked the worst possible time to video bomb ,52,3998,25327,29325,video
CompanyJ_970, ,1,1325,7411,8736,photo
CompanyJ_971, MiddleChild ,13,1262,8799,10061,photo
CompanyJ_972,Damn ,5,3679,18245,21924,video
CompanyJ_973, spidadmitchell is cookin via utahjazz ,39,218,2472,2690,video
CompanyJ_974, spidadmitchell did a little bit of everything in the Jazz W 35 PTS 6 REBS 6 ASTS 2 STLS 2 BLKS ,96,364,2955,3319,video
CompanyJ_975,Classic Pop ,12,2413,19616,22029,photo
CompanyJ_976,5 years ago today Melo dropped 62 at The Garden Career high Knicks franchise record via NBATV ,94,3679,17161,20840,video
CompanyJ_977,DPOY Rudy Gobert Sixth Man Domantas Sabonis MVP B R Midseason NBA Awards ,73,147,1855,2002,photo
CompanyJ_978,They re not allowed to serve anyone not even Tiger Via BStoneKUSI ,66,137,1604,1741,link
CompanyJ_979,Is anybody having a better season than the Beard Ranking the top 100 players this season ,89,93,757,850,photo
CompanyJ_980,What PJ Tucker saw last night ,30,2758,15938,18696,video
CompanyJ_981,Victor Oladipo suffered a ruptured quad tendon in his right knee last night and will undergo surgery The Pacers star is out for the season ,139,1668,7516,9184,photo
CompanyJ_982,Steelers legend James Harrison takes us through his legendary 100 yard INT TD return in the Super Bowl that should never have happened I looked up and I m like Where did all these red jerseys come from ,202,155,1391,1546,photo
CompanyJ_983,Rams HC Sean McVay turns 33 today Graduated from college in 2008 became Bucs assistant WR coach Became Redskins assistant TE coach in 2010 TE coach in 2011 OC in 2014 Became youngest head coach ever in 2017 won Coach of the Year Next week Super Bowl LIII ,255,2621,19906,22527,photo
CompanyJ_984,Don The Bearman Wachter is a 30 year Chicago Bears season ticket holder who even ran the iconic Bear flag onto the field Brian Urlacher surprises him with a nomination him for the ford Hall of Fans ,198,202,1264,1466,video
CompanyJ_985,I mean ,7,586,5365,5951,photo
CompanyJ_986,Don Bearman Wachter loves the Bears so much he dons a bear suit on game day including a real bear head Michael Banks is a retired military man who loves the Lions because their work ethic reminds him of his service Which superfan deserves a spot in the Ford Hall of Fans ,271,20,147,167,video
CompanyJ_987,Stephen A Smith is the favorite br_betting ,43,854,4427,5281,photo
CompanyJ_988,Former No 1 Pick Anthony Bennett is putting up numbers in the G League ,71,1084,7316,8400,video
CompanyJ_989, brandincooks surprised one of the Rams facility staff members with a special gift via RamsNFL ,95,1361,7444,8805,video
CompanyJ_990,The Western Conference All Star starters have been announced ,61,7055,24263,31318,video
CompanyJ_991,The West All Stars now belong to LeBron ,40,2364,7741,10105,video
CompanyJ_992,Your Eastern Conference All Star starters ,42,3017,10754,13771,video
CompanyJ_993,Charlotte s finest Hometown hero Kemba Walker NBAAllStar ,57,1200,5901,7101,photo
CompanyJ_994,See you at the NBAAllStar draft ,32,665,4933,5598,photo
CompanyJ_995, It s kind of surreal KembaWalker reacts to being named an NBAAllStar starter which will be held in Charlotte via NBAonTNT ,123,417,2549,2966,video
CompanyJ_996,Steph gets an assist pregame from lucky fan via NBCSWarriors ,61,1094,8435,9529,video
CompanyJ_997,The HoHighlights Twitter live show is underway with special guest stefondiggs stopping by later ,96,7,41,48,link
CompanyJ_998,Steven Adams tried a euro and failed miserably ,47,1481,9268,10749,video
CompanyJ_999,Boogie is back to getting technicals ,37,610,5317,5927,video
CompanyJ_1000,Stefon Diggs describes his Minneapolis Miracle moment as living a dream via HoHighlights ,89,256,1814,2070,video
CompanyJ_1001,Rondo must be undefeated in King of the Hill via NotoriousOHM ,62,396,3119,3515,video
CompanyJ_1002,Pat Ma Home Boy is going to be throwing the ball with his eyes closed at this pace according to stefondiggs via HoHighlights ,125,102,676,778,video
CompanyJ_1003,The last person Vikings players want dating their sister Stefon Diggs but he says he s the actual victim via HoHighlights ,122,356,2028,2384,video
CompanyJ_1004,No Von Miller trick plays please via NFL ,41,831,7149,7980,photo
CompanyJ_1005,Brodie messed around vs the Pelicans 23 PTS 17 REB 16 AST 1 W ,62,914,5907,6821,photo
CompanyJ_1006,Warriors visit to DC included paying a visit to President Barack Obama via loganmmurdock ,89,1800,10461,12261,photo
CompanyJ_1007, I wake up in a groove Russ leads the league in assists for a reason via royceyoung ,84,624,4125,4749,video
CompanyJ_1008,Wiggins almost ended McGee ,27,1739,11928,13667,video
CompanyJ_1009,KAT s dunk had C Webb hyped on the broadcast ,45,192,2161,2353,video
CompanyJ_1010, SHAQ had no business calling out Chuck on his All Star MVP stat line via NBAonTNT ,83,2552,12612,15164,video
CompanyJ_1011,Rondo has no respect for Okogie s 3 point game ,47,3204,25156,28360,video
CompanyJ_1012,The drama surrounding Antonio Brown has been brewing for years according to an ex teammate Tomlin essentially told the group We ll tolerate it now because of what he brings on the field per JFowlerESPN ,202,395,2522,2917,photo
CompanyJ_1013, Kyrie Kemba Kyrie Ben PG KD AD Jokic The biggest snubs from All Star starters voting ,86,486,4293,4779,photo
CompanyJ_1014,AB making it perfectly clear where he wants to end up ,54,1973,9998,11971,photo
CompanyJ_1015,When you see where his leg is Watch the final round FREE on brlive ,67,567,2015,2582,video
CompanyJ_1016,Liverpool midfielder Gini Wijnaldum caught a guy on his flight tweeting about him via brfootball ,97,591,4827,5418,video
CompanyJ_1017,We know the starters but who makes the cut for the remaining 14 roster spots Predicting the All Star reserves ,110,91,785,876,photo
CompanyJ_1018,Why would you bait Andrew Luck in dodgeball via thecheckdown ,61,1683,16931,18614,video
CompanyJ_1019,Steven Jackson assembled a superteam for the Raiders and his first pick was Nick Foles ,87,202,1587,1789,video
CompanyJ_1020,The NFL has fined Rams CB Nickell Robey Coleman for uncalled helmet to helmet hit on Saints WR Tommylee Lewis per AdamSchefter ,127,1530,7996,9526,photo
CompanyJ_1021,Sabrina Ionescu is the triple double queen of college basketball notching more in her career than any player in history It truly feels like every night she s breaking a new record ,180,126,697,823,photo
CompanyJ_1022,On this day in 2013 LeBron tackled a fan who nailed a ridiculous half court shot via NBATV ,91,9529,60688,70217,video
CompanyJ_1023,Mary Bronco yes that s her real name is a Broncos faithful who dyes her ponytails Denver colors for game day Rodger Avila is a Miami Chaplain who splits his Sundays between preaching and of course his Dolphins Which superfan deserves a spot in the ford Hall of Fans ,266,16,132,148,video
CompanyJ_1024,In sync via luccaabate_ IG ,27,339,3132,3471,video
CompanyJ_1025,Marcus Smart s impression of Tatum is on the money via taylorcsnow ,67,1735,10016,11751,video
CompanyJ_1026,In 2012 Patriots LB Brandon Spikes was in tears after not making the Pro Bowl Tom Brady s response You think I play this s t to go to Pro Bowls We re trying to win rings per RobertKlemko ,187,3615,14577,18192,photo
CompanyJ_1027,Floorball combines soccer and hockey but only the goalie wears pads IFF_Floorball ,82,152,778,930,video
CompanyJ_1028,Why d Bron tag Kyrie though ,28,2967,18217,21184,video
CompanyJ_1029,Dennis Smith Jr has committed to the NBA All Star Slam Dunk Contest in Charlotte per ShamsCharania ,99,1014,5687,6701,photo
CompanyJ_1030,MVP Talk JHarden13 x 1future ,29,5585,13937,19522,video
CompanyJ_1031, SHAQ s throwing the biggest banger of Super Bowl Weekend Next week in Atlanta ,79,362,1583,1945,video
CompanyJ_1032,Brothers Seth Curry and Stephen Curry have been invited to compete in 3 point shooting contest during All Star Weekend in hometown of Charlotte per wojespn and ChrisBHaynes ,173,787,4900,5687,photo
CompanyJ_1033, ,1,5775,26053,31828,video
CompanyJ_1034,Never had a teacher like this via jclarkthejumper ,50,2060,9960,12020,video
CompanyJ_1035,This Jaylen Hands dunk vs ASU was disrespectful ,48,3059,12066,15125,video
CompanyJ_1036,How was Gordon waiting above the rim ,37,309,2582,2891,video
CompanyJ_1037,LeBron s camp would prefer a coaching change and is not too subtle about that per Jackie MacMullan ,99,1217,4435,5652,photo
CompanyJ_1038,Harden ready to go off for 60 PTS tonight via NBA ,50,473,3945,4418,video
CompanyJ_1039,How you look at your boy that wore the same shirt to the party ,63,287,1934,2221,photo
CompanyJ_1040,What is this DLo celebration ,29,486,4730,5216,video
CompanyJ_1041,DLo got T d up from the bench ,30,161,1522,1683,video
CompanyJ_1042,Mo Bamba rejection Terrence Ross one handed alley oop ,54,1129,8988,10117,video
CompanyJ_1043,Giannis got too cocky and missed a wide open dunk ,50,518,4195,4713,video
CompanyJ_1044,Miles Bridges putback Goodness ,31,2437,11045,13482,video
CompanyJ_1045,Mets might have to sign spidadmitchell ,39,546,4459,5005,video
CompanyJ_1046,Swipa step back CLUTCH ,23,1138,6203,7341,video
CompanyJ_1047,Timberwolves had to hold Taj Gibson back as he flipped off ref and got ejected ,79,496,3386,3882,video
CompanyJ_1048,James Harden closing out games on defense shuts down Kawhi ,59,2111,12239,14350,video
CompanyJ_1049,Not an all star starter luka7doncic gets snuffed then hits mean turn around bucket ,83,1487,8941,10428,video
CompanyJ_1050,Lou Williams messed around and got his 1st career triple double in win over the Bulls 31 PTS 10 REB 10 AST ,107,1070,7998,9068,photo
CompanyJ_1051,Original Splash Brothers Steph and Seth Curry will participate in the 3 point contest during All Star Weekend in their hometown of Charlotte per wojespn ,153,1124,8281,9405,photo
CompanyJ_1052,Donovan Mitchell out here throwing fastballs StateFarm ,55,186,2014,2200,video
CompanyJ_1053,Back to back Naomi Osaka defeats Petra Kvitová 7 6 2 5 7 6 4 to become the 2019 Australian Open Champion ,105,731,4150,4881,photo
CompanyJ_1054,Did him dirty while he was down via adam_ch09 IG ,49,1652,12413,14065,video
CompanyJ_1055, KendallCoyne was the first woman to participate in the NHL All Star Fastest Skater competition She did not disappoint via NHLonNBCSports ,138,346,2779,3125,video
CompanyJ_1056,Something about Emirates makes JesseLingard want to dance Dec 2 2017 2 goals 1 milly rock and the W 3 1 Jan 25 2019 1 goal 1 moonwalk and the W 3 1 ,148,192,1091,1283,photo
CompanyJ_1057,Jabari Parker was once considered the best high school player since LeBron James Six years and two NBA teams later Parker and the Bulls appear headed for a near certain divorce They ll try to trade him for anything they can get ,228,550,3068,3618,photo
CompanyJ_1058, Tough times don t last tough people do Dipo sends a message to his fans ,73,7239,36836,44075,photo
CompanyJ_1059,He tried to stay up via BigTenNetwork ,38,1071,5735,6806,video
CompanyJ_1060,Zion Williamson isn t just the heavy favorite to go No 1 in the 2019 draft he could be the best pick in a decade ,113,790,6040,6830,photo
CompanyJ_1061,Mavs legend Dirk Nowitzki will participate in the All Star 3 point contest per ShamsCharania ,93,3873,29245,33118,photo
CompanyJ_1062,Game winner is better in slo mo via ty gage tjma3 Instagram ,60,498,3679,4177,video
CompanyJ_1063,Tic Tac Toe drills are the new wave via BroncoSportsHP ,55,5779,26386,32165,video
CompanyJ_1064,Citadel court storm after buzzer beating game winner via loganreever ,69,155,1230,1385,video
CompanyJ_1065, First dunk in 6th grade Most iconic dunk contest 2000 Jumped over 7 2 defender GOAT in game dunker Still throwing down at 42 Vince Carter has been defying gravity all his life ,177,2636,13096,15732,photo
CompanyJ_1066,355 pound bench press She s 15 via Mahailya3 ,45,8877,43072,51949,video
CompanyJ_1067,JuJu hooked up everybody in the store with some shoes via cowboycollazo2k IG ,77,3395,25579,28974,video
CompanyJ_1068,Steph ready to light it up at TD Garden via NBA ,48,995,7412,8407,video
CompanyJ_1069,Cole Anthony and Oak Hill took over Cali s Nike Extravaganza ,61,170,1229,1399,video
CompanyJ_1070,Quinn Cook has VO4 written on both his shoes tonight to support former high school teammate and long time friend VicOladipo brkicks anthonyVslater ,147,312,2534,2846,photo
CompanyJ_1071,Bryn Forbes lost his shoe and then missed a point blank layup ,62,189,1574,1763,video
CompanyJ_1072,Ben Simmons plans to compete in the Slam Dunk contest at NBAAllStar Weekend per PompeyOnSixers ,95,580,3055,3635,video
CompanyJ_1073,Ben Simmons now says that he was joking about planning to be in the Slam Dunk Contest per PompeyOnSixers ,105,323,2128,2451,link
CompanyJ_1074,Boogie running the break with a no look to KD via NBA ,54,659,5468,6127,video
CompanyJ_1075,Four straight 3s in under two minutes Can t blink with this guy ,64,480,3392,3872,photo
CompanyJ_1076,Corey Brewer accidentally kicked Torrey Craig in the head after hanging on the rim ,83,1923,10026,11949,video
CompanyJ_1077,Gary Harris went playground on this dunk ,41,968,6144,7112,video
CompanyJ_1078,Kyrie is RIDICULOUS via Celtics ,32,5085,22537,27622,video
CompanyJ_1079,Steph hit the shimmy before the 3 pointer went in ,50,3392,18088,21480,video
CompanyJ_1080,This matchup always delivers Steph 24 PTS 6 12 3PT W Kyrie 32 PTS 10 AST 6 REB ,79,843,4866,5709,photo
CompanyJ_1081,KD really waited till the buzzer to attempt a shot and save his FG ,67,384,3774,4158,video
CompanyJ_1082, BEN TOOK A 3 ,14,1160,7484,8644,video
CompanyJ_1083,Nothing but respect between Kyrie and Steph ,44,760,6018,6778,video
CompanyJ_1084,Kerr is now 300 77 in the regular season ,41,1504,9643,11147,photo
CompanyJ_1085,Wilson Chandler left Jokic hanging for a disrespectful amount of time ,70,2811,21245,24056,video
CompanyJ_1086,CJ posted his 1st career triple double in the win over the Hawks 28 PTS 10 REB 10 AST ,86,623,6671,7294,photo
CompanyJ_1087,Novak Djokovic defeats Rafael Nadal in straight sets becomes first man to win 7 titles at Australian Open via DjokerNole ,121,375,2178,2553,video
CompanyJ_1088,There was nobody like Sean Taylor This hit at the 2006 Pro Bowl is still wild via nflthrowback ,95,10735,39488,50223,video
CompanyJ_1089,Bill Belichick was hired as Patriots head coach 19 years ago today His HC resume at the time 36 44 record 1 playoff win Resigned from Jets after one day ,153,670,3964,4634,photo
CompanyJ_1090,Joker dropped 32 18 10 and then made time for some young fans postgame via TJMcBrideNBA ,88,1368,11679,13047,video
CompanyJ_1091,7 goals in 7 straight league games 19 goals in 19 league games overall Unreal ,78,663,4037,4700,photo
CompanyJ_1092,WWE superstar Nia Jax wasn t prepared for the frenzy that rose around her after she punched Becky Lynch in the face in November causing her to bleed everywhere Unsure of her next move she called her cousin Dwayne The Rock Johnson ,230,58,344,402,photo
CompanyJ_1093,Brady leads a We re still here chant then flings the mic He s READY via Patriots ,81,2374,12194,14568,video
CompanyJ_1094,Knocked out of 2 competitions in 4 days Kane and Dele injured Rough week for Tottenham ,87,129,1099,1228,photo
CompanyJ_1095,OBJ Colts mascot at the Pro Bowl never gets old via BWesterblade ,65,8071,36740,44811,video
CompanyJ_1096,Randy Moss put on an MVP performance at the Pro Bowl in 2000 9 catches 212 yards record Touchdown via nflthrowback ,115,1259,6249,7508,video
CompanyJ_1097,There is concern about the NFL s judgement in using four refs who live in Southern California to work Saints Rams after league admits it f ked up the PI call per AdamSchefter ,175,856,4245,5101,photo
CompanyJ_1098,Brady isn t finished yet ,25,3388,16155,19543,photo
CompanyJ_1099,Mark Cuban is willing to play in the NBAAllStar Celebrity game if the NBA lets LaVar join him via LandonBuford ,111,1585,10089,11674,video
CompanyJ_1100,IT giving his son a serious postgame interview is so wholesome via IsaiahThomas ,80,2935,17524,20459,video
CompanyJ_1101,Boban s hands make a softball look like a tennis ball Wild ,59,786,6350,7136,video
CompanyJ_1102,CP3 is officially back tonight after missing 17 games ,54,741,5411,6152,photo
CompanyJ_1103,The Pro Bowl MVP trophy literally broke ,40,1333,10772,12105,photo
CompanyJ_1104,Melo is expected to be at tonight s Knicks Heat game in New York per Anthony_Chiang ,84,414,3039,3453,photo
CompanyJ_1105,Swipa breaks down his love for Dragon Ball Z via Farbod_E ,58,629,3710,4339,video
CompanyJ_1106,D Wade getting in on the wave via TheJaxShow ,45,1474,6871,8345,video
CompanyJ_1107,Luka and DSJ getting the chemistry up ,38,1399,8377,9776,video
CompanyJ_1108,D Wade showing love to Melo pregame at MSG ,43,1031,7285,8316,video
CompanyJ_1109,Steven Adams got the euro to go this time via okcthunder ,57,1125,7045,8170,video
CompanyJ_1110,Melo and MSG give D Wade a warm welcome as he checks in OneLastDance ,69,687,4807,5494,video
CompanyJ_1111,MSG gives Melo a standing ovation ,34,4958,29793,34751,video
CompanyJ_1112, This is home Melo talks returning to MSG and watching D Wade finish out his career ,84,1023,6153,7176,video
CompanyJ_1113,PG ON GIANNIS WOW ,18,6392,22451,28843,video
CompanyJ_1114,RATED R ,8,6455,29666,36121,photo
CompanyJ_1115,NY state of mind ,17,409,3428,3837,photo
CompanyJ_1116,Ref might be the only one on the floor afraid of KAT ,53,1186,9846,11032,video
CompanyJ_1117,Another Harden step back dagger and another 30 point game 40 PTS 11 REBS 6 ASTS ,80,2148,11203,13351,video
CompanyJ_1118,JR Smith at MSG as well That hat ,33,1584,13078,14662,video
CompanyJ_1119,Luka s making history already ,30,1112,6486,7598,photo
CompanyJ_1120,Devin Booker falling out of bounds Sheesh ,42,1086,7380,8466,video
CompanyJ_1121,What is Lance doing ,20,3919,25589,29508,video
CompanyJ_1122,13 years old and already going showtime via CoachGeno41 mymaddy3 Instagram ,75,492,2849,3341,video
CompanyJ_1123,These fans really got Bron to acknowledge them from the rafters via SamiSullivan94 ,83,13200,73214,86414,video
CompanyJ_1124,LANCE ,6,3859,18292,22151,video
CompanyJ_1125,Anthony Davis has requested a trade and told the Pelicans he has no intention of signing an extension if offered per wojespn ,125,13290,49637,62927,photo
CompanyJ_1126, It s time ,11,6099,28524,34623,photo
CompanyJ_1127,Neymar will miss both of PSG s Champions League games against Manchester United is out until at least the end of March per lequipe ,131,282,1236,1518,photo
CompanyJ_1128, Blown PI call leads to Saints NFC CG loss Anthony Davis requests trade Tough week for New Orleans sports fans ,111,3936,20611,24547,photo
CompanyJ_1129,Lakers have to start AD trade by offering Lonzo Kuzma Ivica Zubac and No 1 pick per BA_Turner ,94,2428,10557,12985,photo
CompanyJ_1130,Who gets to stay in Hollywood ,30,2712,18583,21295,photo
CompanyJ_1131,MVP Watch for Paul George Averaging career highs in PTS and REB 1st in total steals 3rd in 3PM Thunder sit at 3rd in the West DPOY candidate ,141,5608,28283,33891,photo
CompanyJ_1132,Rams DB Nickell Robey Coleman goes off on facing the arrogance of the Patriots and a beatable Tom Brady in the Super Bowl Put the dagger in them pull it out and let them leak slow ,180,445,2182,2627,photo
CompanyJ_1133,LaMelo was dropping dimes while Rocket Watts scored 29 as SPIRE picked up another easy win ,91,753,6074,6827,video
CompanyJ_1134, ,1,58447,188018,246465,video
CompanyJ_1135,Lakers Knicks Clippers Trade packages and landing spots for AD ,63,292,2033,2325,photo
CompanyJ_1136,Anthony Davis told coach Alvin Gentry he plans on playing out this season after trade request per _Andrew_Lopez ,112,918,4135,5053,photo
CompanyJ_1137,Messi on top via brfootball ,28,614,4023,4637,photo
CompanyJ_1138,The Colts O Line dominated the line all season SimmsandLefkoe thinks they deserve the Ford Offensive Line of the Year Award From B R x FordTrucks ,146,62,409,471,video
CompanyJ_1139,Marshawn Lynch showed up to Super Bowl media day in 2015 just so he didn t get fined via nflthrowback ,102,12013,46295,58308,video
CompanyJ_1140,Celtics are not a top target for Anthony Davis growing belief Kyrie might not re sign per ChrisBHaynes ,103,1640,6450,8090,photo
CompanyJ_1141,Tom Brady talking about his dad at Super Bowl media day 2017 via thecheckdown ,78,1269,8966,10235,video
CompanyJ_1142,Bron getting healthy locked in from deep via taniaganguli ,58,2245,11886,14131,video
CompanyJ_1143,Watching PG 13 dunk on Giannis from here via thunderbeast405 IG ,64,1440,9359,10799,video
CompanyJ_1144,Pelicans want the league to strictly enforce the tampering rules as they deal with AD s trade request per wojespn ,114,1316,7584,8900,photo
CompanyJ_1145,KD is giving back to his hometown with the Durant Center It s one of the greatest accomplishments so far in my career ,118,1221,6739,7960,video
CompanyJ_1146,The King s ready to make his return ,36,1427,7639,9066,photo
CompanyJ_1147,Trae Young says he will be better than Luka Doncic in 5 10 years In my eyes it s not a question But that s just the competitive nature in my blood per Rachel__Nichols ,167,597,4778,5375,photo
CompanyJ_1148,Wade Phillips a 1future fan I ve been poppin since my demo via RamsNFL ,71,3204,10843,14047,video
CompanyJ_1149, I ll be back better than ever Everybody stay feathery VicOladipo has a special message for all his supporters and fans after surgery via Pacers ,145,1949,12078,14027,video
CompanyJ_1150,In 1996 Spurs GM Gregg Popovich fired Bob Hill and made himself head coach Today he turns 70 with 5 titles 3rd most wins 3rd most playoff wins 21 straight postseason appearances ,178,6556,28878,35434,photo
CompanyJ_1151,Boogie gave the Warriors a scare after taking a hard foul He s okay though ,75,705,5760,6465,video
CompanyJ_1152,Jim Brown Barry Sanders Champ Bailey is in awe to be among the greats ford ,75,49,430,479,video
CompanyJ_1153,Steph was so excited for Klay he fell over ,43,4180,20681,24861,video
CompanyJ_1154,Steph just side stepped a 35 footer at the buzzer Insane ,57,4933,25992,30925,video
CompanyJ_1155,Tom Brady isn t giving Jared Goff any advice via NFL ,53,3530,21699,25229,photo
CompanyJ_1156,History for Steph Curry becomes the first player with 7 straight seasons of at least 200 made threes ,101,910,4845,5755,photo
CompanyJ_1157,Gronk looks ready for the Super Bowl via nflnetwork ,52,845,5107,5952,photo
CompanyJ_1158,If Lakers Pelicans trade talks pick up Lonzo s camp prefers him to be moved to a third team that doesn t have an established PG per ShamsCharania ,146,1250,6785,8035,photo
CompanyJ_1159,McVay is ready to go to battle with Goff Wrangler ,50,101,1070,1171,video
CompanyJ_1160,The Grizzlies blew a 25 point lead Then this sequence cost them the game Cold ,78,1319,7571,8890,video
CompanyJ_1161,This Texas Tech run ,20,1214,7070,8284,video
CompanyJ_1162,Trae Young from the parking lot ICE COLD ,41,1822,13538,15360,video
CompanyJ_1163,If Warriors don t offer Klay a max contract his attention could turn to LA if Lakers land Anthony Davis per wojespn ,116,5256,25242,30498,photo
CompanyJ_1164,Multiple people around the league expect Rich Paul and Anthony Davis to tell teams his preferred destination is the Lakers per wojespn ,135,3337,16787,20124,photo
CompanyJ_1165,Two Hundred Ninety Three via brfootball ,40,446,2395,2841,photo
CompanyJ_1166,In his last three games Zion has more offensive rebounds 11 than missed shots 7 h t wingoz ,91,1052,8287,9339,photo
CompanyJ_1167,Pro football HOF finalist Champ Bailey s favorite play of his career When I picked off Brady and went 100 yards ford ,117,123,948,1071,video
CompanyJ_1168,Raptors and Bucks are expected to make offers for Anthony Davis before the deadline per KevinOConnorNBA ,104,1344,6196,7540,photo
CompanyJ_1169,Are you cut out to be a Lumberjack World Champion ,50,155,1266,1421,video
CompanyJ_1170,This 9 year old plays against 11 year olds and dominates them via jaylanmoore12 brfootball ,91,1184,7974,9158,video
CompanyJ_1171, ,1,696,6913,7609,photo
CompanyJ_1172,The eyebrow at the end via J1MM3R_ ,35,12864,59472,72336,video
CompanyJ_1173,The Patriots are paying for Josh Gordon s drug treatment and a return to the team in the future is possible per DougKyed ,121,2462,14086,16548,photo
CompanyJ_1174,Clemson WR Tee Higgins cleared his defender via teehiggins5 chasebrice7 ,72,854,4642,5496,video
CompanyJ_1175,Joel Embiid on making his 2nd All Star Game A lot of you guys said I was never going to play via sixers ,104,944,6565,7509,video
CompanyJ_1176,When 17 year old Messi put 4 past Sevilla in 2004 via FCBarcelona ,66,1299,8711,10010,video
CompanyJ_1177,Brandin Cooks is paying for a Rams janitor and his son to attend the Super Bowl I just felt like it would be special for him to see that he is a part of this success per ByMikeJones ,182,5055,38870,43925,photo
CompanyJ_1178,Trading Gasol and Conley is the only way forward for Memphis says HowardBeck and it s long overdue ,99,236,1528,1764,video
CompanyJ_1179,Source close to Celtics says Kyrie is genuinely interested in reuniting with LeBron That is for real per RicBucher ,115,10079,32584,42663,photo
CompanyJ_1180, Knicks have strong chance at KD if he leaves Warriors AD is open to New York Porzingis centered NYK package is better than Lakers League sources help RicBucher break down the chaotic trade deadline ,199,685,2777,3462,photo
CompanyJ_1181,NBA has fined Anthony Davis 50k for violating the CBA when his agent Rich Paul went on record requesting a trade per ShamsCharania ,131,1276,6134,7410,photo
CompanyJ_1182, Check your Venmo ,18,10040,58014,68054,photo
CompanyJ_1183,Russ on the beat via okcthunder ,32,2113,11812,13925,video
CompanyJ_1184,NFL HOF Finalist Ed Reed says he only stayed at Miami for his senior season because he knew the Canes would be unbeatable Ford ,127,303,1423,1726,video
CompanyJ_1185,The two minute GridironHeights Super Bowl special drops Thursday at 8pm ET ,75,63,517,580,photo
CompanyJ_1186,Russ had the whole team recreating his euro ,44,5014,22873,27887,video
CompanyJ_1187,Luka Trae Kuz and Tatum headline this year s MTNDEWICERisingStars Full rosters ,79,198,1719,1917,photo
CompanyJ_1188,Rams WR Brandin Cooks gifting the team custodian with a pair of tickets to the Super Bowl is what it s all about via RamsNFL ,125,27441,128025,155466,video
CompanyJ_1189,Delly mic d up ,15,3283,22079,25362,video
CompanyJ_1190,Jah is really ballin out again ,31,2750,18056,20806,video
CompanyJ_1191,J Cole will perform at halftime of the NBA All Star Game in his home state of North Carolina ,93,8817,40084,48901,photo
CompanyJ_1192,James Harden went 11 32 tonight But he still scored 37 points and extended his 30 point streak to 24 ,101,633,5299,5932,photo
CompanyJ_1193,AD may have requested a trade but he s still helping out the Pels coaching staff ,81,471,4256,4727,video
CompanyJ_1194,Harden thought he got fouled so he just ran out of bounds ,58,1406,8843,10249,video
CompanyJ_1195,Rudy Gay called game ,21,3043,12491,15534,video
CompanyJ_1196,Jimmy ,6,2927,13678,16605,video
CompanyJ_1197,Ingram stood over Corey Brewer and laughed ,43,8182,36266,44448,video
CompanyJ_1198,Pop was not happy with the Spurs after their 126 124 win over the Suns Phoenix got robbed via EvanClosky ,105,812,5585,6397,video
CompanyJ_1199,Scary fall for Joel Embiid Hoping he s ok ,42,558,6188,6746,video
CompanyJ_1200,PSG confirm Neymar s injury will keep him out for 10 weeks He will miss both UCL games against Manchester United and the quarter finals if PSG go through ,154,212,1431,1643,photo
CompanyJ_1201,Anthony Davis is putting up a stat line we haven t seen since Kareem in 1972 73 Has any player who s ever been traded been as good as he is right now ,150,215,1827,2042,photo
CompanyJ_1202,Ingram really did that via ashleysung IG ,41,11713,54468,66181,video
CompanyJ_1203,Ed Reed is staying humble with his Pro Football HOF nomination Just being in that talk is enough for me ford ,109,444,2656,3100,video
CompanyJ_1204,Jimmy Butler picks his soccer GOAT via brfootball ,50,466,3604,4070,photo
CompanyJ_1205, Mike Jones made the tackle 19 years ago today the Rams LB stopped Kevin Dyson on the last play of Super Bowl XXXIV The Greatest Show on Turf won the title on a defensive play via NFLGameDay ,191,1373,6966,8339,video
CompanyJ_1206,Greatest champion Russell Leading scorer Kareem Most dominant Wilt Shaq Embiid and others are asking Why does the GOAT always have to be a guard ,145,647,3700,4347,photo
CompanyJ_1207,Talk your talk then JoelEmbiid ,31,1492,10117,11609,photo
CompanyJ_1208,Jason Frederick who plays on a basketball team for kids with special needs hits an incredible 3 with a celebration to match via calmaxpack ,139,937,6378,7315,video
CompanyJ_1209,Pelicans GM Dell Demps isn t ready to engage in trade talks regarding AD yet so he s not picking up his phone per mcten ,120,436,2537,2973,photo
CompanyJ_1210,Brandin Cooks already won Super Bowl week with this gesture ,60,617,4903,5520,video
CompanyJ_1211,Shaq finds it disrespectful LeBron has jumped Kobe in the GOAT convo ,69,4839,14097,18936,photo
CompanyJ_1212,Lonzo Ball s preference would be for the Lakers to find a third team for him like Chicago or New York if he s included in a trade deal for Anthony Davis per taniaganguli ,170,1172,7046,8218,photo
CompanyJ_1213,Comeback 6 1 win via brfootball ,32,1130,6824,7954,photo
CompanyJ_1214,Gronk hinting at retirement ,28,452,4602,5054,photo
CompanyJ_1215,Two Hornets aren t enough to stop Tatum ,40,846,6484,7330,video
CompanyJ_1216,Dirk s loved everywhere ,24,1181,9313,10494,video
CompanyJ_1217,Dirk had some big career nights at the Garden ,46,1198,6072,7270,video
CompanyJ_1218,The Pels already took AD out of their intro vid Petty ,54,1039,4937,5976,video
CompanyJ_1219,Kevin Garnett is STILL making money from his Celtics contract 5M a year until 2024 turbotax ,92,6388,22687,29075,video
CompanyJ_1220, We want Kanter chants turn into Enes kissing MSG s logo when checking in after a few DNP ,90,641,4597,5238,video
CompanyJ_1221,Sheesh Tatum ,13,5694,32350,38044,video
CompanyJ_1222,Pelicans have no interest in trading AD to the Lakers right now per wojespn ,76,1670,8773,10443,photo
CompanyJ_1223,Jarvis Landry s going with the Rams to win the big game on Sunday Super Bowl episode of simmsandlefkoe drops Friday at 5pm et ,126,46,437,483,video
CompanyJ_1224,Jokic stay running up on the ref ,33,198,2072,2270,video
CompanyJ_1225,Dirk put up a season high 14 points tonight and the MSG crowd was loving it ,76,1563,11621,13184,video
CompanyJ_1226,KAT BALLGAME ,13,1229,8174,9403,video
CompanyJ_1227,CJ making shots without even trying via NBA ,44,435,4114,4549,video
CompanyJ_1228,Reunited ,9,9707,58266,67973,photo
CompanyJ_1229, If this is it I m gonna miss you guys Dirk stayed after all his teammates to sign autographs for the MSG locker room attendants via townbrad ,142,1149,10113,11262,video
CompanyJ_1230,Bagley GOT UP ,14,344,3283,3627,video
CompanyJ_1231,Vince was tight about the foul till he realized he taught Giles the move ,73,4894,33830,38724,video
CompanyJ_1232,Happy birthday Jackie Robinson The Major League Baseball legend would have been 100 today ,90,14169,62204,76373,photo
CompanyJ_1233,Will the Patriots win their 6th ring Will Brady win his 5th MVP Super Bowl LIII picks and predictions ,102,102,976,1078,photo
CompanyJ_1234,McVay and the Rams are riding high heading to the Super Bowl turbotax ,70,225,1401,1626,video
CompanyJ_1235,16 year old Zaire Wade has been putting in work ,48,2373,12831,15204,video
CompanyJ_1236,Jimmy Butler sat down with B R and addressed everything On free agency I don t even know what I m going to have for lunch tomorrow On bullying KAT I don t think that s a good choice of words ,191,187,1413,1600,photo
CompanyJ_1237,JuJu on the Steelers next season We need to stop being Kardashians and just play ball per FirstTake ,100,2398,18466,20864,photo
CompanyJ_1238,Kristaps Porzingis expressed his concern about losing and team direction in a meeting with Knicks management today per wojespn ,127,829,5525,6354,photo
CompanyJ_1239,Magic Johnson presented Dell Demps five different trade scenarios is waiting to hear back which he s most interested in per BA_Turner ,134,1612,6145,7757,photo
CompanyJ_1240,In today s meeting with management Kristaps Porzingis gave the Knicks the impression that he prefers to be traded per wojespn ,126,1276,6994,8270,photo
CompanyJ_1241,Wonder how he s feeling right now ,34,359,2412,2771,photo
CompanyJ_1242,The Nets Clippers Heat Spurs and Raptors are all interested in exploring trades for Kristaps Porzingis per wojespn ,115,641,3283,3924,photo
CompanyJ_1243,New Orleans should trade Anthony Davis in July and not a minute sooner according to HowardBeck ,95,262,1719,1981,video
CompanyJ_1244,The Knicks are finalizing a deal to send Kristaps Porzingis to the Mavs per ShamsCharania ,90,4218,12762,16980,photo
CompanyJ_1245,,0,3065,13833,16898,photo
CompanyJ_1246,Last time Luka and Porzingis were on the same court ,52,1162,6494,7656,photo
CompanyJ_1247,Knicks would get Dennis Smith Jr and expiring contracts of DeAndre Jordan and Wes Matthews in the proposed trade per TheSteinLine ,130,958,3893,4851,photo
CompanyJ_1248,Tryna process everything that s going on in the NBA right now ,62,5699,17995,23694,photo
CompanyJ_1249, Save my spot on the plane tonight ,35,3374,15242,18616,photo
CompanyJ_1250,Knicks fans right now ,22,12136,34627,46763,video
CompanyJ_1251,Porzingis will inform the Mavs of his intention to sign a qualifying offer in restricted free agency per ShamsCharania Which means he s going to be an UFA in 2020 ,163,805,4006,4811,photo
CompanyJ_1252,New York s only hope ,21,2255,10418,12673,photo
CompanyJ_1253, ,1,8418,31266,39684,video
CompanyJ_1254,Rough week for these kids via MattEstreich ,43,1574,8900,10474,photo
CompanyJ_1255,New duo in Dallas ,18,9252,41903,51155,photo
CompanyJ_1256,J Cole approves of the trade ,29,695,5689,6384,photo
CompanyJ_1257,3x Super Bowl Champ and 5x Pro Bowler Ty Law says the Pats built their dynasty on defense before Brady became the GOAT Ford ,124,75,494,569,video
CompanyJ_1258,Old school New school Kristaps has new threads and a new mentor from B R and americanexpress ,93,474,3375,3849,video
CompanyJ_1259,Your 2019 Eastern Conference NBAAllStar Reserves ,49,632,2449,3081,photo
CompanyJ_1260,Your 2019 Western Conference NBAAllStar Reserves ,49,634,2355,2989,photo
CompanyJ_1261,Rudy Gobert misses out on a 1M bonus for not being selected to the All Star game per BobbyMarks42 ,98,485,2772,3257,photo
CompanyJ_1262, Well this is awkward ,22,1181,8404,9585,link
CompanyJ_1263,Chuck was heated over the AD trade request We cannot have players and agents colluding to stack super teams via NBAonTNT ,121,1536,7907,9443,video
CompanyJ_1264,Who got robbed ,15,872,6909,7781,photo
CompanyJ_1265,Jokic s nickname is officially Big Honey now via NBAonTNT ,58,407,2430,2837,video
CompanyJ_1266,Tom Brady is Thanos and he just found the final Infinity Stone GridironHeights x Super Bowl special playstation ,112,6979,16440,23419,video
CompanyJ_1267,LeBron is back ,15,24079,62474,86553,video
CompanyJ_1268,Is this the moment Luka found out he didn t make the NBAAllstar team ,69,1528,10243,11771,video
CompanyJ_1269,And so it begins ,17,441,4217,4658,link
CompanyJ_1270,Spurs fans started a Manu chant after Bats took over the court ,63,1797,8576,10373,video
CompanyJ_1271,DSJ and DeAndre get a new look for their next game in MSG from B R and americanexpress ,87,349,2390,2739,video
CompanyJ_1272,Emotional moment for KarlTowns and his family after finding out he s been selected for his 2nd All Star game via ChuckyAnthony ,127,1041,6274,7315,video
CompanyJ_1273,Checking in on Reggie and Blake in Detroit ,43,4283,22133,26416,video
CompanyJ_1274,Nets really made Rondae sit all the way over there ,51,520,4294,4814,video
CompanyJ_1275,It really is too easy for Steph ,32,583,4310,4893,video
CompanyJ_1276,Boogie staredown Embiid is having none of that ,47,1077,8237,9314,video
CompanyJ_1277, ,1,1463,8403,9866,photo
CompanyJ_1278,Embiid threw down a windmill and Boogie was impressed ,54,926,7631,8557,video
CompanyJ_1279,Tyson drew a chalk line around Rondo like it was a crime scene ,63,1672,13110,14782,video
CompanyJ_1280,Draymond went all out to defend Boogie after controversial call ,64,605,4797,5402,video
CompanyJ_1281,Bron just pulled off the Harden step back ,42,4434,27383,31817,video
CompanyJ_1282,Lance always living his best life ,34,3754,18872,22626,video
CompanyJ_1283,El Clasico in the Copa del Rey semifinals ,42,219,1197,1416,photo
CompanyJ_1284,Julius Peppers has announced his retirement from the NFL after 17 years in the league Incredible career for the Panthers DE No 2 Draft Pick in 2002 NFL DROY 9x Pro Bowl 3x First Team All Pro 2000s All Decade team No 4 in NFL Career Sacks 159 5 ,244,6963,36568,43531,photo
CompanyJ_1285,The Patriots are coming TurboTax ,33,289,1288,1577,video
CompanyJ_1286,The NFL is the only major league that crowns its champion on a neutral site but players and fans deserve home field advantage ,126,175,1239,1414,video
CompanyJ_1287,Utah and Memphis have had exploratory discussions on a potential swap that includes Mike Conley and Ricky Rubio per TheSteinLine ,129,598,2962,3560,photo
CompanyJ_1288,The 6 biggest snubs from this year s NBA All Star roster ,57,66,731,797,photo
CompanyJ_1289,Kyrie Irving when asked about his future with the Celtics Oct 4 2018 If you guys will have me back I plan on re signing here Feb 1 2019 Ask me July 1 I don t owe anybody s t ,174,12712,54344,67056,photo
CompanyJ_1290,Boston isn t a preferred destination for Anthony Davis but remains a rental option per ShamsCharania ,101,796,4369,5165,photo
CompanyJ_1291,Either the Knicks are getting Kevin Durant or they just made the worst trade in history According to a rival exec it s option 1 They re pretty sure they re getting KD ,167,852,3746,4598,photo
CompanyJ_1292,Oh ,3,4441,23392,27833,photo
CompanyJ_1293,Ty Law is knocking on the Hall of Fame s door partly because he spent his life learning from a Hall of Famer Ford ,114,61,377,438,video
CompanyJ_1294,Anthony Davis is focused on the Lakers as his top trade destination while also listing the Knicks as a preferred landing spot per ShamsCharania ,144,1847,7733,9580,photo
CompanyJ_1295,Legendary skier Lindsey Vonn has called it a career 82 World Cup wins 20 World Cup titles 3 Olympic medals ,107,667,6142,6809,photo
CompanyJ_1296,The NBA has added Dirk Nowitzki and Dwyane Wade as special roster additions to play in the All Star Game ,105,5206,26632,31838,photo
CompanyJ_1297,JR fanning the flames ,22,704,3918,4622,photo
CompanyJ_1298,You think you eat a lot of wings on Super Bowl Sunday Full time competitive eater Molly Schuyler once ate 501 in 30 mins without chewing ,137,99,518,617,photo
CompanyJ_1299,Blake went full Jackie Moon via shaqtin ,40,7095,27029,34124,video
CompanyJ_1300,Rudy Gobert left in tears while discussing his All Star snub via tribjazz ,74,2126,13385,15511,video
CompanyJ_1301,Anthony Davis spoke on the trade rumors It s my time I feel like I gave this city all I could Intends to play this season when he s healthy We never wanted it go public via _Andrew_Lopez ,187,521,2817,3338,photo
CompanyJ_1302,10 years ago today Steelers vs Cardinals in Super Bowl XLIII became an instant classic via NFLThrowback ,104,2538,10591,13129,video
CompanyJ_1303, Hopefully he just plays like he used to before I taught him everything Bragging rights are on the line for former Bulldogs Todd Gurley and Sony Michel ,152,637,3493,4130,video
CompanyJ_1304,Super Bowl LIII is already one for the record books ,52,447,3173,3620,video
CompanyJ_1305,Four years ago today Malcolm Butler made one of the greatest plays in football history after the Seahawks chose not to run the ball via nflthrowback ,149,1386,6537,7923,video
CompanyJ_1306,D Angelo Russell has been selected to replace Victor Oladipo as a reserve in the All Star game per ShamsCharania ,113,4269,20835,25104,photo
CompanyJ_1307,In 2017 Magic Johnson said the Lakers needed a leader and traded D Lo Russell this year Career high PPG 19 6 Career high AST 6 4 Nets in the playoff race First All Star berth ,175,11713,52651,64364,photo
CompanyJ_1308,Gobert heard Draymond talking ,30,3012,15392,18404,photo
CompanyJ_1309,Triple H said there could be a future for Gronk in WWE ,55,322,2390,2712,photo
CompanyJ_1310,Rick Pitino says former Grizzlies guard Nick Calathes is a better passer than Magic Johnson and Larry Bird via EuroLeague ,122,279,1622,1901,video
CompanyJ_1311,New drill alert via SUNYAdkBaseball ,36,816,4326,5142,video
CompanyJ_1312,AD speaks ,10,3146,18024,21170,photo
CompanyJ_1313,Giannis working on his range Via jdrpeterson ,45,431,3667,4098,video
CompanyJ_1314,Never seen a game of dodgeball end like this via manuel1532011 ,63,598,3070,3668,video
CompanyJ_1315,Kristaps Porzingis unlikely to play for Mavericks this season as he continues recovery from torn ACL last year per espn_macmahon ,129,353,2594,2947,photo
CompanyJ_1316, ochocinco s reaction to finding out terrellowens middle name is Eldorado caesarspalace Simmsandlefkoe The Show Super Bowl special ,131,343,1503,1846,video
CompanyJ_1317,The NBA has taken over Super Bowl week AD s public trade request Porzingis trade Kyrie Bron reunion rumors Pelicans ignoring Lakers Kyrie KD Knicks buzz Bron s return from injury Warriors and Gobert fighting All Star reserves replacements ,239,2926,12475,15401,photo
CompanyJ_1318, ,1,5624,31089,36713,photo
CompanyJ_1319, We want Kyrie chants took over MSG via JakeKilgore ,52,1284,7250,8534,video
CompanyJ_1320,MSG let it be known for Kyrie ,30,701,4795,5496,video
CompanyJ_1321,Kyrie calls out to dad to get jersey after game at MSG ,55,3659,23236,26895,video
CompanyJ_1322,This Russ mug ,14,2641,15491,18132,video
CompanyJ_1323,PG x D Wade jersey exchange ,28,5395,33635,39030,video
CompanyJ_1324,PG continued his hot streak with 43 PTS vs the Heat ,52,1265,7674,8939,video
CompanyJ_1325,What you gonna do KingJames ,28,1444,13918,15362,photo
CompanyJ_1326,James Harden kept his 30 PTS streak alive with this last second 3 making it 25 games straight He s now tied with Wilt Chamberlain for 3rd longest streak in NBA history ,168,643,4311,4954,video
CompanyJ_1327,Lakers first offer to Pelicans for AD per wojespn Lonzo Ball Kyle Kuzma Rajon Rondo Michael Beasley 1st round pick ,115,3608,17569,21177,photo
CompanyJ_1328, ,1,2086,15158,17244,photo
CompanyJ_1329,They REALLY committed to this kiss cam competition ,51,969,8058,9027,video
CompanyJ_1330,Who s winning OROY Saquon or Baker via thecheckdown ,52,1094,10545,11639,photo
CompanyJ_1331,After NY traded away Porzingis RJ Barrett could be a better fit than Zion Best fits for top prospects of the 2019 class ,120,223,2087,2310,photo
CompanyJ_1332,If the Pats can exploit the Rams Achilles Heel they ll be lifting the Lombardi Trophy on Sunday ,96,184,1368,1552,video
CompanyJ_1333, OBJ dressed up as a crossing guard and these fans had no idea via simmsandlefkoe ,82,11019,42702,53721,video
CompanyJ_1334,AIR ZION via CBSSports ,23,1394,7268,8662,video
CompanyJ_1335,Eight Straight Messi is on fire ,32,180,1372,1552,photo
CompanyJ_1336,Usain Bolt just tied the NFL record for fastest 40 yard dash without spikes via simoncrosse ,92,8024,37137,45161,video
CompanyJ_1337,Dabo Swinney surprised the Clemson equipment manager with 2 tickets to the Super Bowl His reaction was perfect via ClemsonFB ,125,1943,7894,9837,video
CompanyJ_1338,Pats owner Robert Kraft joined Cardi B on stage during her performance via TaylorRooks ,87,2862,11536,14398,video
CompanyJ_1339,Every year the Pro Football HoF president knocks on players doors to let them know they ve made the Hall of Fame This year he s knocking on the greatest fans doors too Ford ,173,163,1025,1188,video
CompanyJ_1340,Vince had some wise words for Rudy Via utahjazz ,48,1264,10029,11293,video
CompanyJ_1341,17 goals Serie A s leading scorer via brfootball ,49,254,1693,1947,photo
CompanyJ_1342,Saquon takes home Offensive Rookie of the Year ,47,3856,18057,21913,photo
CompanyJ_1343,Patrick Mahomes is the 2018 NFL Offensive Player of the Year ,61,2139,15212,17351,photo
CompanyJ_1344,JuJu Travis Kelce Emmitt Smith and others test their Rams and Patriots knowledge in Back Up or Made Up ahead of Super Bowl LIII ,128,125,837,962,video
CompanyJ_1345,Chicago s Matt Nagy is the 2018 NFL Coach of the Year ,54,1219,7406,8625,photo
CompanyJ_1346,Ed Reed and Tony Gonzalez headline the 2019 Pro Football Hall of Fame Class Rest of the class Champ Bailey Pat Bowlen Gil Brandt Ty Law Kevin Mawae Johnny Robinson ,164,956,4090,5046,photo
CompanyJ_1347,Andrew Luck is the 2018 NFL Comeback Player of the Year QB missed all of 2017 but returned to throw the second most TDs of his career ,134,963,6567,7530,photo
CompanyJ_1348,Aaron Donald is the 2018 NFL Defensive Player of the Year ,58,1344,7363,8707,photo
CompanyJ_1349,Patrick Mahomes is the 2018 Most Valuable Player ,49,6140,26770,32910,photo
CompanyJ_1350,LeBron James is out against the Warriors tonight due to load management per ChrisBHaynes ,89,908,4682,5590,photo
CompanyJ_1351,Eagles DE Chris Long is the 2018 Walter Payton NFL Man of the Year ,67,2989,22280,25269,photo
CompanyJ_1352,Satoranský ended Brook Lopez 45 seconds into the game ,54,712,3560,4272,video
CompanyJ_1353,Klay Thompson will not participate in 3 Point Contest in Charlotte at All Star Weekend per ChrisBHaynes ,104,246,2013,2259,photo
CompanyJ_1354,10 years ago today Kobe dropped 61 at The Garden At the time he was clashing with Spike Lee over control of a documentary After setting the MSG record Mamba said he wanted to stop Spike from talking ,199,1818,8422,10240,photo
CompanyJ_1355,Luka is now doing the Harden step back ,39,6563,35510,42073,video
CompanyJ_1356,Giannis pulled up from 3 and airballed badly ,45,422,3502,3924,video
CompanyJ_1357,DJ Augustin had Shabazz FROZEN ,31,849,3661,4510,video
CompanyJ_1358,Two time NBA champion JaVale McGee Never forget via warriors ,61,1173,8252,9425,video
CompanyJ_1359,Who needs Manu when you have The Coyote ,40,2076,8140,10216,video
CompanyJ_1360,Views from Mount Zion ,22,1075,6631,7706,photo
CompanyJ_1361,Block Steal Bucket Jah s rebirth for NOLA continues ,52,515,3794,4309,video
CompanyJ_1362,This Kemba move had the Hornets bench in disbelief ,51,2769,17261,20030,video
CompanyJ_1363,From the bottom to the top ,27,39,200,239,photo
CompanyJ_1364,From the bottom to the top ,27,978,6090,7068,photo
CompanyJ_1365,The Rams had a top three rushing offense and didn t miss a beat without Gurley They are the FordTrucks Offensive Line of the Year ,130,69,368,437,video
CompanyJ_1366,Harden had Rubio wobbling with this step back ,46,625,3217,3842,video
CompanyJ_1367,Boogie caught a BODY then got tech d for the staredown via wyattrt3 ,68,1307,6807,8114,video
CompanyJ_1368,The Boogie poster in slow mo is cinematic ,42,4668,21728,26396,video
CompanyJ_1369,Lakers fans infiltrated Oracle and tried to recruit Klay ,57,489,3686,4175,video
CompanyJ_1370,KD and Josh Hart threw the ball at each other Both got T ed up immediately ,75,598,4585,5183,video
CompanyJ_1371, We re gonna keep your legacy alive forever Watching these Hall of Famers get the news is amazing Ford ,103,420,2169,2589,video
CompanyJ_1372,Steph clowns Warriors owner and coaches for not wanting to work during All Star Weekend via stephencurry30 IG ,110,444,3461,3905,video
CompanyJ_1373,James Harden tonight 43 PTS 12 REB 5 AST 6 STL 4 BLK 12 22 FG 15 15 FT W ,73,1239,8136,9375,photo
CompanyJ_1374,Jokic looking like TB 12 on his 10th assist of the night ,57,464,3915,4379,video
CompanyJ_1375,Willie Trill threw down on Embiid ,34,643,3791,4434,video
CompanyJ_1376,This Shaquem Griffin speech via NFL ,36,18162,60437,78599,photo
CompanyJ_1377,Porzingis leaves Knicks fans with a warning on his IG story The city deserves better than that STAY WOKE ,105,938,6349,7287,photo
CompanyJ_1378,Several veteran Lakers including Michael Beasley had an emotionally charged verbal exchange with Luke Walton after Warriors loss stopped short of getting physical per ShamsCharania ,181,2094,8622,10716,photo
CompanyJ_1379,NOLA considering to make counteroffer that includes two first round picks and adds a Pelicans player to the deal per taniaganguli and BA_Turner ,144,547,2556,3103,photo
CompanyJ_1380,SUPER BOWL SUNDAY ,18,1289,6319,7608,photo
CompanyJ_1381,Odell really introduced Saquon for ROTY as SaQuads via Giants ,62,2351,16748,19099,photo
CompanyJ_1382,Paul Rudd suited up READY to announce Mahomes MVP via thecheckdown ,67,497,4874,5371,photo
CompanyJ_1383,LIII ,5,521,2381,2902,video
CompanyJ_1384,Tim Weah assisted Celtic s first goal just 4 minutes after subbing on and then scored their second too via brfootball ,118,615,5204,5819,video
CompanyJ_1385,Feb 3 2002 Pats defeat Rams in Super Bowl XXXVI 20 17 and begin their dynasty SINCE Rams 111 160 1 Patriots 4 Super Bowls Feb 3 2019 Rams vs Patriots again ,156,420,1887,2307,photo
CompanyJ_1386,Ed Reed credits his incredible family and friends for his road to the ProFootballHOF This is not my moment it s their moment From B R x Ford ,141,207,1205,1412,video
CompanyJ_1387,Aguero scores in under a minute for the second game in a row via NBCSportsSoccer ,81,259,1781,2040,video
CompanyJ_1388,McVay turned 1 the day before Belichick s first Super Bowl appearance Hulu ,75,298,1484,1782,video
CompanyJ_1389,Luka wasn t feeling it via 90svon ,34,8899,58393,67292,video
CompanyJ_1390,11 years ago today David Tyree made one of the most iconic plays in NFL history to help the Giants dethrone the undefeated Patriots via nflthrowback ,149,6285,26986,33271,video
CompanyJ_1391,LeBron says he and Kyrie are in a good place after their phone call I love the man that he s becoming I love the challenges he s accepted and I always wish the best for him per joevardon ,187,841,6095,6936,photo
CompanyJ_1392,AGUERO HAT TRICK via brfootball ,32,303,1789,2092,photo
CompanyJ_1393,DSJ s first bucket as a Knick ,30,1042,8486,9528,video
CompanyJ_1394,Still asking teammates who they got New team same routine for DJ ,65,3131,27090,30221,video
CompanyJ_1395,Joakim gets showered with boos in his return to The Garden Reminder Knicks owe him 37M ,87,739,5059,5798,video
CompanyJ_1396, You got a 7 1 white guy on you my son could go by him Seton Hall s coach was fed up via CBBonFOX ,98,2210,10112,12322,photo
CompanyJ_1397,DSJ to DJ ,10,439,3611,4050,video
CompanyJ_1398,Kawhi showing love to a young fan via Raptors ,46,414,4433,4847,video
CompanyJ_1399,Steven Adams was completely frozen by this Kyrie move via Celtics ,66,2601,13641,16242,video
CompanyJ_1400,George Kittle Von Miller and other NFL stars give their over unders on Super Bowl prop bets including broadcast mentions of McVay s age ,136,105,637,742,video
CompanyJ_1401, When I suck I ll retire Tom Brady continues to shut down the idea of hanging it up via WillieMcGinest ,103,1731,8885,10616,photo
CompanyJ_1402, Let him leave in peace ,24,374,2909,3283,photo
CompanyJ_1403,The Patriots believe that using the TB12 Method contributed to Gronk s year long injuries per MikeGiardi ,105,142,993,1135,photo
CompanyJ_1404,OKC needed a bucket and Russ took it himself vs three defenders Game over ,74,2374,13968,16342,video
CompanyJ_1405,10 year old nailed the Shammgod AND the stepback via rome_the_writer IG ,72,2126,12947,15073,video
CompanyJ_1406,Saints fans turned out in droves to protest the Super Bowl via MichaelDeMocker ,79,2141,8279,10420,video
CompanyJ_1407,One Patriots player says Jared Goff will s t his pants when the defense throws new looks at him per MikeGiardi ,111,399,2194,2593,photo
CompanyJ_1408,This Magic Johnson Super Bowl preview is all you need ahead of the big game via NFLonCBS ,89,2218,6808,9026,video
CompanyJ_1409,Conor McGregor and his son in matching lavender suits at Super Bowl LIII ,73,4102,25262,29364,photo
CompanyJ_1410,Tom s ready via NFL ,20,2457,9962,12419,photo
CompanyJ_1411,This Rams pregame huddle via NFL ,33,839,4353,5192,video
CompanyJ_1412,Tony Romo said I ve been waiting to hear Welcome to the Super Bowl my whole life ,81,1433,9214,10647,photo
CompanyJ_1413,RT if you got the Rams in SBLIII ,33,7459,3751,11210,photo
CompanyJ_1414,RT if you got the Pats in SBLIII ,33,3658,1954,5612,photo
CompanyJ_1415,Beast Mode s outfit So real ,28,1681,8690,10371,photo
CompanyJ_1416,The greatest dynasty ever The next budding powerhouse HERE WE GO ,65,292,1525,1817,photo
CompanyJ_1417,INTERCEPTED ,12,586,3079,3665,photo
CompanyJ_1418,Tom Brady s first pass of Super Bowl LIII PICKED via NFL ,57,830,4054,4884,photo
CompanyJ_1419,There s a first time for everything ,36,319,2136,2455,photo
CompanyJ_1420,First sack of the postseason on Brady ,38,309,2345,2654,photo
CompanyJ_1421,Edelman s route running is ridiculous via thecheckdown ,55,698,4445,5143,photo
CompanyJ_1422,Julian Edelman 5 catches 74 yards Rams 32 total yards ,54,316,1961,2277,photo
CompanyJ_1423,Anyone seen this man SBLIII ,28,1120,5286,6406,photo
CompanyJ_1424, SBLIII ,8,2356,9961,12317,photo
CompanyJ_1425,Saints fans watching the Rams get shut out in the 1st half ,59,3040,12920,15960,photo
CompanyJ_1426, Second half is gonna be elite SBLIII ,38,1947,7648,9595,photo
CompanyJ_1427,Rams offense got shut down in the 1st half 0 points 57 total yards Two 1st downs All the lowest of the McVay era via NFLResearch ,129,287,1534,1821,photo
CompanyJ_1428,It actually happened ,21,26018,126255,152273,photo
CompanyJ_1429,Big Boi pulled up SBLIII ,25,1913,10030,11943,photo
CompanyJ_1430,BRUH ,5,486,4117,4603,link
CompanyJ_1431,Rough game for Goff 5 14 52 yards ,34,957,4953,5910,photo
CompanyJ_1432,Johnny Hekker just set a Super Bowl record with a 65 yard punt MVP so far ,74,1288,9668,10956,photo
CompanyJ_1433, ,1,678,4666,5344,photo
CompanyJ_1434,WE ALMOST HAD A TD ,19,1354,7359,8713,photo
CompanyJ_1435,,0,7395,29505,36900,photo
CompanyJ_1436,GRONK ,6,1152,4933,6085,photo
CompanyJ_1437,It s about that time Brady Gronk Pats score 1st TD of the game via NFL ,71,748,2862,3610,photo
CompanyJ_1438,Drove 50 yards down the field to throw an interception ,55,3033,12343,15376,photo
CompanyJ_1439,Stephon Gilmore was worth every penny via Patriots ,51,1183,5049,6232,photo
CompanyJ_1440, You ve still got a lot to learn ,33,1466,8352,9818,photo
CompanyJ_1441,Tom Brady didn t even have to score ,36,2050,6887,8937,photo
CompanyJ_1442,Patriots win Super Bowl LIII ,29,2600,6592,9192,video
CompanyJ_1443,GOAT Talk ,10,35767,111195,146962,photo
CompanyJ_1444,Julian Edelman is SUPER BOWL MVP His career could be a movie No scholarships out of HS Kent State QB 1 college catch for 11 yards No combine invite 7th round pick Brady s security blanket Clutch part of Pats dynasty 3x champ ,225,21925,86375,108300,photo
CompanyJ_1445,New England adds another Lombardi to the family ,48,869,3387,4256,video
CompanyJ_1446, We re still here Bill Belichick remembers the haters Everybody counted us out from the beginning of the season via NFLonCBS ,125,1747,8281,10028,video
CompanyJ_1447,Brady adds No 6 Hulu ,21,1184,4313,5497,video
CompanyJ_1448, ,1,1273,7456,8729,photo
CompanyJ_1449,Raiders will play in San Francisco at Oracle Park for 2019 season Announcement expected this week per rajmathai ,112,764,2710,3474,photo
CompanyJ_1450,Gronk says his future will be decided in a week or two If that s a career he goes down as one of the greatest ever 3x Champion 4x All Pro 1st 5x Pro Bowl 92 TDs 602 catches 9 024 yards ,185,3595,16954,20549,photo
CompanyJ_1451, I m pretty numb right now I definitely got out coached Sean McVay via Sheena_Marie3 ,85,2245,17833,20078,video
CompanyJ_1452, ,1,2677,16372,19049,photo
CompanyJ_1453,The champs are bumping MO BAMBA on a old school boom box via MasterTes ,71,7002,29813,36815,video
CompanyJ_1454,A win is a win hulu ,20,657,4196,4853,video
CompanyJ_1455,Dynasty ,8,1982,9126,11108,photo
CompanyJ_1456, We came flying in To win Super Bowl LIII the Patriots squashed the Rams revolution before it even began ,105,143,1210,1353,photo
CompanyJ_1457,Gronk s catch twistedwan IG ,28,1233,9520,10753,video
CompanyJ_1458,Big year for Boston beating LA ,31,2058,11021,13079,photo
CompanyJ_1459,Dynasties via brfootball ,25,997,7460,8457,photo
CompanyJ_1460,Jared Goff puts the Super Bowl loss on himself It was me It was our offense And we well I couldn t do my part per MikeSilver ,125,379,4070,4449,photo
CompanyJ_1461,On this day in 2004 Messi signed his first professional contract In the 15 years since 663 games 581 goals 246 assists 33 trophies 5 Ballons d Or via brfootball ,161,713,5039,5752,photo
CompanyJ_1462,Mourinho wipes out via ap_alexeeva ,35,181,1214,1395,video
CompanyJ_1463,What it s all about ,20,827,9261,10088,photo
CompanyJ_1464,Ja Morant went from an unranked recruit to possibly the next Russell Westbrook He s a basketball genius A once in a lifetime player ,132,708,4075,4783,photo
CompanyJ_1465,Seven years ago today Jeremy Lin checked in for the Knicks unsure if he had an NBA future He finished with 25 points and Linsanity was born ,140,12182,57772,69954,video
CompanyJ_1466,What does Vegas know br_betting ,32,433,2868,3301,photo
CompanyJ_1467,Celtics not on expanded handful of teams Anthony Davis would be willing to sign with long term per wojespn ,107,361,2476,2837,photo
CompanyJ_1468,Melo s son is out here hooping via CarmeloAnthony ,50,4068,17223,21291,video
CompanyJ_1469,Sean Payton had to laugh when these kids reenacted the blown PI call via klayton34 Instagram ,93,1208,8615,9823,video
CompanyJ_1470,Anthony Davis would sign a long term deal with these teams per ShamsCharania Lakers Knicks Bucks Clippers ,106,1818,8760,10578,photo
CompanyJ_1471,Lakers have absolutely gotten more serious in pursuit of AD Magic Johnson and Dell Demps have had multiple conversations today per wojespn ,139,844,4448,5292,photo
CompanyJ_1472,Brian Flores is the new Dolphins coach His journey Raised in one of NY s toughest areas Same neighborhood as Mike Tyson Torn quad ruined NFL chances Joined Pats as assistant scout Promoted to defensive play caller Held Rams to 3 points in Super Bowl ,250,1475,8018,9493,photo
CompanyJ_1473,Franchise cornerstones ,23,957,8286,9243,photo
CompanyJ_1474,Bats have been an unexpected attraction at Spurs games since 2009 ,66,245,2034,2279,video
CompanyJ_1475,Lakers latest offer to the Pelicans for Anthony Davis per BA_Turner Lonzo Kuz Ingram Rondo Lance Beasley Two 1sts LA also willing to take Solomon Hill for cap relief ,166,3184,11975,15159,photo
CompanyJ_1476,Heat will retire Chris Bosh s jersey on March 26 ,49,3845,26152,29997,photo
CompanyJ_1477,Mark Cuban says this feels like Dirk s final season but still wants him to work with the team Whatever he wants He s earned it via 1053thefan ,142,981,8540,9521,photo
CompanyJ_1478,He s back ,10,1686,12258,13944,photo
CompanyJ_1479,Agree with the Mamba ,21,3550,21048,24598,photo
CompanyJ_1480,Jokic bullying ,15,758,6831,7589,video
CompanyJ_1481,Adam Sandler s handles are out of control via spidadmitchell ,61,1917,14900,16817,video
CompanyJ_1482,The Nets bench lost it after Giannis air ball ,46,1073,7319,8392,video
CompanyJ_1483,Beard crossing ,15,1881,10746,12627,video
CompanyJ_1484,The latest on AD Growing pessimism about Pelicans willingness to deal AD to Lakers per ramonashelburne Danny Ainge has urged Pelicans to wait until offseason to negotiate deal with Celtics in hopes of pairing Kyrie with AD per wojespn ,235,494,2661,3155,photo
CompanyJ_1485,Giannis says he will probably take Steph Curry with 1st pick in All Star Draft per Matt_Velazquez ,98,833,6809,7642,video
CompanyJ_1486,CP3 wyd ,8,572,4074,4646,photo
CompanyJ_1487,The streak continues 27 straight 30 point games for The Beard 44 PTS 15 26FG 8 REBS 6 ASTS ,91,1039,6646,7685,photo
CompanyJ_1488,DID BAGLEY REALLY JUST DO THAT ,31,8776,43882,52658,video
CompanyJ_1489,Mahomes pulled up to a Lifetime and cooked everybody via Faiz_Jiwani kheuzil ,77,13992,72116,86108,video
CompanyJ_1490,The great Hammerin Hank Aaron turns 85 today 2 297 RBI 1st 755 home runs 2nd 3 771 hits 3rd ,92,2820,14195,17015,photo
CompanyJ_1491,Seven days until the Champions League returns via brfootball ,61,144,1529,1673,photo
CompanyJ_1492,Former teammate says Kyrie hates the narrative other players like KD or AD can influence his free agency decision per SIChrisMannix ,132,557,3603,4160,photo
CompanyJ_1493,Cristiano Ronaldo turns 34 today His career so far club and country 942 games 675 goals 246 assists 29 trophies 5 Ballons d Or And he s still going strong ,155,2728,11442,14170,photo
CompanyJ_1494, mb3five via stevenspurgeon IG ,31,384,3360,3744,video
CompanyJ_1495,On this day in 1999 they were kids making their pro debuts in a lockout shortened season Two decades later they re NBA legends ,127,2667,14480,17147,photo
CompanyJ_1496,Bill Belichick told Tom Brady and Julian Edelman after the SBLIII win We ll be back too ,88,894,5058,5952,photo
CompanyJ_1497,How it d look if Shaq played in the league today via Shady00018 ,64,9327,42208,51535,video
CompanyJ_1498,Robert Kraft rocking his chain from MeekMill at the Pats parade via _AndrewCallahan masslivenews ,97,1357,5371,6728,photo
CompanyJ_1499,Lakers won t have a team left ,30,6930,24487,31417,video
CompanyJ_1500,Gronk has a full bottle of wine on the parade bus via 7News ,60,617,4195,4812,video
CompanyJ_1501,LaVar calls Luke Walton the worst coach ever for Lonzo and says he turned the PG into a loser via DougandWolf987 ,113,1019,4567,5586,photo
CompanyJ_1502,Gronk just chugging beers now via joeycanfly1 ,46,598,3999,4597,video
CompanyJ_1503,Miss State recruit Lee Witherspoon averaged nearly 20 yards per carry and scored 59 TDs And he s only played RB for one season ,127,255,1291,1546,photo
CompanyJ_1504,LeBron addresses Anthony Davis trade rumors says he tends not to play much fantasy basketball per billoram ,107,303,2041,2344,photo
CompanyJ_1505,John Wall suffered ruptured Achilles after slipping and falling in his house and will be out 12 months ,103,7138,28027,35165,photo
CompanyJ_1506,Washington owes John Wall 37 8M in 2019 20 40 8M in 2020 21 43 8M in 2021 22 46 8M in 2022 23 ,94,2679,13607,16286,photo
CompanyJ_1507,Party like Neymar and Mbappe at neymarjr s birthday via davidbrazil IG ,71,134,1140,1274,video
CompanyJ_1508,Lakers pull out of AD talks because of Pelicans outrageous requests including 6 8 draft picks per BA_Turner ,108,4886,19045,23931,photo
CompanyJ_1509,Lakers final offer included Lonzo Kuzma Ingram Hart Zubac KCP and 2 first rounders to Pelicans for AD and Solomon Hill per BA_Turner ,133,2261,7951,10212,link
CompanyJ_1510, ,1,725,6085,6810,link
CompanyJ_1511,Maya Moore announces she won t play pro basketball in 2019 ,59,1157,4557,5714,photo
CompanyJ_1512,Who ya got Draft your NBAAllStar team and enter for a chance to win 25K ,72,198,1162,1360,photo
CompanyJ_1513,Boogie after the news of John Wall s Achilles injury I know he ll overcome this no doubt in my mind Via anthonyVslater ,119,1009,7151,8160,video
CompanyJ_1514,Edelman and Brady Always in sync via NFLFilms ,46,1127,7733,8860,video
CompanyJ_1515,Mo Bamba will miss significant time with a stress fracture in his lower left leg but no surgery is expected per wojespn ,120,260,2701,2961,photo
CompanyJ_1516,The GridironHeights season finale drops at 8 p m ET Catch up on all of Season 3 now ,84,69,418,487,photo
CompanyJ_1517, DwyaneWade s rocking a world tour shirt with his best career moments on it What was your favorite Shop the D Wade x B R World Tour collection ,143,5130,22242,27372,photo
CompanyJ_1518,Makur Maker is a 7 foot high school recruit who went from unranked to No 15 in the 2020 rankings ,97,385,2839,3224,video
CompanyJ_1519,Grizzlies are in strong talks with Hornets to move Marc Gasol to Charlotte per ShamsCharania ,93,522,2997,3519,photo
CompanyJ_1520,20 years ago today the NBA was introduced to White Chocolate Jason Williams following the 1999 lockout ,103,12514,44354,56868,video
CompanyJ_1521, Bron s gonna trade you Pacers fans being ruthless to BI ,57,5649,24470,30119,video
CompanyJ_1522,Patrick Mahomes is lost without football for the next 6 months GridironHeights playstation ,91,913,3737,4650,video
CompanyJ_1523,Dunk Contest is set Who ya got ATTSlamDunk ,43,544,2980,3524,photo
CompanyJ_1524,Lakers down 23 at half to the Pacers ,37,3150,11401,14551,photo
CompanyJ_1525,2019 All Star 3 Point Contest Participants Devin Booker defending champ Steph Curry Seth Curry Dirk Nowitzki Damian Lillard Kemba Walker Khris Middleton Buddy Hield Danny Green Joe Harris Who ya got ,199,2149,12135,14284,photo
CompanyJ_1526,Congrats to kingjames who just reached 32k points ,50,7576,40580,48156,video
CompanyJ_1527,Myles Turner humbled Kuz ,25,781,4262,5043,video
CompanyJ_1528,Zion tried it via CBSSports ,28,629,4442,5071,video
CompanyJ_1529,Nick Foles will void his contract with the Eagles buying them out for 2M and becoming a free agent unless Eagles use a franchise tag per RapSheet ,146,635,3386,4021,photo
CompanyJ_1530,That was just mean MilesBridges ,32,843,4632,5475,video
CompanyJ_1531,Russ didn t have to do AG like that ,36,1523,7235,8758,video
CompanyJ_1532,42 point loss That s the biggest loss of Bron s career ,55,1896,10828,12724,photo
CompanyJ_1533, tobias31 called game ,22,318,2359,2677,video
CompanyJ_1534,Kuzma on how to avoid trade rumors after 42 point loss Maybe I should Bird Box ,79,715,5335,6050,photo
CompanyJ_1535,Wall wasn t messing with JuJu s jokes ,38,4679,29699,34378,photo
CompanyJ_1536,Lotta open seats on that Lakers bench ,38,1293,7428,8721,video
CompanyJ_1537,The Lakers have agreed in principle to send Svi Mykhailiuk and a second round pick to the Pistons for Reggie Bullock per MarcJSpearsESPN ,137,1245,5751,6996,photo
CompanyJ_1538,Clippers are sending Tobias Harris to the 76ers per ShamsCharania ,66,2069,9509,11578,photo
CompanyJ_1539,76ers new starting lineup PG Ben Simmons SG JJ Redick SF Jimmy Butler PF Tobias Harris C Joel Embiid ,101,10627,54275,64902,photo
CompanyJ_1540,Philadelphia has long term plans for their new Big 4 and plan to re sign Butler and Harris this offseason per wojespn ,118,1490,9598,11088,photo
CompanyJ_1541,Celtics remain cautiously optimistic about keeping Kyrie despite his recent comments and the Knicks new cap space per ZachLowe_NBA ,131,333,2740,3073,photo
CompanyJ_1542,Quavo Bad Bunny and Hasan Minhaj headline the NBAAllStar celebrity game ,72,699,3296,3995,photo
CompanyJ_1543,Pistons are finalizing a trade to send Stanley Johnson to the Bucks for Thon Maker per wojespn ,95,1372,7723,9095,photo
CompanyJ_1544,Makur Maker is a 7 foot high school recruit who went from unranked to No 15 in the 2020 rankings ,97,339,2624,2963,video
CompanyJ_1545,Favorites in the East ,22,4305,27960,32265,photo
CompanyJ_1546,Ja Morant True high flyer via teamflightbros ,45,3865,21925,25790,video
CompanyJ_1547,KD believed he d be viewed as the world s best player after beating LeBron in the 2017 NBA Finals per SherwoodStrauss ,118,1450,8757,10207,photo
CompanyJ_1548,We re here to talk BHM B R x BLK HSTRY Are You Listening ,57,188,771,959,video
CompanyJ_1549,Trail Blazers Record Setters GOATs Happy National Girls and Women in Sports Day NGWSD2019 ,90,957,3679,4636,photo
CompanyJ_1550,Marcus Morris isn t worried ,28,771,4711,5482,photo
CompanyJ_1551,Barcelona losing to Real Madrid At home ,40,205,2034,2239,photo
CompanyJ_1552,52 years ago Muhammad Ali fought Ernie Terrell Leading up to the bout Terrell kept calling him Cassius Clay Ali hated it Over the course of 15 rounds Ali punished Terrell while yelling WHAT S MY NAME ,200,3075,10763,13838,photo
CompanyJ_1553,NBA franchise values per Forbes 1 Knicks 4B 2 Lakers 3 7B 3 Warriors 3 5B ,74,639,3552,4191,photo
CompanyJ_1554,Wizards are sending Otto Porter to the Bulls for Bobby Portis and Jabari Parker per ShamsCharania ,98,3856,10254,14110,photo
CompanyJ_1555,Iman Shumpert is going to the Rockets in a three team deal with Houston Cleveland and Sacramento per wojespn ,109,2031,9059,11090,photo
CompanyJ_1556,Lakers are running low on hope Pelicans will engage with latest trade offer before Thursday s deadline per wojespn ,115,277,1993,2270,photo
CompanyJ_1557,AD showed Jabari some love after Parker got the news he was traded via JJTheMedillMan ,86,573,4084,4657,video
CompanyJ_1558,Brooklyn might have the best bench reactions in the league ,59,3338,20439,23777,video
CompanyJ_1559,THJ s first points as a Mav Alley oop from Luka ,48,1405,11059,12464,video
CompanyJ_1560,CLUTCH via NBA ,15,1266,8358,9624,video
CompanyJ_1561,Knicks are equal footing with the Lakers in terms of teams AD is interested in signing long term with per TheSteinLine ,119,675,3323,3998,photo
CompanyJ_1562,Kerr couldn t help himself ,27,525,3891,4416,photo
CompanyJ_1563,Mavs are sending Harrison Barnes to the Kings per ShamsCharania ,64,696,3777,4473,photo
CompanyJ_1564,The Bucks just dropped 148 points Greek Freak 43 PTS 17 21FG 6 REBS 4 ASTS 3 STLS ,82,1360,7803,9163,video
CompanyJ_1565,That s rough ,13,7768,37856,45624,video
CompanyJ_1566,Is this the moment Barnes found out he was traded ,50,961,6030,6991,video
CompanyJ_1567,Giannis Playground bully ,25,813,5963,6776,photo
CompanyJ_1568,This is why Klay doesn t dribble via NBCSWarriors ,50,2933,15601,18534,video
CompanyJ_1569,Bron weighs in on the Barnes mid game trade ,44,2586,10805,13391,photo
CompanyJ_1570,Lamar Odom has signed with the BIG3 will join the 2019 draft pool per NotoriousOHM ,83,1017,6518,7535,photo
CompanyJ_1571,Harden didn t appreciate this Frank Mason beard foul ,53,829,5019,5848,video
CompanyJ_1572,Iguodala didn t have to watch it go in via NBCSWarriors ,56,8406,41860,50266,video
CompanyJ_1573,Young Lakers after seeing LeBron s IG post about the Harrison Barnes trade ,75,3102,12102,15204,photo
CompanyJ_1574,We not getting any more trades tonight ,39,543,4149,4692,photo
CompanyJ_1575,KD has no interest in talking about his free agency or talking to media I don t trust y all via MarkG_Medina ,109,2908,13378,16286,video
CompanyJ_1576,KD didn t hold back last night ,31,599,4557,5156,photo
CompanyJ_1577,25 years ago today Michael Jordan signed a minor league contract with the White Sox He would play 127 games recording 3 HRs and 51 RBI and 114 strikeouts ,154,828,5716,6544,photo
CompanyJ_1578,The trade deadline has been full of surprises ,46,389,3157,3546,photo
CompanyJ_1579,Chiefs GM on Mahomes hooping We spoke to Pat Mahomes agent and said Chiefs Kingdom can be assured there will be no more basketball for Pat per adamteicher ,155,957,4361,5318,link
CompanyJ_1580,LeBron is relaxed on deadline day ,34,819,4630,5449,photo
CompanyJ_1581,The Pelicans are sending Nikola Mirotic to Milwaukee per wojespn ,65,855,4915,5770,photo
CompanyJ_1582,Nik Stauskas and Wade Baldwin are having a rough week Sunday Traded from Blazers to Cavs Wednesday Traded from Cavs to Rockets Thursday Traded from Rockets to Pacers and waived ,177,1863,6269,8132,photo
CompanyJ_1583, Hey Dell me again ,19,1477,8710,10187,photo
CompanyJ_1584,Already grinding again VicOladipo ,34,2747,13149,15896,video
CompanyJ_1585,LaVar didn t hold back his feelings on the Lakers Lonzo is better than LeBron Bron won t win title in LA without Zo Magic isn t in charge of Lakers via undisputed ,163,611,2853,3464,photo
CompanyJ_1586,Breaking The Raptors are nearing a deal to land Marc Gasol per wojespn ,71,763,3432,4195,photo
CompanyJ_1587,The Clippers are sending Avery Bradley to the Grizzlies for Garrett Temple and JaMychal Green per wojespn ,106,537,2060,2597,photo
CompanyJ_1588,The Grizzlies will receive Jonas Valanciunas Delon Wright CJ Miles and a 2024 second round pick per wojespn ,108,981,3337,4318,link
CompanyJ_1589,LeBron s grand plan isn t to make the Lakers stronger it s to make the West weaker ,83,1209,6609,7818,photo
CompanyJ_1590,Marc Gasol received a standing ovation when he joined the Grizzlies bench one last time via ChrisVernonShow ,108,485,4177,4662,video
CompanyJ_1591,Lakers are trading Beasley and Zubac to the Clippers for Mike Muscala per wojespn ,82,1046,4382,5428,photo
CompanyJ_1592,,0,701,3156,3857,photo
CompanyJ_1593,Grizzlies discussed deals with multiple teams but decided to keep Mike Conley per wojespn ,90,180,1295,1475,photo
CompanyJ_1594,Breaking Sixers are sending Markelle Fultz to Orlando per WojESPN ,66,3570,15679,19249,photo
CompanyJ_1595,Gasol joins the North ,22,1431,7707,9138,photo
CompanyJ_1596,Rich Paul says Anthony Davis is not being traded today per joevardon ,69,736,3209,3945,photo
CompanyJ_1597,Are the Mavs the deadline winners of 2019 ,42,334,2923,3257,video
CompanyJ_1598,New beginning for Markelle ,27,1196,7183,8379,photo
CompanyJ_1599,Pelicans Lakers trade talks ,28,1146,4188,5334,video
CompanyJ_1600,Looks like Bron is happy Zo is staying in LA ,45,490,4267,4757,photo
CompanyJ_1601,Magic and LeBron s private post deadline meeting ,49,1141,4944,6085,video
CompanyJ_1602,We are the bold the feared the future OwnTheGame jumpman23 ,59,400,2024,2424,video
CompanyJ_1603,Bron and Kyrie face off in Boston tonight Could there be a reunion in L A down the road ,88,827,5985,6812,video
CompanyJ_1604,The Russ and Noah pregame routine is back via okcthunder ,57,5802,35433,41235,video
CompanyJ_1605,A jacked Aussie punter signing for Miami wasn t the only wild part of National Signing Day ,91,136,884,1020,video
CompanyJ_1606,Giannis may be an All Star captain but SHAQ still can t pronounce his name The NBA All Star Draft is coming up next at 7pm ET on NBAonTNT ,138,1936,10192,12128,video
CompanyJ_1607,With the first pick in the NBAAllStar Draft Team LeBron selects Kevin Durant NBAAllStar ,88,334,1202,1536,video
CompanyJ_1608, TeamGiannis selects Stephen Curry NBAAllStar ,46,176,713,889,video
CompanyJ_1609, TeamLeBron selects Kyrie NBAAllStar ,37,452,1734,2186,video
CompanyJ_1610, TeamGiannis selects Joel Embiid NBAAllStar ,44,142,538,680,video
CompanyJ_1611, TeamLeBron selects Kawhi NBAAllStar ,37,240,1036,1276,video
CompanyJ_1612, TeamGiannis selects Paul George NBAAllStar ,44,180,564,744,video
CompanyJ_1613, TeamLeBron selects Harden NBAAllStar ,38,213,817,1030,video
CompanyJ_1614, TeamGiannis selects Kemba Walker NBAAllStar ,45,124,546,670,video
CompanyJ_1615,Live look at Bron after he drafted AD ,38,903,4450,5353,photo
CompanyJ_1616,Team Bron or Team Giannis ,26,2343,8997,11340,photo
CompanyJ_1617,Reserves for TeamLeBron Anthony Davis Klay Dame Westbrook Aldridge KAT Beal ,76,663,2564,3227,photo
CompanyJ_1618,All Star teammates once again Bron picks D Wade ,48,1747,8315,10062,photo
CompanyJ_1619,Reserves for TeamGiannis Khris Middleton Nikola Jokic Ben Simmons Blake Griffin D Angelo Russell Nikola Vucevic Kyle Lowry Special reserve Dirk ,144,311,1543,1854,photo
CompanyJ_1620,Giannis accused Bron of tampering when he drafted AD via NBAonTNT ,66,5512,25691,31203,video
CompanyJ_1621, We have a trade Bron trades Russ to Team Giannis for Ben Simmons ,66,2476,12704,15180,photo
CompanyJ_1622,The Pelicans plan to allow AD back into the lineup for the rest of the season per wojespn ,90,311,2724,3035,photo
CompanyJ_1623,Watch Steven Adams in the background while Russ and PG received NBAAllStar honors ,82,2641,15394,18035,video
CompanyJ_1624,Trae Young s vision ,20,743,4639,5382,video
CompanyJ_1625,Bron and Rondo during the Lakers last timeout ,46,1401,10109,11510,video
CompanyJ_1626,Russ reaction after missing a wide open dunk ,45,4138,25527,29665,video
CompanyJ_1627,Team LeBron and Team Giannis are set Who ya got with metrobytmobile ,68,303,1600,1903,video
CompanyJ_1628,This Celtics sequence ,22,542,3343,3885,video
CompanyJ_1629,Terrance Ferguson went Bron on this dunk ,41,2756,14479,17235,video
CompanyJ_1630,Gotta love Bron and Kyrie exchanging buckets ,45,1248,6669,7917,video
CompanyJ_1631,Kuz CLUTCH ,11,1504,7292,8796,video
CompanyJ_1632,RONDO CALLED GAME ,18,4176,17147,21323,status
CompanyJ_1633,RONDO FOR THE WIN IN BOSTON ,28,24918,73677,98595,video
CompanyJ_1634,Winning solves everything ,26,2882,17439,20321,photo
CompanyJ_1635,Rondo gets his revenge in Boston ,33,694,4560,5254,photo
CompanyJ_1636, I ll see you in the offseason ,31,5251,38629,43880,photo
CompanyJ_1637,What we all want to see ,24,4515,23509,28024,photo
CompanyJ_1638,Josh Anderson POSTER OF THE YEAR via CBSSportsNet ,50,2457,9893,12350,video
CompanyJ_1639,Jake Layman caught him sleeping ,32,514,5049,5563,video
CompanyJ_1640,Champions League Soon via brfootball ,37,181,1905,2086,photo
CompanyJ_1641,Winner Markelle Fultz Loser Everyone involved in the AD saga Biggest winners and losers from the trade deadline ,112,162,1987,2149,photo
CompanyJ_1642,Slow Mo Rondo ,14,9576,48980,58556,video
CompanyJ_1643,Synchronized Shooting via umichwbball ,38,1663,10942,12605,video
CompanyJ_1644,Danny Ainge on Kyrie s commitment to the Celtics We re still engaged but we really can t make those vows sign that contract until July 1st via 985TheSportsHub ,159,211,1898,2109,photo
CompanyJ_1645,Drug kingpin s lieutenant gt Elite boxing trainer Calvin Ford is the real life inspiration for The Wire s Cutty character and is using his story to provide hope for Baltimore ,175,110,473,583,photo
CompanyJ_1646,Zion is still No 1 but there s a new No 2 Post Trade Deadline Mock Draft ,73,588,2780,3368,photo
CompanyJ_1647,The goalie was devastated via saccwolves brfootball ,52,2320,12901,15221,video
CompanyJ_1648,Romo almost holed out via PGATOUR ,34,920,7061,7981,photo
CompanyJ_1649,Ump really got a whole jab step routine for the call via Rev_Strikeout ,71,5693,24012,29705,video
CompanyJ_1650,The post LeBron effect ,23,5053,23656,28709,photo
CompanyJ_1651,LeBron s move to L A created a power vacuum in the East and for the first time in nine years teams see a path to the Finals HowardBeck ,135,439,2528,2967,video
CompanyJ_1652,Luke Brown is lighting up high school hoops bringing the community together to watch him break Indiana s all time scoring record ,129,1188,6140,7328,video
CompanyJ_1653,LaVine went reverse off the alley oop ,38,845,6063,6908,video
CompanyJ_1654,Standing ovation for Caris LeVert who is back for the Nets ,59,4026,29101,33127,video
CompanyJ_1655,DSJ went 360 off the break ,27,1409,8938,10347,video
CompanyJ_1656,DSJ just trucked Blake ,23,975,7953,8928,video
CompanyJ_1657,Dirk dominating on both ends of the floor ,42,963,7181,8144,video
CompanyJ_1658,This Ben Simmons hesitation ,28,2806,16472,19278,video
CompanyJ_1659,Philly gave Boban a standing ovation for his 1st game with the 76ers ,69,590,6372,6962,video
CompanyJ_1660,Dwyane Wade heads to locker room after scary fall appears to be ok ,67,548,5445,5993,video
CompanyJ_1661,Draymond Green got ejected at the end of the 3Q after exchanging words with the Suns bench ,91,808,5894,6702,video
CompanyJ_1662,D Wade caught after returning from his scary fall ,50,3529,19205,22734,video
CompanyJ_1663,Boogie begged Warriors coaches to keep him in the game ,55,505,5331,5836,video
CompanyJ_1664,KD on Bron taking him with 1st pick in NBA All Star Draft two years in a row What else is he supposed to do via MarkG_Medina ,125,956,6851,7807,video
CompanyJ_1665,AD checked out with 3 14 left in the 3Q He didn t play in the 4Q ,65,641,6248,6889,video
CompanyJ_1666,POGBA Feeling himself after scoring 7 goals in 8 games via NBCSportsSoccer ,75,747,4311,5058,video
CompanyJ_1667,Alvin Gentry on why AD sat the 4th quarter We had talked about playing between 22 and 25 minutes That s why he didn t go back in the game ,138,116,1252,1368,photo
CompanyJ_1668,Bronny Jr and Floyd Mayweather pulled up for the hype show at Sierra Canyon s opening playoff game ,99,898,8019,8917,video
CompanyJ_1669,Salah puts Liverpool up 3 0 ,28,69,860,929,link
CompanyJ_1670,The NCAA has unveiled the first bracket of March Madness season 1 seeds Duke Tennessee Virginia Gonzaga ,104,882,5010,5892,photo
CompanyJ_1671,100 Real Madrid goals for Gareth Bale but none better than this via brfootball ,79,1500,7520,9020,video
CompanyJ_1672,Senior Luke Maye is big time for UNC Via CBSSports ,51,826,4569,5395,video
CompanyJ_1673,Sent him flying with the pump fake before sealing the game winner via jaskran_b katherineneleh bhavrup_gosal Instagram ,119,647,6168,6815,video
CompanyJ_1674,17 2 run for Mississippi State vs No 5 Kentucky Wildcats lead 51 48 9 minutes to go via CBSSports ,98,129,1395,1524,video
CompanyJ_1675,Middleweight champ Robert Whittaker is OUT of tonight s title defense at UFC 234 due to a hernia injury per bokamotoESPN ,121,306,862,1168,photo
CompanyJ_1676,Markus Howard for your POY consideration 38 points for No 10 Marquette in a 66 65 win over No 14 Villanova ,107,431,2460,2891,video
CompanyJ_1677,LeBron breaks down his All Star roster and addresses everyone s contract situation via taniaganguli ,100,654,4118,4772,video
CompanyJ_1678,16 years ago today MJ reminded Kobe how many rings he had during his final All Star Game ,89,13597,51823,65420,video
CompanyJ_1679,Can t wait ,11,827,6933,7760,photo
CompanyJ_1680,Dunking Skipping Showing love to the poncho guy Admiral Schofield everybody ,76,447,3596,4043,video
CompanyJ_1681,Russ pulled up with the construction vest on via NBA ,53,2702,16879,19581,video
CompanyJ_1682,On this day in 1992 Magic Johnson returned Iconic performance Retired three months earlier HIV Voted into All Star starting lineup Thought it d be his last game ever Dropped 25 PTS and 9 AST Battled MJ and Isiah MVP ,216,810,4032,4842,video
CompanyJ_1683,Zion out of NOWHERE via CBSSports ,34,2747,12661,15408,video
CompanyJ_1684,DSJ off the backboard to DJ ,28,1027,6442,7469,video
CompanyJ_1685,These kids Duke s freshmen score 74 of team s 81 points as Blue Devils hand No 3 Virginia its second loss of the season ,120,897,5082,5979,photo
CompanyJ_1686, I m going to hug em and tell them that we got to come together Magic s message to the Lakers after trade deadline drama per LarryLage ,135,436,3097,3533,photo
CompanyJ_1687,Bradley Beal got tackled by the Wizards bench after this Jabari dunk ,69,1579,10254,11833,video
CompanyJ_1688,The AAF is no joke via TheAAF ,30,4520,17597,22117,video
CompanyJ_1689,Harden s footwork is just on another level via NBA ,51,2600,13610,16210,video
CompanyJ_1690,Rozier looking scary with Kyrie on the sidelines ,49,6174,33201,39375,video
CompanyJ_1691,How did Taurean Prince not cross the line ,42,2213,19645,21858,video
CompanyJ_1692,Mick Foley broke out Mr Socko on this guy then the Grizzlies mascot gave him a flying elbow through a table ,108,916,3418,4334,video
CompanyJ_1693,Pacers fans broke out a Tank for Zion chant during free throw break ,68,458,3651,4109,video
CompanyJ_1694,Celtics got booed off the court at TD Garden after blowing 28 point lead vs Clippers ,85,2973,14494,17467,video
CompanyJ_1695,PG drops 45 in the win over the Rockets ,40,4581,21944,26525,photo
CompanyJ_1696,45 from PG 42 from Harden 21 12 11 from Russ 26 point OKC comeback Unreal game in H Town ,89,3022,14607,17629,photo
CompanyJ_1697,The Brodie keeps getting it done ,33,832,4322,5154,photo
CompanyJ_1698,Harden couldn t believe this non call so he chased down the ref ,64,360,2896,3256,video
CompanyJ_1699,Russ had a quadruple double 21 PTS 12 REB 11 AST 10 TO but scored the go ahead bucket and defended Harden on the other end ,123,1102,7060,8162,video
CompanyJ_1700,Marcus Morris on the Celtics recently It hasn t been fun for a long time We don t have no attitude we don t have no toughness per ByJayKing ,140,470,2841,3311,photo
CompanyJ_1701,Holiday brothers Jrue and Justin swapped jerseys after squaring off tonight ,76,857,8275,9132,photo
CompanyJ_1702,Paul George has been in a ZONE His last 11 games 31 PTS W 31 PTS W 36 PTS W 23 PTS W 36 PTS W 37 PTS W 43 PTS W 37 PTS L 39 PTS W 27 PTS W 45 PTS W ,148,6886,39588,46474,photo
CompanyJ_1703,38 points Outscored Kobe First national TV game Seven years ago today Linsanity became real ,92,4548,27760,32308,video
CompanyJ_1704,Pogba s last 9 PL games 8 goals 5 assists No L s Cooking via brfootball ,72,254,2127,2381,photo
CompanyJ_1705,This kid s handles had the ref SHOOK via qo2cold Instagram ,59,25741,99928,125669,video
CompanyJ_1706,MVP watch Harden 36 6 PPG 7 8 APG 6 7 RPG PG 28 3 PPG 4 0 APG 7 9 RPG Giannis 27 0 PPG 5 8 APG 12 5 RPG Curry 28 7 PPG 5 4 APG 5 1 RPG ,135,1158,6201,7359,photo
CompanyJ_1707,AGUEROMG via NBCSportsSoccer ,29,766,3189,3955,video
CompanyJ_1708,Man City 4 0 Chelsea after 24 minutes FOUR ZERO ,48,618,3515,4133,photo
CompanyJ_1709,3 year old pulled up on the fastbreak and walked away before she drained the bucket via Hawk ,93,3072,20898,23970,video
CompanyJ_1710,Aguero Hat trick vs Arsenal last weekend Hat trick vs Chelsea today Big games big goals ,88,480,2521,3001,photo
CompanyJ_1711,Cosmo still got it via byu_cosmo ,33,1338,7308,8646,video
CompanyJ_1712,Man City 6 0 Chelsea Men against boys ,38,736,2613,3349,photo
CompanyJ_1713,Tobias got called about the trade during his late night Netflix binge via sixers ,81,1753,13453,15206,video
CompanyJ_1714,4 goals in the last 3 league games via brfootball ,50,313,2529,2842,photo
CompanyJ_1715,He took back his comments to Austin Rivers real quick via _justinbolton Instagram ,82,7993,41060,49053,video
CompanyJ_1716,Quavo is the calmest QB in Atlanta via thecheckdown ,52,3073,21275,24348,video
CompanyJ_1717,Ben Simmons wants to work with Magic Johnson this offseason talk big guard secrets per TheSteinLine ,100,916,7679,8595,photo
CompanyJ_1718,Luka was ready to run into the lockers because he didn t get the three point play ,82,545,5058,5603,video
CompanyJ_1719,This baby race is the best timeout show right now ,50,468,3418,3886,video
CompanyJ_1720,Tobias via NBA ,15,642,6159,6801,video
CompanyJ_1721,Kuzma with 23 PTS in 12 mins ,29,1614,11443,13057,photo
CompanyJ_1722,Embiid even tricked the cameraman via sixers ,45,1056,8732,9788,video
CompanyJ_1723,The Mavs couldn t hold Dame ,28,334,2490,2824,video
CompanyJ_1724,Luka has TAKEN OVER in the 4Q ,30,1403,9847,11250,video
CompanyJ_1725,Embiid had his way with the Lakers 37 PTS 14 REBS ,50,615,4114,4729,video
CompanyJ_1726,Mo Bamba explains how Tatum actually inspired sheckwes hit song via OrlandoMagic ,81,915,4884,5799,video
CompanyJ_1727,Magic had seen enough and decided to dip early ,47,960,7163,8123,video
CompanyJ_1728,WHAT AN ENDING via MSUBearsHoops ,33,1418,6083,7501,video
CompanyJ_1729,Embiid on his reaction to Simmons attempting a three I was like oh s t It caught me off guard via NBASarah ,107,1714,11504,13218,video
CompanyJ_1730,These military surprises never get old ,39,3477,21881,25358,video
CompanyJ_1731,Marvin Bagley dropped 32 PTS and put on a show vs the Suns ,59,841,6510,7351,video
CompanyJ_1732,Klay scored on an assist off Boogie s head ,43,2483,16389,18872,video
CompanyJ_1733,Standing ovation for D Wade at Oracle Arena via MiamiHEAT ,58,1298,9225,10523,video
CompanyJ_1734,That man D Wade ,16,3298,17204,20502,video
CompanyJ_1735,KD CLUTCH ,10,630,4367,4997,video
CompanyJ_1736,D Wade x Steph jersey exchange ,31,5423,39156,44579,video
CompanyJ_1737,Anthony Edwards the potential No 1 pick in the 2020 Draft just committed to Georgia ,84,3414,13091,16505,video
CompanyJ_1738,TOMORROW The Champions League returns ,38,633,3794,4427,photo
CompanyJ_1739,29 years ago today One of the biggest upsets in sports history Mike Tyson undefeated and undisputed heavyweight champion of the world lost by knockout to underdog Buster Douglas ,178,1088,5761,6849,photo
CompanyJ_1740, ,1,903,9241,10144,photo
CompanyJ_1741,Colts LB Darius Leonard surprised his mom with a new Mercedes Benz Her reaction via dsleon45 ,93,1468,9746,11214,video
CompanyJ_1742,PSG always rocking the Jumpman23 brkicks brfootball ,52,149,1843,1992,photo
CompanyJ_1743,All Star Game is this week One of the most iconic ASG moments Shaq and MJ one on one ,85,8129,33406,41535,video
CompanyJ_1744,18 year old phenom Vinicius Junior is ready to fill the void at Real Madrid left by Ronaldo As he debuts in the Champions League knockout stage he s already built a rep He s not a promise anymore he s a reality ,211,229,1463,1692,photo
CompanyJ_1745,Steph to D Wade on his retirement Are you sure you don t have a couple more years left in there Wade is averaging 13 9PPG 3 9RPG 4 4APG off the bench ,150,866,7224,8090,photo
CompanyJ_1746,17 years ago LeBron faced Carmelo in HS They struck up a friendship the night before 11 000 fans showed up Bron 36 PTS 12 27 FG 8 REB 5 AST 6 STL Melo 34 PTS 14 25 FG 11 REB 2 AST LBJ s Chosen One cover came out a week later ,225,1789,10220,12009,photo
CompanyJ_1747,Breaking Heisman winner Kyler Murray announces he is fully committing to football instead of playing in MLB with A s ,117,3841,19696,23537,photo
CompanyJ_1748,Elton Brand on Ben Simmons asking permission to work with Magic Johnson in the offseason I said no per 975TheFanatic ,117,997,5910,6907,photo
CompanyJ_1749,Jeremy Lin is finalizing a buyout with Hawks clearing the way for him to sign with Raptors per wojespn ,103,1240,8252,9492,photo
CompanyJ_1750,Browns have signed Kareem Hunt to a contract Browns GM We believe he deserves a second chance ,94,10347,41651,51998,photo
CompanyJ_1751,Bron s defense on Ben this possession ,38,1057,9204,10261,video
CompanyJ_1752,D Lo 22 years old is the youngest player in NBA history to hit 500 three pointers h t APOOCH ,93,6907,36012,42919,photo
CompanyJ_1753,Game high 25 PTS 15 PTS in the 4th 21 point comeback 18 years ago today Allen Iverson took home All Star MVP ,109,1604,7641,9245,photo
CompanyJ_1754,Harden is locked in ,20,2356,11539,13895,photo
CompanyJ_1755,A Boogie hooping in Australia with a couple fans The commentary via ArtistHBTL UncleSego ,89,1270,7017,8287,video
CompanyJ_1756,Harden s bench on FIFA is entirely players with huge beards brfootball ,71,1045,7934,8979,photo
CompanyJ_1757,Tobias wasn t gonna let Boban wear the same fit two days in a row via Tobias31 ,79,1075,9867,10942,video
CompanyJ_1758,DON T JUMP WITH THON MAKER ,27,1329,8484,9813,video
CompanyJ_1759,Mario Hezonja trying to end careers ,36,3134,12408,15542,video
CompanyJ_1760,Raptors forgot to fill Marc Gasol in on the pregame ritual via TSN_Sports ,74,1316,8392,9708,video
CompanyJ_1761,Marc you good ,14,173,1966,2139,video
CompanyJ_1762,Toronto gave Marc Gasol a standing ovation ,43,519,4886,5405,video
CompanyJ_1763,PG SHEESH ,10,8744,40248,48992,video
CompanyJ_1764,Luka hit Harden with his favorite move ,39,4944,26545,31489,video
CompanyJ_1765,PG had Aminu shook ,19,3168,14659,17827,video
CompanyJ_1766,Luka just making up moves at this point ,40,7571,38687,46258,video
CompanyJ_1767,PJ turned the ball over but he had Luka playing Twister ,56,921,5216,6137,video
CompanyJ_1768,Rose went coast to coast in 4 4 seconds Wow ,44,3918,23414,27332,video
CompanyJ_1769,KAWHI BANK FOR THE WIN ,23,1198,6996,8194,video
CompanyJ_1770,Russ makes history 10 straight games with a triple double the longest streak ever ,82,4602,18846,23448,photo
CompanyJ_1771,All Harden could do was smile after barely keeping his 30 points streak alive The Beard is now at 30 games straight ,116,1503,8284,9787,video
CompanyJ_1772,The moment Russ passed Wilt for the longest triple double streak ,65,3667,20089,23756,video
CompanyJ_1773,The Champions League is BACK GAME ON ,37,1744,7179,8923,photo
CompanyJ_1774,PG making a real MVP push Russ breaking records Won 11 of last 12 Don t sleep on OKC out West ,94,4694,26211,30905,photo
CompanyJ_1775,Anthony Edwards projected No 1 pick of 2020 draft is looking to lead Georgia to their first NCAA tournament since 2015 ,119,252,1912,2164,video
CompanyJ_1776,14 years ago today Allen Iverson dropped a career high 60 Unstoppable ,70,1852,7401,9253,video
CompanyJ_1777,The official signed scoresheet from Wilt Chamberlain s 100 point game Expected to auction for 100K via darrenrovell ,116,1204,6976,8180,photo
CompanyJ_1778,Today Watch on brlive ,22,185,1380,1565,photo
CompanyJ_1779,Chris Bosh plans to officially retire during his Heat ceremony in March via ringer 2x champion 11x All Star 19 2 PPG 8 5 REB ,125,2611,16106,18717,photo
CompanyJ_1780,A new move from Bradley Beal ,29,491,3329,3820,video
CompanyJ_1781,Today marks 19 years since Vince Carter shut down the 2000 Dunk Contest via NBATV ATTSlamDunk ,94,5495,21886,27381,video
CompanyJ_1782,Manchester United s last 11 games 10 wins 1 draw Pogba 8 goals 5 assists Rashford 6 goals 1 assist Became Champions League contenders The post Mourinho effect ,159,117,814,931,photo
CompanyJ_1783,This 7 year old might be the fastest kid alive via blaze_813 Instagram ,71,2741,13545,16286,video
CompanyJ_1784,First leg Barca 4 1 Roma Second leg Roma 3 0 Barca Roma advance ASRomaEN had one of the wildest comebacks in Champions League history via brfootball ,149,263,1387,1650,video
CompanyJ_1785,More rings than fingers Bill Russell turns 85 today ,52,3981,24675,28656,photo
CompanyJ_1786,The Professor Skip 2 My Lou and other AND1 legends still see their influence in the NBA and NBA stars agree Let s be real Kyrie Irving Isaiah Thomas James Harden a lot of guys they had to watch the tapes ,204,277,1060,1337,photo
CompanyJ_1787,AB just dropped this video as a thank you to Steeler nation Time to move on and move forward via AB84 ,102,2859,13342,16201,video
CompanyJ_1788,MVPG ,5,3404,16733,20137,photo
CompanyJ_1789,AB has officially requested a trade from the Steelers per AdamSchefter ,71,1127,4306,5433,link
CompanyJ_1790,The NFL season may be over but TheAAF is making sure football isn t ,68,780,3794,4574,video
CompanyJ_1791,NBA says it found no tampering between Lakers and Ben Simmons per ShamsCharania ,80,519,3920,4439,photo
CompanyJ_1792,Kawhi on his bank in game winner I was playing around telling the guys I called game like Paul Pierce did on his little interview ,130,1036,7268,8304,video
CompanyJ_1793, ,1,2783,13082,15865,photo
CompanyJ_1794,Huncho is coming for another MVP in the NBAAllStar Celebrity Game via QuavoStuntin ,83,1418,7139,8557,video
CompanyJ_1795,On this day in 2000 Jason Williams introduced the NBA to the elbow pass ,72,5621,25489,31110,video
CompanyJ_1796,All Champions League teams are holding a minute of silence for Emiliano Sala the player who died in a tragic plane crash ,121,448,3476,3924,video
CompanyJ_1797,Di Maria fell FAR ,18,230,2099,2329,video
CompanyJ_1798,Mbappe unstoppable ,19,910,4466,5376,video
CompanyJ_1799,Feb 12 2014 KingJames buries the Warriors and breaks out The Silencer celebration ,82,13902,51688,65590,video
CompanyJ_1800, Manchester United thought they had the easy win ,49,395,2454,2849,photo
CompanyJ_1801,PSG bursts Manchester United s bubble via brfootball ,53,461,2562,3023,video
CompanyJ_1802,When you watch the NBA today do you see the AND1 Mixtape Tour ,62,274,1736,2010,photo
CompanyJ_1803,Al Horford and the C s take on the 76ers in a potential ECF preview chocolate_milk ,83,153,1453,1606,video
CompanyJ_1804,Isaiah Thomas has been upgraded to questionable could make his debut for the Nuggets on Wednesday vs Sacramento per wojespn ,124,863,7324,8187,photo
CompanyJ_1805,Mbappe 14 goals in 24 games Ronaldo 14 goals in 40 games ,57,800,5086,5886,photo
CompanyJ_1806,Hawks just hit 10 threes and dropped 38 points on the Lakers in the first quarter ,82,959,6527,7486,photo
CompanyJ_1807,Hawks fans chanted Kobe s better at LeBron while he shot FTs ,61,4215,19341,23556,video
CompanyJ_1808,LSU AT THE BUZZER Tigers upset No 5 Kentucky 73 71 in Lexington ,64,1924,9232,11156,video
CompanyJ_1809,Trae Young just nutmegged LeBron ,33,1336,9263,10599,video
CompanyJ_1810,Simmons threw it down and Tatum immediately responded with a yam ,65,19449,76860,96309,video
CompanyJ_1811, Down 23 in the second half Still got the W No 2 Duke rallies late to beat No 16 Louisville 71 69 via CBSSports ,112,3091,11061,14152,video
CompanyJ_1812,SPIDA FEELING IT ,17,1290,12656,13946,video
CompanyJ_1813,Steph was hype after Boogie s slam ,35,249,3064,3313,video
CompanyJ_1814,Manchester United fans welcomed Di Maria back by throwing a beer at him and he wasn t gonna turn down free beer ,112,339,3230,3569,video
CompanyJ_1815,3 Ws in Lakers last 11 games Back to back losses 10th in the West Luke Walton s seat is getting hot ,100,834,6904,7738,photo
CompanyJ_1816,15 years ago today LeBron Wade and Carmelo Anthony took over the rookie challenge including 33 PTS from Bron and 17 from Melo ,126,1077,4902,5979,video
CompanyJ_1817, It s been 10 years Drake s So Far Gone album is still making its presence felt a decade later ,95,3240,12686,15926,video
CompanyJ_1818,Today s Champions League action is going to be good Watch on brlive ,68,45,402,447,photo
CompanyJ_1819,Young stars will be making headlines for years via brfootball ,62,864,6522,7386,photo
CompanyJ_1820,Coach K had to remind Duke in the huddle vs Louisville per WillBrinson I don t coach losers I coach winners Then Duke came back from a 23 point deficit in 9 minutes minutes to win by 2 ,185,658,4268,4926,photo
CompanyJ_1821,Ravens have agreed in principle to trade Joe Flacco to the Broncos can t go through until March 13th per AdamSchefter ,118,1413,4397,5810,photo
CompanyJ_1822,Happy 42nd birthday to NFL legend Randy Moss Holds NFL records for receiving TDs in a season 23 5x receiving TD leader 6x Pro Bowl NFL 2000s All Decade Team via nflthrowback ,174,3093,14905,17998,video
CompanyJ_1823,The challengers are coming for Real Madrid UCL via brfootball ,62,237,855,1092,video
CompanyJ_1824,D Lo reached out to LeBron for advice this summer It helped turn him into an All Star ,86,654,3936,4590,photo
CompanyJ_1825,Zach Lavine brought his BOUNCE to the Slam Dunk contest in 2016 ,64,2376,14865,17241,link
CompanyJ_1826, To hear maybe 60 000 people sing it not even at a concert would be very moving for him Ky Mani Marley How Bob Marley s Three Little Birds became Ajax s anthem via brfootball ,175,1323,5179,6502,video
CompanyJ_1827,Isaiah Thomas will make his debut for the Denver Nuggets tonight vs Sacramento per wojespn ,91,2467,16096,18563,photo
CompanyJ_1828,Most of the NBA s best players reside in the West so why are All Star selections still based on conference asks HowardBeck ,123,242,1448,1690,video
CompanyJ_1829,The security guard was crowd surfing in the PSG fans via s_leksaa brfootball ,77,456,3360,3816,video
CompanyJ_1830,Turnaround ,11,1399,7623,9022,photo
CompanyJ_1831,Brodie doesn t care about the criticism I ve been blessed with the talent to not give a f k per royceyoung ,107,2574,14301,16875,photo
CompanyJ_1832,Courtois is lucky this goal didn t count after that fumble ,59,100,810,910,video
CompanyJ_1833,Son with the Wakanda Forever celebration ,41,702,4406,5108,video
CompanyJ_1834,Vinicius Jr got past 3 defenders to assist Benzema s 7th goal in 7 games ,73,479,2734,3213,video
CompanyJ_1835, 87th minute winner Two away goals Real Madrid know how to take care of the Champions League via brfootball ,108,352,1543,1895,photo
CompanyJ_1836,Russ is a man of many talents ,30,2915,13550,16465,photo
CompanyJ_1837,D Wade acts out the iconic celebration from the 06 Finals win over Mavs during warmups in Dallas via DavidFurones_ ,115,2029,13055,15084,video
CompanyJ_1838,The Raptors player intros are ridiculous ,41,1303,8115,9418,video
CompanyJ_1839,Old teammates Boban and DeAndre reunite Jimmy wasn t having it ,63,3965,32249,36214,video
CompanyJ_1840,KNOX BAPTIZED SIMMONS ,22,11051,36749,47800,video
CompanyJ_1841,Only way to stop Giannis ,25,198,1587,1785,video
CompanyJ_1842,D Rose still SPEEDY via NBA ,28,1083,7480,8563,video
CompanyJ_1843,Simmons and DSJ getting chirpy ,31,574,4240,4814,video
CompanyJ_1844,OH MY ,6,2545,10964,13509,video
CompanyJ_1845,Wade over Luka Dirk over Wade The fader will be missed from these legends ,74,970,5950,6920,video
CompanyJ_1846,Jokic to himself ,17,337,3092,3429,video
CompanyJ_1847,30 points for the 31st consecutive game James Harden ties Wilt Chamberlain for the 2nd longest streak in NBA history ,117,548,2866,3414,photo
CompanyJ_1848,Standing ovation for IT as he checks in for his first game back from injury ,76,2114,14279,16393,video
CompanyJ_1849,Spicy P getting clutch buckets RUNNING POINT He s got a career high 37 ,71,665,5398,6063,video
CompanyJ_1850,The rook Okogie really locked down The Beard s step back via NBATV ,67,14267,61537,75804,video
CompanyJ_1851,Embiid almost took out Regina King ,35,816,3923,4739,video
CompanyJ_1852,D Lo iced the game in 3OT ,26,2804,16796,19600,video
CompanyJ_1853,IT coming through CLUTCH in his return ,39,2360,17608,19968,video
CompanyJ_1854,D Wade and Dirk exchange jerseys via dallasmavs ,48,5359,28083,33442,video
CompanyJ_1855, ,1,658,7782,8440,photo
CompanyJ_1856,JOKIC ENDS IT ,14,648,4795,5443,video
CompanyJ_1857, via NBCSNorthwest ,19,1044,6120,7164,photo
CompanyJ_1858,Kerr ready for the All Star break ,34,2370,13704,16074,video
CompanyJ_1859,29 years ago today Michael Jordan had to wear a nameless No 12 jersey after his No 23 was stolen from the locker room pregame ,126,5900,29066,34966,video
CompanyJ_1860,Wade to Dirk while exchanging jerseys last night It s an honor ,63,1157,10958,12115,photo
CompanyJ_1861,7 0 EMBIID INCOMING via rkd215 Instagram ,41,4214,27837,32051,video
CompanyJ_1862,Rematch in Chicago next year ,29,2410,18898,21308,photo
CompanyJ_1863,For the love of the game HappyValentinesDay ,44,423,3030,3453,photo
CompanyJ_1864,The hardest workers recognize game ,35,251,2773,3024,photo
CompanyJ_1865,With the Kiss Cam love is in the air for all to see via 15sof ,62,3147,14452,17599,video
CompanyJ_1866,CJ McCollum on treatment of white vs black athletes If it s a white athlete that comes in it s just that Oh he s mature When it s an African American athlete it s Oh he speaks well More from B R x BLK HSTRY on YouTube ,218,4104,10908,15012,video
CompanyJ_1867,Every team in the NBA went to Greece to scout Giannis except the New York Knicks Finding Giannis premieres Saturday at 6 30 ET on TNT ,134,741,3836,4577,video
CompanyJ_1868,Wade and his daughter are ready for his last All Star Weekend via DwyaneWade ,77,644,7368,8012,video
CompanyJ_1869,LBJ NBA team owner ,19,1044,7602,8646,photo
CompanyJ_1870,Happy Valentine s Day ,22,3680,14004,17684,video
CompanyJ_1871,Why is Brady commenting on everyone s Valentine s Day posts ,60,3078,28385,31463,photo
CompanyJ_1872,Markieff Morris has agreed to sign with the Thunder per ShamsCharania ,70,6809,28127,34936,photo
CompanyJ_1873,Shots fired via brfootball ,27,536,4530,5066,photo
CompanyJ_1874,Jimmy is suited and booted via JimmyButler ,43,1773,13287,15060,video
CompanyJ_1875, 2chainz on the stage Lil Durk Shiggy Filayyyy and more on the court BRxNC Sunday Charlotte MTNDEWxRUFFLESBALLERSBALL Register here ,132,36,179,215,photo
CompanyJ_1876,Valentine s Day Russ is in the building via NBAonTNT ,53,1153,7443,8596,video
CompanyJ_1877,Sunday s All Star Game will feature a lot of star power and a lot of 253M to be exact Turbotax ,95,461,2654,3115,video
CompanyJ_1878,Russ is now the Thunder Sonics all time points leader 18 208 ,61,3416,18623,22039,photo
CompanyJ_1879,Terrence Ross WHAT ,19,7315,31963,39278,video
CompanyJ_1880,Magic when asked about Kemba You know I can t answer any questions about no players because every time I do it I get fined via KeepBlitzin ,139,1814,9341,11155,video
CompanyJ_1881,Your updated standings heading into NBAAllStar ,47,526,3041,3567,photo
CompanyJ_1882,Alvin Gentry s response when asked about AD leaving the game after injuring shoulder I m going to talk about the guys who played the game via espn_macmahon ,156,148,1424,1572,video
CompanyJ_1883, carmeloanthony to D Wade People joke about the banana boat but we more than a banana boat OneLastDance via NBAonTNT ,117,1620,11210,12830,video
CompanyJ_1884,AD s MRI reveals that he suffered a muscle contusion in left shoulder that forced him to leave the game vs OKC It is unclear if he will miss the All Star game per sam_amick ,173,310,2214,2524,photo
CompanyJ_1885,LeBron says he can relate to Zion He s been covered since he was in high school and everybody is trying to compare him to the next this or the next that per mcten ,163,1139,11834,12973,photo
CompanyJ_1886,The energy was unreal when Dion Waiters and Tim Hardaway Jr turned the 2014 Rising Stars game into a one on one battle MTNDEWICERisingStars ,140,8757,35224,43981,video
CompanyJ_1887,Adam Silver debuts a new type of jersey that can change number and player via NBA ,82,12500,49061,61561,video
CompanyJ_1888,Gary Payton talking trash to Ron Harper as they help kids at a children s hospital is classic via jadande ,106,1337,7726,9063,video
CompanyJ_1889,Jayson Tatum says he would ve drafted Kyrie No 1 because he s the best player in the All Star Game this year ,109,989,8887,9876,photo
CompanyJ_1890,Feb 15 2001 13 year old Messi landed in Barcelona He had no contract yet people feared he was too young too small and too expensive He proved them all wrong via brfootball ,172,1058,5414,6472,photo
CompanyJ_1891,Kawhi Leonard is a simple man brkicks via nbhoops ,50,1247,8226,9473,photo
CompanyJ_1892,Historic numbers Massive following Praise from legends Luka Doncic is taking over ,82,987,4217,5204,video
CompanyJ_1893,The Pelicans have fired GM Dell Demps per wojespn ,50,2096,9891,11987,photo
CompanyJ_1894,Luka wanted his money via NBATV ,32,3397,24926,28323,video
CompanyJ_1895,Young Kyrie was just mean Taking ankles in the 2013 Rising Stars game like it was nothing MTNDEWICERisingStars ,111,3546,16361,19907,video
CompanyJ_1896,Colin Kaepernick and Eric Reid have settled grievances with the NFL but the resolution is subject to a confidentiality agreement per markgeragos ,145,880,2550,3430,photo
CompanyJ_1897,Dirk and D Wade had their battles but ultimately they improved one another Now they re hitting All Star weekend together one last time ,135,531,3761,4292,video
CompanyJ_1898, Word on the street is that LeBron s playing at 280 pounds groin injury hurt his conditioning program per WindhorstESPN ,120,1035,5781,6816,photo
CompanyJ_1899,15 years ago today Eddie Guerrero upset Brock Lesnar for the WWE championship R I P to a legend via WWE ,104,11589,33275,44864,video
CompanyJ_1900,9 year old caught his defender with creative handles via gstaroo7 jaden_b_fleek Instagram ,90,512,3615,4127,video
CompanyJ_1901,Poster dunks Beard heroics Cold blooded shots The NBA s top 10 plays at the All Star break ,91,1773,6569,8342,photo
CompanyJ_1902,Stephen Curry s mom taught him how to shoot Via MarcJSpearsESPN ,64,1806,11048,12854,video
CompanyJ_1903,Caught him reaching for the bait via its_hamza_i Instagram ,59,342,3907,4249,video
CompanyJ_1904,John Collins is lucky enough to be receiving advice from Dominique Wilkins and Vince Carter ahead of the AT amp T Slam Dunk Contest per ChrisKirschner ,151,293,2328,2621,photo
CompanyJ_1905,Jesus Shuttlesworth still got it via MiamiHEAT ,47,2188,11176,13364,video
CompanyJ_1906,D Wade having Ray Allen nostalgia sitting courtside via MiamiHEAT ,66,2973,17468,20441,video
CompanyJ_1907,The NBA s rising stars take center stage to kick off All Star Weekend ,70,531,3803,4334,photo
CompanyJ_1908,Someone give Jesus Shuttlesworth a 10 day ,42,8340,38633,46973,video
CompanyJ_1909,Collins prepping for the AT amp T Slam Dunk Contest ,52,384,3211,3595,video
CompanyJ_1910,Bagley windmill ,16,778,5389,6167,video
CompanyJ_1911,Collins off the backboard to HIMSELF ,37,1616,7890,9506,video
CompanyJ_1912,Simmons and Kuz going at it tonight Will one of them take home MVP ,67,413,2845,3258,video
CompanyJ_1913,Collins went 360 off a Trae Young alley oop WOW ,48,3245,18509,21754,video
CompanyJ_1914,If Trae Young got this off ,27,639,4135,4774,video
CompanyJ_1915,Trae Young showed off the handles with Uncle Drew mic d up ,59,953,5129,6082,video
CompanyJ_1916,AND ONE OKOGIE ,15,143,1271,1414,video
CompanyJ_1917,Team USA beats Team World 161 144 MTNDEWICERisingStars ,55,328,2190,2518,photo
CompanyJ_1918,Trae Young nutmeg on DeAndre Ayton ,35,1451,10777,12228,video
CompanyJ_1919,Kyle Kuzma wins the 2019 MTNDEWICERisingStars MVP ,50,4005,17587,21592,photo
CompanyJ_1920,Kenny s annual ASW party or another Fyre Festival via NBAonTNT ,63,311,2062,2373,video
CompanyJ_1921,Steph s bet against Seth in the 3 Point Contest Loser has to buy all the family tickets for the rest of our careers palm ,121,1814,9848,11662,video
CompanyJ_1922,MJ vs Bron KG and D Wade debate who s the on KGArea21 ,54,3062,12571,15633,video
CompanyJ_1923,Before the 1988 3 Point Contest Larry Bird asked everyone competing Who s coming in second Larry Legend won in his warm up jacket and celebrated before the last ball went in MtnDew3PT ,184,5805,30979,36784,photo
CompanyJ_1924,LeBron never did the Dunk Contest but if he did ,48,3517,21665,25182,video
CompanyJ_1925,Drazen Petrovic Mitch Richmond Dell Curry and a young Steph at the 1992 3 Point Contest MtnDew3PT ,98,961,5497,6458,photo
CompanyJ_1926,This year s All Stars turn back the clock with old school jerseys ,66,3884,21014,24898,photo
CompanyJ_1927, ,1,593,5205,5798,photo
CompanyJ_1928,From one phenom to another ,27,410,3675,4085,photo
CompanyJ_1929,Different league same Ronaldo via brfootball ,45,274,1609,1883,photo
CompanyJ_1930,D Wade says he ll only play his son Zaire one more time Been there done that via MiamiHEAT ,91,5655,31668,37323,video
CompanyJ_1931,Dirk is not committing to retirement I haven t announced this is gonna be it If it s still fun we re gonna make that decision later ,132,550,4363,4913,photo
CompanyJ_1932,11 years ago today Gerald Green blew out a candle on the rim So underrated via NBATV ATTSlamDunk ,97,14099,70682,84781,video
CompanyJ_1933, ,1,21279,78634,99913,photo
CompanyJ_1934,Taking a reverse layup in the 1996 Dunk Contest was a bold move from Darrell Armstrong via shaqtin ATTSlamDunk ,111,433,2951,3384,video
CompanyJ_1935,PSG really gave Mbappe a special jersey to celebrate scoring 100 goals in practice via KMbappe brfootball ,106,825,7371,8196,photo
CompanyJ_1936,D Wade vs Zaire via NBATV ,26,1128,8525,9653,video
CompanyJ_1937, Quavo couldn t stop telling me he had 2 more points than me ,61,435,4596,5031,video
CompanyJ_1938,In 2004 a rookie Kyle Korver splashed 9 straight triples in the MtnDew3PT Contest Nobody cheered louder than Allen Iverson Korver I ve started to understand more and more how big A I was for me early in my career per E_Woodyard ,228,888,6074,6962,photo
CompanyJ_1939,Zaire throwing lobs to Wade and Bron via NBAonTNT ,50,3244,19319,22563,video
CompanyJ_1940,LeBron said it takes a real man to patch things up like Kyrie did I love Kyrie I love everything about Kyrie ,109,2397,18947,21344,photo
CompanyJ_1941, I m Fox look at me Need Luka mic d up every game via NBAAllStar ,65,8687,47106,55793,video
CompanyJ_1942,Kobe won the 1997 Dunk Contest as an 18 year old rookie Youngest champ ever via NBAHistory ATTSlamDunk ,103,2530,10137,12667,video
CompanyJ_1943,Zaire getting lefty lessons from Harden via JHarden13 ,54,3825,25257,29082,video
CompanyJ_1944,13 years ago D Wade put on a perfect round to beat LBJ in the TacoBellSkills Challenge via NBAHistory ,102,2472,13263,15735,video
CompanyJ_1945,Who s taking home this year s 3 Point crown caesarspalace ,58,141,978,1119,video
CompanyJ_1946,Zion getting ready for next year s Dunk Contest via Mike_Schmitz ATTSlamDunk ,77,924,5562,6486,video
CompanyJ_1947,Whose creativity is gonna take it to another level tonight wellsfargo ,70,69,549,618,video
CompanyJ_1948,A fan asked Harden how many steps a travel was The Beard kept it via noahlevine_ jackpotier Instagram ,102,2080,12473,14553,video
CompanyJ_1949,This Kansas drummer was BRINGING IT ,36,5276,30315,35591,video
CompanyJ_1950,D Wade discussed his unique relationship and competition with Kobe via NBAonTNT ,80,13480,42905,56385,video
CompanyJ_1951,LeBron backs Colin Kaepernick ,30,3226,14139,17365,photo
CompanyJ_1952,The Greek Freak grew up idolizing The Answer and even had the cornrows via NBAonTNT ,84,777,5642,6419,video
CompanyJ_1953, MeekMill is confident the 76ers are going deep in the playoffs and can beat the Warriors via NBAonTNT ,103,956,5476,6432,video
CompanyJ_1954,Let the Saturday night festivities begin ,41,595,2890,3485,photo
CompanyJ_1955,Tatum with the comeback victory over Conley TacoBellSkills ,59,521,3624,4145,video
CompanyJ_1956,Trae steals the W from Swipa TacoBellSkills ,44,846,4977,5823,video
CompanyJ_1957,Luka tried it from half court and advanced TacoBellSkills ,58,553,3972,4525,video
CompanyJ_1958,Jokic didn t want to shake Tatum s hand after the loss TacoBellSkills ,70,471,4320,4791,video
CompanyJ_1959,Trae beats Luka in the battle of the rooks TacoBellSkills ,58,950,6205,7155,video
CompanyJ_1960,TATUM FROM HALF COURT FTW ,26,9981,43773,53754,video
CompanyJ_1961,The Curry family comes full circle at this year s All Star Weekend caesarspalace ,81,376,2036,2412,video
CompanyJ_1962,AND HE S ONLY 20 YEARS OLD TacoBellSkills ,42,1043,7021,8064,photo
CompanyJ_1963,Legends were a little rusty ,28,876,6642,7518,video
CompanyJ_1964,Joe Harris went perfect on the money ball rack and finished with 25 PTS MtnDew3PT ,82,1066,6692,7758,video
CompanyJ_1965,STEPH WITH 27 MtnDew3PT ,24,5456,20691,26147,video
CompanyJ_1966, Shoots like Steph big like Klay Buddy went off for 26 CaesarsPalace ,69,255,1875,2130,video
CompanyJ_1967,Joe Harris goes PERFECT on money rack AGAIN MtnDew3PT ,54,1443,8056,9499,video
CompanyJ_1968,Tonight needs one more contestant ,34,4229,23143,27372,video
CompanyJ_1969,A true underdog story Joe Harris almost wasn t even in the MtnDew3PT ,69,812,5298,6110,photo
CompanyJ_1970,Nets sleeper Joe Harris beats Steph to win the MtnDew3PT CaesarsPalace ,71,864,4313,5177,video
CompanyJ_1971,Shoot your shot Tatum ,22,433,3434,3867,photo
CompanyJ_1972,Joe Harris has arrived 2 5 PPG his first two seasons Assigned to G League 17x 13 9 PPG this year 47 1 3PT second in NBA Nets in the playoff mix MtnDew3PT champion ,163,1103,7084,8187,photo
CompanyJ_1973,DSJ 360 ATTSlamDunk ,20,635,3054,3689,video
CompanyJ_1974,She was fed up ATTSlamDunk ,27,1245,4702,5947,photo
CompanyJ_1975,Diallo brought out Russ for his 1st dunk ATTSlamDunk CaesarsPalace ,67,514,2774,3288,video
CompanyJ_1976,50 for Bridges ATTSlamDunk ,27,913,4356,5269,video
CompanyJ_1977,Ville Mentality ,16,3173,11866,15039,photo
CompanyJ_1978,John Collins broke the plane ATTSlamDunk ,41,545,3016,3561,video
CompanyJ_1979,DSJ OVER J COLE ATTSlamDunk ,28,7960,26980,34940,video
CompanyJ_1980,DIALLO REALLY DID THAT ,23,3043,10692,13735,photo
CompanyJ_1981,DIALLO REALLY DID THE VINCE ELBOW DUNK OVER SHAQ ,49,23323,79395,102718,video
CompanyJ_1982,J Cole tried it ATTSlamDunk ,28,12940,63974,76914,video
CompanyJ_1983,DSJ leapfrogged D Wade for 50 ATTSlamDunk ,42,640,3750,4390,video
CompanyJ_1984,Legendary Hamidou Diallo is your 2019 ATTSlamDunk Champ ,56,7989,27583,35572,photo
CompanyJ_1985,Diallo s creativity got him the Slam Dunk crown WellsFargo ,59,505,3052,3557,video
CompanyJ_1986,Russ amp PG were hyped after Diallo won the ATTSlamDunk via russwest44 ,71,1676,9708,11384,video
CompanyJ_1987,FIRE ,5,2587,16848,19435,photo
CompanyJ_1988,These guys won NBAAllStar Saturday ,35,1376,8598,9974,photo
CompanyJ_1989,What a night ATT ,17,659,3880,4539,video
CompanyJ_1990, 6x champion 6x Finals MVP 5x MVP 14x All Star 10x scoring champion Happy 56th to MJ ,85,15214,56622,71836,video
CompanyJ_1991,NBA All Stars pay homage to MJ s fashion sense on his birthday ,63,1308,6564,7872,photo
CompanyJ_1992,25 years ago today David Robinson racked up a quadruple double Nobody s done it since 34 points 10 boards 10 assists 10 blocks ,127,9500,41547,51047,video
CompanyJ_1993,1998 All Star Game Kobe s first Wasn t a starter during the season Youngest All Star in history 19 Scored a team high 18 PTS ,125,5141,19056,24197,video
CompanyJ_1994,Luka and Dirk doing the whisper challenge via NBAUK ,52,2674,13828,16502,video
CompanyJ_1995,Messi has now scored 30 goals in 11 consecutive seasons ELEVEN STRAIGHT via brfootball ,87,322,2094,2416,photo
CompanyJ_1996,Shaq showed no mercy in All Star games ,39,2136,10734,12870,video
CompanyJ_1997,Six titles Two three peats MJ sure knows how to celebrate ,58,1685,7898,9583,photo
CompanyJ_1998,LeBron explains why he chose Jordan s No 23 as a kid I wanna be able to fly like him I wanna be able to shoot like him I wanna be able to dunk on somebody like him ,164,1735,13319,15054,photo
CompanyJ_1999,The 2013 All Star Game was more than just an exhibition to Kobe ,64,11048,45332,56380,video
CompanyJ_2000,Back handspring into a dunk And John Collins loved it BRxNC ,60,670,5578,6248,video
CompanyJ_2001,There will never be a better All Star entrance than Shaq and the Jabbawockeez in 2009 ,86,11990,50999,62989,video
CompanyJ_2002,From Rich the Kid to French Montana the All Star Weekend BudLive party was incredible budweiserusa ,99,49,473,522,video
CompanyJ_2003,The crowd went WILD via lisafreestyle brfootball ,49,2405,13405,15810,video
CompanyJ_2004,Hamidou Diallo went sky high for the dunk of the night WellsFargo ,66,939,5819,6758,video
CompanyJ_2005,Dwyane Wade on taking the torch early in his career Kobe wasn t passing nothing A I wasn t passing nothing I had to come in and earn everything I got per MrMichaelLee ,167,1655,10234,11889,photo
CompanyJ_2006,19 goals in 18 league games for KMbappe via brfootball ,55,345,3089,3434,photo
CompanyJ_2007,Kyrie s layup package in the 2014 All Star Game was just ridiculous ,68,3268,15598,18866,video
CompanyJ_2008,Brodie x JColeNC NBAAllStar ,28,3333,26166,29499,photo
CompanyJ_2009,RUN IT BACK ,12,17334,58987,76321,video
CompanyJ_2010,An all time Melo NBAAllstar moment breaking the 3PT record in the 2014 All Star game ,85,917,4118,5035,video
CompanyJ_2011,One last All Star Dance via NBAAllStar ,39,5584,28905,34489,photo
CompanyJ_2012, TeamLeBron vs TeamGiannis via NBA ,35,2550,10488,13038,photo
CompanyJ_2013,One last All Star matchup for Dirk and D Wade ,46,332,2319,2651,video
CompanyJ_2014, I got to leak out in front of him I ain t as quick as I used to be Bron and D Wade talk last NBAAllStar game together and when we can expect a lob via NBAonTNT ,161,1514,6992,8506,video
CompanyJ_2015,Reunited NBAAllStar ,20,925,5516,6441,photo
CompanyJ_2016, Bout that time NBAAllStar ,27,236,1623,1859,photo
CompanyJ_2017,D Wade is going out on his own terms ,37,3385,17383,20768,photo
CompanyJ_2018, MeekMill kicking off NBAAllStar ,33,3803,12538,16341,video
CompanyJ_2019,One Last All Star Intro ,24,8862,36059,44921,video
CompanyJ_2020,Giannis putting on a dunkfest NBAAllStar ,41,339,2222,2561,video
CompanyJ_2021, I m done for the night Steph mic d up during the 360 dunk ,59,1106,6935,8041,video
CompanyJ_2022,Bron waiting for AD to check in NBAAllStar ,43,688,4938,5626,photo
CompanyJ_2023,BACK TO BACK 3s FOR DIRK ,25,4783,21327,26110,video
CompanyJ_2024,GIANNIS GOT UP ,15,17232,55934,73166,video
CompanyJ_2025,PG went 360 CaesarsPalace ,26,2612,10879,13491,video
CompanyJ_2026,At the half TeamGiannis leads TeamLeBron 95 82 Giannis 20 PTS 5 REBS 4 ASTS PG 14 PTS ,86,385,2640,3025,photo
CompanyJ_2027, 2chainz shut it down at BRxNC ,31,301,2801,3102,photo
CompanyJ_2028,J Cole brought out the old school Hornets jacket Cold ,54,11209,63961,75170,photo
CompanyJ_2029,Dirk mic d up ,14,3940,22777,26717,video
CompanyJ_2030,Wade to Bron Just like old times ,33,14740,55155,69895,video
CompanyJ_2031,This might be the last time we see a Bron Wade alley oop MetroPCS ,66,2172,8833,11005,video
CompanyJ_2032,DAME TIME FROM THE LOGO TWICE We ve got a game ,47,6141,31319,37460,video
CompanyJ_2033,D Wade and Dirk thank everyone for the opportunity to play in 2019 NBAAllstar ,78,1152,6196,7348,video
CompanyJ_2034,Steph on Klay AND 1 ,20,3130,13974,17104,video
CompanyJ_2035,Dunks Games PB amp Js The BRxNC event had a little bit of everything Statefarm ,79,58,400,458,video
CompanyJ_2036,This photo NBAAllStar ,22,1520,11419,12939,photo
CompanyJ_2037, TeamLeBron takes down TeamGiannis 178 164 KD 31 PTS 7 REBS Klay 20 PTS 8 REBS Kawhi and Bron 19 PTS ,101,1398,5055,6453,photo
CompanyJ_2038,Kyrie to Bron Chemistry still there BudweiserUSA ,49,1562,7939,9501,video
CompanyJ_2039,Game recognize game ,20,866,5289,6155,photo
CompanyJ_2040,All Star MVP number 2 for KD 31 PTS 7 REBS ,43,2210,10044,12254,photo
CompanyJ_2041, ,1,5068,30232,35300,photo
CompanyJ_2042,The best mic d up moments from 2019 NBAAllStar Game ,52,972,5160,6132,video
CompanyJ_2043,The Steph to Giannis alley oop was otherworldly statefarm ,58,2948,12067,15015,video
CompanyJ_2044,Break it down Kawhi ,20,1900,14264,16164,video
CompanyJ_2045,Captain to captain ,19,1313,12019,13332,photo
CompanyJ_2046, MeekMill nailed a 3 and won 4k during the AllStar Game ,56,1870,11083,12953,video
CompanyJ_2047,PG remixed Harden s move ,25,1537,9560,11097,photo
CompanyJ_2048,KD brings home another All Star MVP metrobytmobile ,51,394,2981,3375,video
CompanyJ_2049,That was fun ,13,4942,42602,47544,photo
CompanyJ_2050,Joker was trolling last night ,30,2145,18230,20375,video
CompanyJ_2051,On this day in 2002 a 17 year old high school junior was crowned The Chosen One Even got the words tattooed on his back He lived up to the hype via SInow ,154,5502,22126,27628,photo
CompanyJ_2052,Next year s contest just got interesting ATTSlamDunk ,53,816,5398,6214,photo
CompanyJ_2053,Embiid had the best time at All Star via djlukalorena ,54,1664,9305,10969,video
CompanyJ_2054,Drizzy putting in some pad work via HollywoodHino IG ,53,1863,12829,14692,video
CompanyJ_2055,This Steph Giannis alley is even more ridiculous in slow mo via NBA ,68,3509,17578,21087,video
CompanyJ_2056,This fan wanted a little more than Steph s autograph via HOOPmag ,65,1812,14831,16643,video
CompanyJ_2057,Only NBA players with an MVP two Finals MVPs and two All Star MVPs MJ Bron Magic Shaq Kobe KD joined the list last night via MrMichaelLee ,138,1525,7965,9490,photo
CompanyJ_2058,Ronaldo s cockiness and talent terrorized Atleti for years And as he returns to Madrid with Juventus fans haven t forgotten He s a guy that people dislike easily ,162,263,2284,2547,photo
CompanyJ_2059,D Generation X to be inducted into the WWE Hall of Fame Class of 2019 per tim00 Triple H Shawn Michaels Road Dogg Billy Gunn X Pac Chyna ,137,4382,14520,18902,photo
CompanyJ_2060,Kevin Garnett says the 2000 USA Olympics team had a 1M bounty to whoever could dunk on Yao Ming per steven_lebron ,114,4366,23202,27568,photo
CompanyJ_2061,Giants stopped fielding Odell Beckham trade offers after Patriots aggressively pursued him last summer per CSimmsQB ,116,1353,7352,8705,photo
CompanyJ_2062,That ASSIST paulpogba via EmiratesFACup ,40,569,2430,2999,video
CompanyJ_2063,Assist Goal Pogba flying ,25,318,2342,2660,photo
CompanyJ_2064,Powerful speech from Tim Tebow via SteveGelbs ,46,3468,11481,14949,video
CompanyJ_2065,Star studded NBAAllStar ,24,675,6236,6911,photo
CompanyJ_2066,Already flopping like a pro via vanbram ,40,334,2773,3107,video
CompanyJ_2067,One year ago Kobe and Shaq sat down to hash things out Greatest duo ever via NBAonTNT ,86,5985,28611,34596,video
CompanyJ_2068,Dwyane Wade on final All Star Game I realized this was it and I was thankful for that moment via FOXSportsFL ,109,1316,10600,11916,video
CompanyJ_2069,Steph s lob to Giannis had broadcasters HYPED around the world NBAAllStar via NBA ,82,2081,11371,13452,video
CompanyJ_2070, jarenjacksonjr on Luka Doncic entering the league I thought he was a myth via NBATV ,85,806,5977,6783,video
CompanyJ_2071,LaMelo is officially back via br_hoops IG ,42,7133,46571,53704,video
CompanyJ_2072,Russ on KD and Harden We made it to the Finals when we were 23 If we stayed together we could ve been a problem per LOLNetwork ,127,6326,34019,40345,photo
CompanyJ_2073,Former Laker Michael Beasley is finalizing a deal with Guangdong of the Chinese Basketball Association for significant cash over two months per wojespn ,152,479,4078,4557,photo
CompanyJ_2074,TODAY Depay Messi Salah Lewandowski Watch on brlive ,52,250,2316,2566,photo
CompanyJ_2075,75 YARD via deestroying ,24,2861,19389,22250,video
CompanyJ_2076,15 years ago today the Pistons traded for Rasheed Wallace He took Detroit over the top and helped upset the Kobe Shaq Lakers in the 2004 Finals Ball don t lie ,159,4719,20992,25711,photo
CompanyJ_2077,Nailing the Messi challenge in a Ronaldo kit via dylanpimentel10 IG brfootball ,79,1906,12313,14219,video
CompanyJ_2078,Nikola Jokic turns 24 today as one of the NBA s most unique superstars This season More points than Kyrie More assists than Harden More rebounds than AD More steals than Giannis More triple doubles than anyone but Russ ,219,8393,47704,56097,photo
CompanyJ_2079,Steph says unreal Zion has passion and playing style that you can t teach per JustinTinsley ,92,246,2873,3119,photo
CompanyJ_2080,Champions League is back via brfootball ,40,226,1398,1624,video
CompanyJ_2081,Breaking Manny Machado has agreed to a deal with the Padres per JeffPassan ,75,2411,7503,9914,photo
CompanyJ_2082,Machado s deal is 300M over 10 years the biggest free agent contract in the history of American sports per Feinsand ,116,2200,6943,9143,photo
CompanyJ_2083,2Chainz announces LeBron as the A amp R for his new album RapOrGoToTheLeague ,77,1460,6771,8231,photo
CompanyJ_2084, We still have some unfinished business in the Champions League Messi has eyes on the prize via FCBarcelona brfootball ,119,539,2800,3339,video
CompanyJ_2085,Just too easy for Melo Ball ,28,1909,9254,11163,video
CompanyJ_2086,Champions League giants vs Champions League giants via brfootball ,66,127,1347,1474,photo
CompanyJ_2087,Padres have themselves a new slugger ,37,290,2199,2489,photo
CompanyJ_2088,A fan virtually attends Barcelona s UCL game meets the players and watches warm up all from their hospital room via FundacioFCB OLfondation ,140,513,4244,4757,video
CompanyJ_2089,12 years ago Shaq Bron and Dwight s epic dance off at All Star weekend ,71,11480,46956,58436,video
CompanyJ_2090,No goals from Messi today ,26,309,1745,2054,photo
CompanyJ_2091,Kylie Ohlmiller might be the GOAT of women s lacrosse All time D 1 scoring leader in women s lax history 498 First person to score 150 points in 1 season Next up Winning gold for Team USA h t kylieohlmiller prowomenslax ,220,261,1256,1517,video
CompanyJ_2092,Dame is committed to what he s built with the Blazers ,54,2332,16898,19230,photo
CompanyJ_2093,What a save to keep Barcelona out ,34,82,901,983,video
CompanyJ_2094,Lonzo releases new song called Swerve ft Born Ready ,52,396,3041,3437,photo
CompanyJ_2095,All sounds recorded at All Star Charlotte ,42,323,2375,2698,video
CompanyJ_2096,PUTBACK POSTER via SECNetwork ,30,1487,7444,8931,video
CompanyJ_2097,Romeo Langford dropped him ,27,5371,27441,32812,video
CompanyJ_2098,Ter Stegen too good via brfootball ,35,339,3224,3563,video
CompanyJ_2099,He FLEW for that poster via sdotgdot__ ,39,2026,10483,12509,video
CompanyJ_2100,Another round of Ronaldo vs Atletico Madrid Watch on brlive ,60,64,467,531,photo
CompanyJ_2101,Harden has put the team on his back ,36,467,3732,4199,photo
CompanyJ_2102,The Beard leads the league in scoring minutes played and shot attempts but he might be doing too much ,102,279,1787,2066,video
CompanyJ_2103,2008 2014 2016 2017 2018 Ronaldo s quest for UCL no 6 continues via brfootball ,79,212,1261,1473,photo
CompanyJ_2104,Zion was 6 3 175 lbs freshman year of high school then over the course of about two years I picked up a hundred pounds per GQMagazine ,134,1030,7746,8776,photo
CompanyJ_2105,Dee Gordon opens up on losing his mother to domestic violence when he was seven years old ,90,262,1534,1796,photo
CompanyJ_2106, In other countries it s like If I don t make it my family won t eat 20 year old American WMckennie on motivation playing in Germany and earning his spot at Schalke ,165,367,2063,2430,video
CompanyJ_2107,5 year old dropped two defenders via arat gym IG brfootball ,60,4493,17696,22189,video
CompanyJ_2108,2 years ago today Boogie swapped his No 15 Kings jersey to play alongside The Brow in New Orleans as No 0 AmericanExpress ,122,215,1817,2032,video
CompanyJ_2109,Ronaldo Griezmann These two have history via brfootball ,56,267,3047,3314,photo
CompanyJ_2110,This Schalke fan has unreal balance via brfootball ,51,272,1789,2061,video
CompanyJ_2111,Ronaldo trolls hard via brfootball ,35,777,4314,5091,video
CompanyJ_2112,OBJ pays homage to the greatest via obj ,40,404,2835,3239,video
CompanyJ_2113, ,1,481,4620,5101,photo
CompanyJ_2114,RAHEEM STERLING WINNER via brlive ,34,395,1823,2218,video
CompanyJ_2115,LaMelo Ball says on Facebook s Ball In The Family that he plans on playing college basketball and has talked to USC amp Kansas ,127,1315,7237,8552,photo
CompanyJ_2116,Went a little overboard celebrating ,36,381,2565,2946,video
CompanyJ_2117,Not the return to Madrid Ronaldo expected ,42,202,1932,2134,photo
CompanyJ_2118,Unreal free kick from Sane ,27,810,4791,5601,video
CompanyJ_2119,MICKELSON S CALVES via kharms27 Instagram ,42,573,7533,8106,video
CompanyJ_2120,Dirk knows all the hits from the 90s via dallasmavs ,52,1760,8391,10151,video
CompanyJ_2121,LeBron says he has activated his playoff intensity earlier than usual with Lakers currently 10th in West per Baxter ,116,5310,26261,31571,photo
CompanyJ_2122,Mac made FIVE consecutive threes He s a shooter too via GeorgetownHoops ,72,490,3487,3977,link
CompanyJ_2123,The delivery man decided to take some shots at the house where he was dropping off a package via owenmcallister2 _lukemcallister IG ,132,8670,61256,69926,video
CompanyJ_2124,Zion s bounce will always be mesmerizing via BenGolliver ,57,1331,8271,9602,video
CompanyJ_2125,Zion went down with an injury his foot blew through his sneaker ,64,2541,11914,14455,photo
CompanyJ_2126,In sync jumps are not exclusive to dunks Via Vol_Track ,55,921,6483,7404,video
CompanyJ_2127,Georgia received a tech because a fan threw a teddy bear on the court They ended up losing 68 67 ,97,1445,8294,9739,video
CompanyJ_2128,Obama is probably the real reason Duke UNC tickets were selling for 2k ,71,4575,37777,42352,photo
CompanyJ_2129,No 8 UNC is unfazed by the fans at Cameron Indoor Stadium They beat No 1 Duke 88 72 ,84,2417,9152,11569,photo
CompanyJ_2130,The King looking out for Zion brkicks ,38,320,3064,3384,photo
CompanyJ_2131,The debate over the best burger has no right answer via 1jordanbell ,68,1745,11098,12843,video
CompanyJ_2132,Reminders ,10,870,5373,6243,photo
CompanyJ_2133,Zion Williamson has an 8M insurance policy that would only kick in if he slips past No 16 in the draft due to injury per darrenrovell ,134,2415,11135,13550,photo
CompanyJ_2134,Syracuse coach Jim Boeheim struck and killed a pedestrian in a highway crash on Wednesday night ,96,1335,4321,5656,photo
CompanyJ_2135,Georges St Pierre officially announced his retirement today 3x UFC Welterweight Champ 26 2 record LEGEND ,105,3215,12271,15486,photo
CompanyJ_2136,The only players with 20 goals in Europe s top 5 leagues Messi 22 and Mbappe 20 Elite via brfootball ,101,424,4098,4522,photo
CompanyJ_2137,Winter Is Coming via apiecebyguy ,33,4497,17564,22061,video
CompanyJ_2138,This 7 7 Egyptian player could give Boban some competition via AfricaLeague hamadfathy39_that_will_be_grat IG ,110,481,3287,3768,video
CompanyJ_2139,IT speaking facts ,18,3111,17585,20696,photo
CompanyJ_2140,In September Marcus Smart lost the most important person in his life but now he s playing the best basketball of his career Those around him say that s not a coincidence ,170,227,1425,1652,photo
CompanyJ_2141,AB and Anthony Davis will be the next guests on TheShopHBO ,59,1424,9044,10468,photo
CompanyJ_2142, I mean him he gets into a little more trouble than I did ochocinco and J_No24 pick their equivalents ,102,80,624,704,video
CompanyJ_2143,How soccer fans in Russia greet their team bus via zenit_spb brfootball ,72,4408,16807,21215,video
CompanyJ_2144, RealDealBeal23 wasn t fazed by the backlash from his Black Lives Matter post Anybody can talk behind a phone More from B R x BLK HSTRY on YouTube TheNBPA ,155,225,796,1021,video
CompanyJ_2145,Boogie speaks on the Zion situation ,36,912,5677,6589,photo
CompanyJ_2146,NBA officially proposes lowering draft age from 19 to 18 per Jeff Zillgitt ,75,8302,41010,49312,photo
CompanyJ_2147,All Star Game not competitive anymore HowardBeck has some ideas to make it better ,82,476,3063,3539,video
CompanyJ_2148,We linked up with NBA players in Charlotte for a game of Who Wore It All Star Edition Some of them were nicer than others From TISSOT x B R ,140,119,862,981,video
CompanyJ_2149,N B A B A C K ,14,1460,8416,9876,photo
CompanyJ_2150, Definitely one of the best two guards to ever play the game alleniverson with a special tribute to D Wade in Philly ,117,1360,5289,6649,video
CompanyJ_2151,Boban dropping tear drops like Tony Parker ,43,852,8274,9126,video
CompanyJ_2152,This Kyrie fadeaway ,20,4977,31428,36405,video
CompanyJ_2153,Khris was ready to end Theis ,29,422,3735,4157,video
CompanyJ_2154,Space Jam 2 is coming July 16 2021 per SpringHillEnt ,53,3548,13551,17099,photo
CompanyJ_2155,D Wade x Ben Simmons jersey exchange ,37,1557,13777,15334,video
CompanyJ_2156,Giannis said that Steph s alley oop bounce pass in the All Star Game was bad ,77,562,5246,5808,video
CompanyJ_2157,Giannis chased down Tatum ,26,4516,20664,25180,video
CompanyJ_2158,Pure filth by Kyrie ,20,1099,6316,7415,video
CompanyJ_2159,Khris Middleton CLUTCH ,23,417,3185,3602,video
CompanyJ_2160,Don Nelson has enjoyed retirement I ve been smoking some pot via anthonyVslater ,80,4423,17721,22144,video
CompanyJ_2161,Steph amazed at his own dunk ,29,3144,22236,25380,video
CompanyJ_2162,Kanter needed one win to be happy again ,40,286,3239,3525,photo
CompanyJ_2163,Don Nelson has been enjoying retirement ,40,694,3924,4618,photo
CompanyJ_2164,Bron trying to keep Lakers engaged on every possession ,55,331,3637,3968,video
CompanyJ_2165,How d Ingram get this to fall ,30,897,6082,6979,video
CompanyJ_2166,KD on Bagley ,13,1237,8545,9782,video
CompanyJ_2167,BRON STATUE OF LIBERTY ,23,7479,31411,38890,video
CompanyJ_2168,Lakers win as LeBron activates Playoff Mode ,44,5899,25719,31618,photo
CompanyJ_2169,DeMar returns to the North tonight ,35,2653,12059,14712,video
CompanyJ_2170,8 years ago today Melo made the move back to his hometown of NYC AmericanExpress ,81,485,3006,3491,video
CompanyJ_2171,PG 14 Paul George s jersey number switched to 14 ,49,1773,11551,13324,video
CompanyJ_2172,Chris Paul received another tech last night from ref Scott Foster James Harden on Foster For sure it s personal ,112,913,7708,8621,video
CompanyJ_2173, Beer is every place Kevin Harlan was incredible last night via NBAonTNT ,73,1741,10553,12294,video
CompanyJ_2174, Real Madrid have spent 1 000 days as champions via brfootball ,63,340,1526,1866,video
CompanyJ_2175,LeBron used his Secret Stuff to help the Lakers come back last night ,69,2473,12735,15208,video
CompanyJ_2176,Karl Anthony Towns was involved in a car accident Thursday night on his way to the airport He is listed as questionable for tonight s game vs the Knicks ,153,665,4609,5274,photo
CompanyJ_2177,Zion Williamson will not play in Saturday s game vs Syracuse per GoodmanHoops ,78,330,2194,2524,photo
CompanyJ_2178,Patriots owner Robert Kraft has been charged with soliciting prostitution per the Jupiter Police Department ,108,7439,20329,27768,photo
CompanyJ_2179,A spokesperson for Robert Kraft categorically denies that the Patriots owner engaged in any illegal activity after soliciting prostitution charges per ByJillMartin ,164,243,1114,1357,photo
CompanyJ_2180,Nuggets coach Michael Malone getting buckets on Jamal Murray via nuggets ,73,3516,22406,25922,video
CompanyJ_2181,With 25M downloads in one week Apex Legends is coming for Fortnite s crown via brgaming ,88,505,3015,3520,video
CompanyJ_2182,Buddy Hield hit a deep clutch three argued with his coach then hesitated on the game winner Postgame I should have pulled that b h ,131,7791,45627,53418,video
CompanyJ_2183, I want to be the LeBron James of baseball From gunning for the Hall of Fame to starting his own production company 24 year old Alex Bregman is planning to take over MLB ,170,292,1543,1835,photo
CompanyJ_2184,Brady Vick Mahomes We asked NFL stars which QB they d take in a football version of Space Jam ,94,227,1487,1714,video
CompanyJ_2185,KD after swatting Marvin Bagley five times in one half It wasn t a back and forth via gswchris ,95,600,4672,5272,video
CompanyJ_2186, Half court shot Perfect backflip Marcus Smart is one of a kind via taylorcsnow ,80,339,3048,3387,video
CompanyJ_2187, Clowns on television are saying Don t play That s what we do We play basketball Chuck didn t hold back on the Zion debate via NBAonTNT ,136,4140,15564,19704,video
CompanyJ_2188,Zion Williamson has been the biggest story of the 2018 2019 season But if his season had ended vs North Carolina where would he rank among the best freshmen of all time ,169,110,1057,1167,photo
CompanyJ_2189,Playoff Bron had rihanna hyped at Staples Center last night ,60,2040,12204,14244,video
CompanyJ_2190, YaoMing x 1GunnaGunna DripOrDrown2 ,36,1939,6063,8002,video
CompanyJ_2191,Need a hype man like ZO2_ via JaValeMcGee ,42,7634,34789,42423,video
CompanyJ_2192,This kid s got heart via mgoul ,31,6830,36286,43116,video
CompanyJ_2193,DeMar returns to Toronto tonight ,33,917,7413,8330,photo
CompanyJ_2194,Ric Flair teared up when EVERYBODY came to to his surprise 70th birthday party Todd Gurley Charles Barkley Dennis Rodman Triple H Chris Jericho Evander Holyfield Many more via ArashMarkazi ,189,15044,68437,83481,video
CompanyJ_2195,Gordon swatted Lauri twice with ridiculous hangtime ,52,425,3568,3993,video
CompanyJ_2196,This Raptors tribute video for DeMar DeRozan via Raptors ,57,1948,8534,10482,video
CompanyJ_2197,DeMar appreciated the love via NBA ,35,2947,21975,24922,video
CompanyJ_2198,DeMar 360 layup via NBA ,24,2024,9958,11982,video
CompanyJ_2199,OH MY DSJ ,10,19613,72117,91730,video
CompanyJ_2200,Trae Young literally spun his defender around ,46,31139,101300,132439,video
CompanyJ_2201,KAWHI STEALS THE BALL FROM DEMAR FOR THE WIN ,45,2290,11869,14159,video
CompanyJ_2202,Was this a backcourt violation ,31,629,5013,5642,video
CompanyJ_2203,All love between DeMar and Lowry ,33,927,9684,10611,video
CompanyJ_2204,DeMar and Kyle Lowry after the game ,36,593,3163,3756,video
CompanyJ_2205,Thon Maker FOR THE WIN ,23,1412,10053,11465,video
CompanyJ_2206,PG windmill off the break via NBA ,34,4374,24601,28975,video
CompanyJ_2207,PG FLOATER FOR THE WIN IN 2OT ,30,9346,43192,52538,video
CompanyJ_2208,The Brodie amp MVPG ,20,3830,15575,19405,photo
CompanyJ_2209,41 PTS 9 REB 5 AST LaMelo went off last night ,46,4418,28934,33352,video
CompanyJ_2210,REACH BACK ,11,1989,16752,18741,photo
CompanyJ_2211,5 0 career hat tricks for Messi LEGEND ,39,819,4002,4821,video
CompanyJ_2212,22 Sevilla 1 0 Barca 26 Sevilla 1 1 Barca Messi 42 Sevilla 2 1 Barca 67 Sevilla 2 2 Barca Messi 85 Sevilla 2 3 Barca Messi ,123,661,3659,4320,photo
CompanyJ_2213, HERE WE ARE This pregame speech was real via CoachDubMaddox ,61,3940,14566,18506,video
CompanyJ_2214,Ochocinco helped out a fan who was facing eviction Real one ,60,31659,152206,183865,photo
CompanyJ_2215,Slow Mo Tear Drop ,18,2702,16171,18873,video
CompanyJ_2216,D Angelo Russell took the leap at 22 Career high PPG APG FG Nets 6th in the East Youngest to hit 500 3s First All Star berth Today he turns 23 What s next ,155,3788,25844,29632,photo
CompanyJ_2217, I hate going to that building It s a team that cost us our dreams It s tough to erase the memory of last year because you knew you had that chance The Rockets are still haunted by last year s Warriors ,202,357,2520,2877,photo
CompanyJ_2218,This dad mic d up his 4 year old at hockey practice via howtohockey ,68,4310,22984,27294,video
CompanyJ_2219,Giannis is spending the day with Easton King a 12 year old from MakeAWish He s one of the best teammates I ve ever had via WISN_Watson ,135,432,3730,4162,video
CompanyJ_2220,Ben Simmons wasn t having it with Nurkic You talk a lot of s t for being ass NSFW ,82,13131,61107,74238,video
CompanyJ_2221,WILD OT finish for LSU Tennessee LSU comes away with the W 82 80 ,65,437,2648,3085,video
CompanyJ_2222,AAF is back Watch the Stallions vs Hotshots on BRlive via TheAAF ,65,50,276,326,video
CompanyJ_2223,Kanter came at Simmons after getting dropped ,45,1502,11013,12515,video
CompanyJ_2224,It s Zion s world via brkicks ,30,419,4362,4781,photo
CompanyJ_2225,Rockets Warriors tonight Last time they played Harden hit one of the most ridiculous shots of the year and predicted another MVP ,129,2400,12552,14952,video
CompanyJ_2226,JuJu s out here running routes in crowded malls via TeamJuJu ,61,4083,27794,31877,video
CompanyJ_2227,Paul George is making a strong MVP push His last 10 36 PTS W 37 PTS W 43 PTS W 37 PTS L 39 PTS W 27 PTS W 45 PTS W 47 PTS W 28 PTS L 45 PTS W ,142,5930,33552,39482,photo
CompanyJ_2228,John Wall honors his mom with a new tattoo He recently revealed she has cancer ,79,4864,32572,37436,photo
CompanyJ_2229,Okay Kuz ,9,2035,14288,16323,video
CompanyJ_2230,Thomas Bryant almost punched the ref on this celebration ,57,616,4306,4922,video
CompanyJ_2231,Greatest shooter ever via NBA ,30,6542,36759,43301,video
CompanyJ_2232,No 1 Duke gets revenge on Syracuse without Zion 75 65 ,54,827,6603,7430,photo
CompanyJ_2233,Trae Young from the logo ,25,2264,16183,18447,video
CompanyJ_2234,Lance got t ed up for fake throwing the ball at the ref ,56,491,4568,5059,video
CompanyJ_2235,DLo dropped 40 PTS and took over in the 4Q vs the Hornets ,58,3374,17247,20621,video
CompanyJ_2236,Was this the right call on Kemba to close out the game ,55,136,1297,1433,video
CompanyJ_2237,Zach LaVine 42 PTS Lauri Markkanen 35 PTS Both career highs in 126 116 win over the Celtics ,92,1804,9929,11733,video
CompanyJ_2238,Lopez stared Saric down after the dunk and got t ed up ,55,834,5878,6712,video
CompanyJ_2239,This Bucks fan put on an absolute show ,39,7632,42153,49785,video
CompanyJ_2240,BIG TIME win for the Rockets who beat the Warriors at Oracle without James Harden 118 112 CP3 23 PTS 17 AST Eric Gordon 25 PTS ,127,1297,6430,7727,photo
CompanyJ_2241,It took Steve Kerr awhile to realize Draymond Green was hurt ,61,4194,28817,33011,video
CompanyJ_2242,Tony Hawk helping his daughter overcome her fear of skating via tonyhawk ,73,4372,35451,39823,video
CompanyJ_2243,Giannis has been on another level His last eight PTS REB AST 37 10 2 W 30 15 9 W 43 6 4 W 29 16 5 W 29 17 8 W 33 19 11 W 30 13 6 W 27 10 7 W ,141,2656,18803,21459,photo
CompanyJ_2244,LeBron on the Lakers commitment after Pelicans loss Is basketball the most important thing in your life at this time ,117,627,4299,4926,photo
CompanyJ_2245,What via brfootball ,20,701,3812,4513,photo
CompanyJ_2246,James Harrison Von Miller and other NFL stars pick whether they re more T Challa or Killmonger ahead of the Oscars ,115,134,1071,1205,video
CompanyJ_2247,Some moves never age Dirk turned back the clock for a season high 15 PTS last night ,84,3577,31263,34840,video
CompanyJ_2248,D Rose s last four games 23 PTS 20 PTS 12 PTS 22 PTS Averaging 17 2 off the bench Sixth Man of the Year ,104,6154,37806,43960,video
CompanyJ_2249,Why isn t Kyrie worried about Boston s struggles carrying into the playoffs Because I m here via ByJayKing ,107,985,7660,8645,photo
CompanyJ_2250,Danielle Gibson made history last night with a home run cycle solo HR 2 run HR 3 run HR and grand slam It s only the 2nd in NCAA D I history and she s the first to do it in only FOUR innings via YoCoachYo ,205,1453,7388,8841,video
CompanyJ_2251,Sarri tried to sub off Chelsea s goalkeeper Kepa but he refused to leave and Sarri flipped out via SkyFootball ,111,10534,30951,41485,video
CompanyJ_2252,Manchester City wins the League Cup for the second year in a row via brfootball ,80,455,1867,2322,photo
CompanyJ_2253,Kenneth Faried was benched traded for cap space and waived in the past year Since joining the Rockets 16 PPG 9 9 REB career high paces Nine double doubles in 14 games More 3s than the rest of his career combined ,212,4047,27576,31623,photo
CompanyJ_2254,This freshman s walk up song for his first plate appearance via stadium_sounds IG ,82,2395,13588,15983,video
CompanyJ_2255,Casually racing a moose down a ski slope in Canada via Russell11Simon ,70,1625,11040,12665,video
CompanyJ_2256,Tristan Thompson and Miles Bridges mimicked D Angelo Russell s ice in my veins celebration vs Brooklyn D Lo closed out both games H T NetsDaily ,144,6133,29463,35596,video
CompanyJ_2257,No 10 Michigan State gets the statement W over No 7 Michigan Spartans defeat the Wolverines 77 70 Winston 27 PTS 8 ASTS Goins 16 PTS 11 REBS ,141,884,3870,4754,photo
CompanyJ_2258,Someone get Bobi and Tobi on the red carpet via tobias31 ,57,333,4224,4557,photo
CompanyJ_2259,Hard fall for IT after getting hit by Pat Bev He s okay though ,63,371,5338,5709,video
CompanyJ_2260,Mahershala Ali was hooping before he was acting Oscars via NCAA ,64,2815,10339,13154,video
CompanyJ_2261,Becky Hammon putting in work with Rudy Gay before today s game via NBA ,71,1341,14150,15491,video
CompanyJ_2262,The Knicks are scoring on their own basket now ,47,1242,9057,10299,video
CompanyJ_2263,DSJ tried it ,13,8161,40586,48747,video
CompanyJ_2264,DSJ s been showing out at The Garden ,37,2863,20610,23473,video
CompanyJ_2265,Goalie can t stop scoring via gkalshatti IG brfootball ,55,3230,19104,22334,video
CompanyJ_2266, Last Chance U coach Jason Brown resigns after allegedly sending I m your new Hitler text to a German player ,109,2787,11552,14339,photo
CompanyJ_2267,There s a Brinks truck literally at Dodgers training facility amid reports of them being in on Bryce Harper via pedrogomezESPN ,127,761,3907,4668,video
CompanyJ_2268,If DSJ hit this via nyknicks ,29,987,7363,8350,video
CompanyJ_2269,55 years ago today Muhammad Ali shook up the world Then known as Cassius Clay 22 year old Ali defeated Sonny Liston as a 7 1 underdog to win his first heavyweight title ,169,3101,11281,14382,photo
CompanyJ_2270,He was the only MLB player to kneel during the national anthem What happened next ,82,116,679,795,photo
CompanyJ_2271,Tatum s reserving his All Star spot for next year wrangler ,59,123,1088,1211,video
CompanyJ_2272,LBJ rocking a Bronny shirt today via mcten ,43,1055,10402,11457,photo
CompanyJ_2273, The Nature Boy Ric Flair turns 70 years old today Absolute legend ,67,2190,9906,12096,photo
CompanyJ_2274,This wedding went full WWE via nboulanger IG ,45,4462,20408,24870,video
CompanyJ_2275,Joker is for the kids via TJMcBrideNBA ,39,608,5124,5732,video
CompanyJ_2276, ,1,261,2932,3193,photo
CompanyJ_2277,Michael Porter Jr hasn t played all year back but now he s throwing down windmills with ease ,93,3247,26189,29436,video
CompanyJ_2278,Dennis Rodman s reaction to Joel Embiid saying MJ is not the GOAT You re doing a great job for your little island or country where you re from Shut the f k up go do your goddamn job via TMZ_Sports ,197,4039,17873,21912,photo
CompanyJ_2279, He killed the chemistry He shouldn t have been so public about AD One NBA exec says LeBron deserves blame in LA per B R s EricPincus ,134,1478,6718,8196,photo
CompanyJ_2280,Former No 3 pick Trent Richardson is dominating in the TheAAF Most TDs Sixth in yards Undefeated ,97,1256,7323,8579,video
CompanyJ_2281,Messi was there for Neymar via brfootball ,42,466,4764,5230,photo
CompanyJ_2282,KD just took MKG on a journey ,30,3173,15429,18602,video
CompanyJ_2283,D Lo s got the rainbow floater on lock ,39,2898,24007,26905,video
CompanyJ_2284,Boogie galloping Warriors new favorite celebration ,51,328,3033,3361,video
CompanyJ_2285,New look for DwyaneWade ,24,1682,10925,12607,photo
CompanyJ_2286,D Wade showing his son he s still got it ,41,3336,22132,25468,video
CompanyJ_2287,Roman Reigns announces he s in remission from cancer ,53,1743,10035,11778,photo
CompanyJ_2288,Noah out here hoopin like it s 2014 ,36,2616,14335,16951,video
CompanyJ_2289,Avery Bradley made Ingram hit the ground ,41,2104,9851,11955,video
CompanyJ_2290,Boogie threw Jeremy Lamb s shoe into the crowd and got t ed up ,63,782,5207,5989,video
CompanyJ_2291,History for The ,16,2175,8818,10993,photo
CompanyJ_2292,Shammgod worked with Kobe on his handles 20 years ago Now he s training Kobe s daughter Gigi ,93,749,5613,6362,photo
CompanyJ_2293,The streak is over Harden s stretch of 30 point games comes to an end at 32 ,76,820,5267,6087,photo
CompanyJ_2294,Despite the loss Trae Young dropped a career high 36 PTS and went 8 12 from 3PT vs the Rockets ,95,2088,10973,13061,video
CompanyJ_2295,Another bad loss for the Lakers After falling to the Grizzlies tonight they re now 1 4 in their last 5 games ,109,912,4898,5810,photo
CompanyJ_2296,2 days ago KAT was involved in a serious car accident and had to sit out in concussion protocol In his first game back he dropped 34 PTS 21 REBS and 5 ASTS ,156,1454,12164,13618,photo
CompanyJ_2297,Lotta buckets in this photo OneLastDance ,41,995,9079,10074,photo
CompanyJ_2298, ,1,1297,7954,9251,photo
CompanyJ_2299,Oh no Lakers ,13,3565,15782,19347,video
CompanyJ_2300,Doc called a timeout to stop the game so Clippers players and fans could give Dirk a standing ovation ,102,18485,93186,111671,video
CompanyJ_2301,Trae Young in three games since the All Star break 29 7 PPG 8 7 APG 15 threes 51 7 3PT ,87,1987,15896,17883,photo
CompanyJ_2302,Harden had 28 points with 10 seconds left Hawks weren t letting that streak continue ,85,1102,8560,9662,video
CompanyJ_2303,Josh Hart threw this fan some gum from the sideline via claymassengille IG ,75,1949,23321,25270,video
CompanyJ_2304,If they ever let Harden on a football field via realDockery ,60,8290,33568,41858,video
CompanyJ_2305,Rockies 3B Nolan Arenado agree to a eight year 255M extension per JeffPassan The deal gives Arenado the largest per year salary of any position player ,151,913,4563,5476,photo
CompanyJ_2306,Lakers since Lonzo Ball got hurt Jan 19 4 9 Losing by 16 8 PPG Losses to Hawks Pelicans Grizzlies ,98,2680,13080,15760,photo
CompanyJ_2307,Reggie is still automatic via ReggieMillerTNT ,46,2685,14525,17210,video
CompanyJ_2308,Which way would you bet br_betting ,35,170,1654,1824,photo
CompanyJ_2309,13 year old Olivia Moultrie turns pro will sign a contract with Nike via COPA90US ,82,7713,44534,52247,video
CompanyJ_2310,Megatron gives NFL prospect Hakeem Butler some tips at the line via NFLTotalAccess ,83,1307,7815,9122,video
CompanyJ_2311,Former dancer Shirley Darlington Rowat shirtrix is now a parkour warrior pulling buses through London ,102,54,353,407,video
CompanyJ_2312,Tampering via Dloading ,23,1167,12702,13869,photo
CompanyJ_2313, LethalShooter__ lildurk and BdotAdot5 put on a show and got the dub for the Iced Out Ballers in the MtnDewxRufflesBallersBall in paid partnership with MountainDew ,164,46,286,332,video
CompanyJ_2314,Leading the charge for the Ridge Riders Austinjmills and famouslos32 balled out in the MtnDewxRufflesBallersBall in paid partnership with ruffles ,146,26,164,190,video
CompanyJ_2315,Mitchell Robinson blocked Aaron Gordon twice in one possession ,63,1107,7878,8985,video
CompanyJ_2316, SHOOOOT Lowry taking advice from fans mid game ,48,1253,8033,9286,video
CompanyJ_2317,Down goes Duke RJ Barrett s 21 PTS not enough as No 20 Virginia Tech holds off No 3 Duke 77 72 ,95,692,3845,4537,photo
CompanyJ_2318,That was cold ISO_ZO ,21,965,5357,6322,video
CompanyJ_2319,Kyrie is fed up ,16,4050,26936,30986,video
CompanyJ_2320,PG IS A BAD MAN ,16,6293,35934,42227,video
CompanyJ_2321,IT BACK ,8,1884,12549,14433,video
CompanyJ_2322,Russ had to have a chat with the Nuggets fan real quick ,56,1186,8808,9994,video
CompanyJ_2323,so many emotions ,17,917,9630,10547,video
CompanyJ_2324,Two Clasicos in four days via brfootball ,41,270,1701,1971,photo
CompanyJ_2325,Pelicans vs Lakers tonight ,27,622,6918,7540,photo
CompanyJ_2326,PG flew ,8,816,7496,8312,photo
CompanyJ_2327,Giants HC Pat Shurmur wants Eli Manning back When everyone started playing better around Eli he played better he ll be back ,124,228,1913,2141,photo
CompanyJ_2328,Russ felt a boundary was crossed ,33,690,5600,6290,video
CompanyJ_2329,IT got into it with a fan on the sideline last night via murshed_sawaged IG ,76,633,4607,5240,video
CompanyJ_2330,She took the defender s ankles on the step back via hola_Travito ,65,400,2457,2857,video
CompanyJ_2331,Set a world record with 31 straight NBA threes in ONE MINUTE via miracola360 ,77,4501,25465,29966,video
CompanyJ_2332,Dee Ford went from a bust to a breakout star for the Chiefs then cost them a trip to the Super Bowl Now the free agent wants to come back to Kansas City even hungrier ,167,136,1023,1159,photo
CompanyJ_2333,Eagles won t franchise tag Nick Foles allowing him to become a free agent per AdamSchefter ,91,655,3538,4193,photo
CompanyJ_2334,Steph Curry tosses an alley oop to a Parkland student via anthonyVslater ,73,546,6922,7468,video
CompanyJ_2335, BANG BANG Three years ago today Steph Curry pulled up from 38 for the win ,75,5127,26678,31805,video
CompanyJ_2336,D K Metcalf is a 6 4 240 lb WR who looks ready to destroy the NFLCombine ,73,3580,19022,22602,video
CompanyJ_2337,Man of many paulpogba via brfootball ,37,127,1134,1261,photo
CompanyJ_2338,Bron is feeling himself today via kylegoon ,43,1842,12454,14296,video
CompanyJ_2339,Backheel goal that chipped the keeper via NBCSportsSoccer ,58,1279,6749,8028,video
CompanyJ_2340,Suarez vs Real Madrid October 28 Hat trick in 5 1 win February 27 Go ahead goal in Copa del Rey semifinal ,106,110,812,922,photo
CompanyJ_2341,Safety Toni Harris commits to Central Methodist University She is the first woman to sign a letter of intent at a skill position in CFB history via _Antoinetteeeee ,164,1889,6208,8097,video
CompanyJ_2342,Barcelona takes down Real Madrid 4 1 on aggregate via brfootball ,65,876,3701,4577,photo
CompanyJ_2343,Eagles say thank you to Nick Foles via Eagles ,46,3228,14083,17311,photo
CompanyJ_2344, ,1,1026,7527,8553,photo
CompanyJ_2345,Kemba hit Harden with his own step back That s cold ,52,5688,35051,40739,video
CompanyJ_2346,SHEESH via SECNetwork ,22,2352,9169,11521,video
CompanyJ_2347,D Lo dancin on em ,18,2119,13102,15221,video
CompanyJ_2348, McclungMac showing out via GeorgetownHoops ,44,674,3851,4525,video
CompanyJ_2349,Wade nutmegged Draymond ,24,733,5283,6016,video
CompanyJ_2350,Harden missed 22 threes before this one ,40,873,7210,8083,video
CompanyJ_2351,Rodney Hood owes Jadakiss a beer ,33,171,910,1081,video
CompanyJ_2352,Vinsanity is still hanging in the air at 42 ,44,2002,10815,12817,video
CompanyJ_2353,KLAY OFF THE DRIBBLE ,21,730,6068,6798,video
CompanyJ_2354,FATHER PRIME FOR THE WIN ,25,43637,118661,162298,video
CompanyJ_2355,Amazing via MiamiHEAT ,22,6034,24888,30922,video
CompanyJ_2356,Ain t that just like D Wade ,28,4914,22703,27617,photo
CompanyJ_2357,Mood ,5,1758,8396,10154,photo
CompanyJ_2358, spidadmitchell hit the brakes ,31,3607,18503,22110,video
CompanyJ_2359,Tough times in Boston ,22,246,2325,2571,photo
CompanyJ_2360, When Kobe hit that game winner on me in LA off the glass from the top of the key I said how is that possible Thank you for showing me the way Mamba Mentality DwyaneWade ,170,15287,58642,73929,video
CompanyJ_2361,Flight 23 via NBA ,18,1592,8637,10229,video
CompanyJ_2362,Marvin Bagley gets carried off the floor after an apparent knee injury ,71,466,3821,4287,video
CompanyJ_2363,KUZZZZZ via NBA ,16,652,4912,5564,video
CompanyJ_2364,King Clutch AD s reaction ,26,10560,44838,55398,video
CompanyJ_2365,Trae looks like The Answer in ATL ,34,986,6974,7960,photo
CompanyJ_2366,Still not over this DwyaneWade via b_schutz IG ,47,3459,20950,24409,video
CompanyJ_2367,His house in 2009 His house in 2019 ,36,15268,65972,81240,video
CompanyJ_2368,Messi and Modric six years later via brfootball ,48,1236,6230,7466,photo
CompanyJ_2369,From game worn shoes to a free concert for 900 fans StephenCurry30 is the people s champ ,89,688,4544,5232,video
CompanyJ_2370,Scoreboard gave AD s first bucket to the Lakers ,48,2555,17634,20189,video
CompanyJ_2371,D Wade came through in the clutch ,34,599,6273,6872,photo
CompanyJ_2372,And he just turned 20 today ,28,670,5104,5774,photo
CompanyJ_2373,NBA and WNBA stars are asked about the first time they were called the N word Are You Listening w TheNBPA amp TheWNBPA FCHWPO CJMcCollum _ajawilson22 mconley11 ,160,803,2157,2960,video
CompanyJ_2374,Jason Witten announces he s returning to the Cowboys after year in MNF booth ,77,5036,17341,22377,photo
CompanyJ_2375,LeBron is ready for all challengers ,36,907,5266,6173,photo
CompanyJ_2376,Toni Harris is breaking barriers in football ,45,288,1606,1894,photo
CompanyJ_2377, cassius_stanley went for the windmill from the line ,53,2570,12940,15510,video
CompanyJ_2378,The step back The ankles The stare The Beard ended Wesley Johnson a year ago today ,83,5120,25166,30286,video
CompanyJ_2379,Breaking Bryce Harper is headed to the Phillies per JonHeyman ,62,9024,20728,29752,photo
CompanyJ_2380,Bryce Harper s deal is for 330M which breaks Giancarlo Stanton s MLB record per JonHeyman ,90,1382,4677,6059,photo
CompanyJ_2381,Harden ISO game has put him in the history books ,49,571,3087,3658,video
CompanyJ_2382,Russ feeling himself pregame via NBAonTNT ,42,973,6885,7858,video
CompanyJ_2383,The HoHighlights show is LIVE Look forward to special guest J_No24 coming up soon ,82,6,34,40,link
CompanyJ_2384,OH MY JORDAN POOLE via BigTenNetwork ,37,771,3484,4255,video
CompanyJ_2385,James Harden from way back ,27,680,4003,4683,video
CompanyJ_2386,Boogie looking more and more like his old self ,47,631,5387,6018,video
CompanyJ_2387,Giannis wouldn t sit out if he was in Zion s position I love basketball too much per TMZ_Sports ,96,476,5072,5548,photo
CompanyJ_2388,Refs assisting the Warriors now ,32,517,3267,3784,video
CompanyJ_2389,The one player that always makes J_No24 takes his game to the next level Julio Jones via HoHighlights ,102,154,743,897,video
CompanyJ_2390,Coach s son got emotional when he realized the seniors won t be back next season via LeVelleMoton ,98,14003,81935,95938,video
CompanyJ_2391,Larry Nance yelled ball don t lie twice after missed FT s on his flagrant foul ,79,2953,20812,23765,video
CompanyJ_2392,PJ Tucker was heated after getting called for an offensive foul and got ejected ,80,574,3113,3687,video
CompanyJ_2393,D Wade fakes never get old ,27,6751,34653,41404,video
CompanyJ_2394,Another buzzer beater for Samajae Haynes Jones and Gregg Marshall earns his 300th career win via GoShockersMBB ,111,307,1681,1988,video
CompanyJ_2395,FIFTY SIX Harden has Houston on his BACK ,41,555,3856,4411,photo
CompanyJ_2396,They put a tarantula on OmarHoH s head via HoHighlights ,56,124,718,842,video
CompanyJ_2397,58 and a W for The Beard ,25,1343,6548,7891,photo
CompanyJ_2398,D Wade and CP3 Brothers for life ,33,2038,13998,16036,video
CompanyJ_2399,James Harden now has six 50 PT games this season No other player has more than one ,83,2279,11401,13680,video
CompanyJ_2400,Joe Ingles is just tryna have a good time ,42,309,3723,4032,video
CompanyJ_2401,LeBron is the first athlete ever to A amp R an album RapOrGoToTheLeague out now ,80,2876,10791,13667,photo
CompanyJ_2402,Korver is in that zone ,23,745,8210,8955,video
CompanyJ_2403,SPIDA MITCHELL CLUTCH ,22,1042,7495,8537,video
CompanyJ_2404,Oh no Jason Terry ChocoChallenge ,33,1709,8235,9944,video
CompanyJ_2405,Ty Lue could replace Luke Walton if Lakers part with the head coach this summer per ChrisBHaynes ,97,1885,12149,14034,photo
CompanyJ_2406, hopesolo is helping girls become ankle breaking ballers at Tudela F C via brfootball ,86,440,2802,3242,video
CompanyJ_2407, GameOfZones is coming ,23,1267,5804,7071,photo
CompanyJ_2408,From the studio to the hardwood RapOrGoToTheLeague KingJames x 2Chainz ,71,2019,6813,8832,video
CompanyJ_2409,Kevin Durant says he no longer needs to prove himself I don t need anything in this basketball world to fulfill anything in me The NBA is never going to fulfill me per KerithBurke ,180,666,4823,5489,photo
CompanyJ_2410,With rising stars and a surprising playoff push the Kings might be the best story of the NBA season says HowardBeck ,116,775,3529,4304,video
CompanyJ_2411,Bron won the contest and timed the beat perfectly via LakersReporter ,69,4778,28223,33001,video
CompanyJ_2412,Damian Lillard may be the NBA s most selfless superstar On what kind of legacy he ll leave They re going to remember the kind of person I was ,142,438,2887,3325,photo
CompanyJ_2413,Ole Miss WR D K Metcalf put up 27 reps on bench press The next seven receivers 13 12 14 8 7 13 15 via mattschneidman ,117,1358,8159,9517,photo
CompanyJ_2414,Antoine Davis broke Stephen Curry s freshmen 3 point record as a 3 star recruit ,80,912,4751,5663,video
CompanyJ_2415,All Star tributes Vintage alley with LBJ Game winner of the year D Wade s OneLastDance has owned February ,106,1199,6149,7348,video
CompanyJ_2416,Pau Gasol and Spurs agree to buyout will be playoff eligible wherever he signs per wojespn ,91,486,2698,3184,photo
CompanyJ_2417,Gasol plans to sign with Milwaukee Bucks per wojespn ,53,1287,7763,9050,link
CompanyJ_2418,LaMelo feeling that new Zo Lance track via ZO2_ ,48,2899,15003,17902,link
CompanyJ_2419, If you re not here to compete or fight to the death I don t want you on my team Boogie was not playing around TheDivision2 ,124,468,2593,3061,video
CompanyJ_2420,D Lo rainbow shots ,19,604,5246,5850,video
CompanyJ_2421,Ice Trae from the logo Casual ,30,1761,12589,14350,video
CompanyJ_2422,Huerter on Markkanen Sheesh ,28,1113,6529,7642,video
CompanyJ_2423,Kyrie took the Wizards defense on a journey ,44,398,2761,3159,video
CompanyJ_2424,Vince had Lauri slippin ,24,1639,10149,11788,video
CompanyJ_2425,Trae Young came up CLUTCH again Game headed to OT ,50,3254,17986,21240,video
CompanyJ_2426,Trae Young forces 2OT CLUTCH ,29,1349,6993,8342,video
CompanyJ_2427,OH MY LAVINE ,13,2215,9978,12193,video
CompanyJ_2428,KAWHI FOR THE WIN ,18,1612,7655,9267,video
CompanyJ_2429,DEVIN BOOKER PUT AD ON A POSTER ,32,4183,19906,24089,video
CompanyJ_2430,Zach LaVine with a critical turnover Game is headed to 4OT ,59,392,2617,3009,video
CompanyJ_2431,Bron incoming via NBA ,22,706,4783,5489,video
CompanyJ_2432,What a night for Zach LaVine 47 PTS career high 9 REB 9 AST 4OT win over the Hawks ,83,734,4411,5145,photo
CompanyJ_2433,This Brandon Ingram move and finish Wow via NBA ,48,3117,16643,19760,video
CompanyJ_2434,Trae Young has been BALLIN ,27,2672,11941,14613,photo
CompanyJ_2435,Bron reverse putback via NBA ,29,10159,49393,59552,video
CompanyJ_2436,Brook Lopez didn t get the memo DON T JUMP WITH INGRAM via NBA ,63,2508,10807,13315,video
CompanyJ_2437,Giannis is just too strong via NBA ,35,2768,14280,17048,video
CompanyJ_2438,Bucks clinch a playoff spot with a win in L A ,46,1212,8636,9848,photo
CompanyJ_2439, ,1,6579,38686,45265,photo
CompanyJ_2440,Eric Bledsoe drops a season high 31 PTS in 131 120 win over the Lakers He just signed a 4 year 70M extension with Milwaukee ,124,413,4342,4755,video
CompanyJ_2441,Second save is UNREAL via NBCSportsSoccer ,42,429,2913,3342,video
CompanyJ_2442,Wilt Chamberlain scored 100 points on March 2 1962 57 years later still a record ,81,2969,14307,17276,photo
CompanyJ_2443, Yo AB tell that boy the route Still burned him via AB84 ,57,4188,26227,30415,video
CompanyJ_2444,Fell flat on his face trying to celebrate SoccRepublic ,55,787,4523,5310,video
CompanyJ_2445,AD is coming into his own as the CEO of his career You growing up The Shop replays tonight at 9 45pm on HBO via RealSportsHBO ,126,499,2714,3213,video
CompanyJ_2446,Lil Boosie pitched it to the gutter and still got a strike via BOOSIEOFFICIAL ,78,1351,7169,8520,video
CompanyJ_2447,Roger Federer wins his 100th career title One Hundred ,54,1159,5497,6656,photo
CompanyJ_2448,LUKAKU 88TH MINUTE WINNER via NBCSportsSoccer ,46,649,3679,4328,video
CompanyJ_2449,People around the NFL believe almost universally the Cardinals will draft Kyler Murray with the No 1 pick per KimJonesSports ,125,547,3148,3695,photo
CompanyJ_2450,Tom Brady proved QB combine numbers are important but they re not everything via NFL ,85,755,4608,5363,photo
CompanyJ_2451,The Ridge Riders A 4 point shootout in the Around The Ridge Challenge Chips for everyone Ruffles had everyone living like ballers at the MtnDewxRufflesBasketballCourt ,167,20,154,174,video
CompanyJ_2452,Reached 50 PSG goals in just 76 games Second highest scorer in Europe s top 5 leagues KMbappe via brfootball ,109,527,4125,4652,photo
CompanyJ_2453,Trae Young s playing like he heard the doubters His last five 30 PTS 10 AST 23 PTS 8 AST 36 PTS 8 AST 36 PTS 10 AST 49 PTS 16 AST ,130,4832,27115,31947,photo
CompanyJ_2454,Philly rides with No 3 ,23,692,5526,6218,photo
CompanyJ_2455,D K Metcalf has taken over the NFL combine 6 3 228lbs 27 reps 40 5 vertical 4 33 40 time 1 6 body fat ,102,12860,65561,78421,photo
CompanyJ_2456,Messi and Ramos getting heated via brfootball ,46,1223,9880,11103,photo
CompanyJ_2457,Barcelona against Real Madrid 5 1 in October 3 0 in February 1 0 in March ,74,1985,5615,7600,photo
CompanyJ_2458, ,1,2540,19025,21565,photo
CompanyJ_2459,D K Metcalf broke down on the phone with his family after a life changing performance at the combine via NFL ,109,7409,56874,64283,video
CompanyJ_2460,Whoops ,7,552,4009,4561,photo
CompanyJ_2461, You chasing followers They re chasing greatness Prime Time was preaching via DeionSanders ,91,1372,4699,6071,video
CompanyJ_2462, The impact that David Beckham s had on the sport in America can t be overstated Respect from kobebryant via LAGalaxy ,118,370,2045,2415,video
CompanyJ_2463,Blake s handles and 3PT game have come a long way ,50,1424,10354,11778,video
CompanyJ_2464,Abby Wambach Serena Williams Doris Burke For Women s History Month the USWNT chose women who inspire them for the names on their jerseys today via brfootball ,158,260,1432,1692,photo
CompanyJ_2465,Oh ,3,1599,8933,10532,photo
CompanyJ_2466,Turner put Isaac on a POSTER ,29,556,3421,3977,video
CompanyJ_2467,Never seen D Wade so scared ,28,903,5110,6013,video
CompanyJ_2468,OH MAN DJJ ,11,1211,6166,7377,video
CompanyJ_2469, Handshake Matching braids Like father like son via NBA ,56,2033,15586,17619,video
CompanyJ_2470,Spurs broadcast loses it over this Rudy Gay dunk ,49,1266,7440,8706,video
CompanyJ_2471,Bron GOT UP on Rondo s alley oop ,33,827,5552,6379,video
CompanyJ_2472,Derrick Favors tried to end Ersan Ilyasova with this dunk ,58,1355,9072,10427,video
CompanyJ_2473,LeBron James passes Kobe Bryant for 5th on NBA s all time career field goals list 11 720 ,89,1741,8866,10607,photo
CompanyJ_2474,Josh Jackson one handed alley oop Wow ,38,756,5819,6575,video
CompanyJ_2475,D Lo amp Flash OneLastDance ,28,1485,9633,11118,photo
CompanyJ_2476,Bron just turned the ball over on a routine inbounds play after Lakers gave up another layup ,93,1424,7569,8993,video
CompanyJ_2477,This Will Barton assist was too smooth ,39,2410,14123,16533,video
CompanyJ_2478,Donovan Mitchell came up BIG in win over the Bucks Spida dropped a career high 46 PTS ,86,2252,15417,17669,video
CompanyJ_2479,Lakers drop another game on the road Lost to last place Phoenix Suns 4 5 games back of 8th spot 3 7 in last 10 games ,117,1241,6610,7851,photo
CompanyJ_2480,Only Magic is ahead of Steph in Andre s eyes ,45,519,3858,4377,photo
CompanyJ_2481,Today we pay tribute to Flash and all his greatness DWadeDay ,61,3850,14180,18030,video
CompanyJ_2482,Steph stepped into the crowd to calm tensions between a Warriors fan and a security guard via nce1913 ,102,1723,11815,13538,video
CompanyJ_2483,Allen Iverson broke out one of his coldest crossovers ever on this day in 2006 The Answer dropped Antonio Daniels twice ,120,9796,37433,47229,video
CompanyJ_2484,Nevada s Jordan Caroline gets heated after a Utah State coach yelled a profanity laced insult at him per michaeleaves NSFW via JakeKUTV ,136,1642,6995,8637,video
CompanyJ_2485,The kid from Marquette became an NBA icon The one man show became a selfless 3x champ DWadeDay ,95,3731,18992,22723,photo
CompanyJ_2486,Montez Sweat ran a blazing 4 42 Record for a DL since 2003 He s 260 via NFL ,76,3297,19331,22628,photo
CompanyJ_2487,D Wade State of Mind DWadeDay ,30,964,3868,4832,video
CompanyJ_2488,KD forgot he had the towel on via MindiABC7 ,44,1065,8606,9671,video
CompanyJ_2489,Jaguars absolutely expect to sign Nick Foles per LesBowen ,58,1321,6323,7644,photo
CompanyJ_2490, Defender slaps floor Defender gets scored on Opponent turns the tables Brutal sequence ,88,8872,39322,48194,video
CompanyJ_2491,He waved goodbye after crossing him up via kiywii ,50,3811,19629,23440,video
CompanyJ_2492,2006 DALLAS Won almost single handedly with 34 7 PPG 2012 OKC Took down a rising KD Harden Russ powerhouse 2013 SAN ANTONIO Helped defeat one of the great modern dynasties DWadeDay ,181,1588,6575,8163,photo
CompanyJ_2493,Devin White sheds tears after running a 4 42 the best 40 time for a linebacker via thecheckdown ,96,3310,23592,26902,photo
CompanyJ_2494,Nobody s ankles are safe today Uncle Drew vs The Beard via NBA ,63,2846,14405,17251,video
CompanyJ_2495,Wade County DWadeDay ,21,1095,6074,7169,photo
CompanyJ_2496,Rodney Hood found the stroke ,29,1031,8030,9061,video
CompanyJ_2497,Kyrie dipped into Dirk s bag of tricks via celtics ,51,597,5194,5791,video
CompanyJ_2498,Mario Balotelli scored and headed straight to Instagram to celebrate via beINSPORTSUSA ,87,2709,12493,15202,video
CompanyJ_2499,Things get a little chippy after Kris Dunn slaps Trae Young in the back of the head ,84,818,4854,5672,video
CompanyJ_2500,Celtics are down big again This time at home ,45,394,3194,3588,photo
CompanyJ_2501,Harden had Marcus Smart going in circles via HoustonRockets ,60,278,1730,2008,video
CompanyJ_2502,Why d he slap Ed Oliver like this via thecheckdown ,51,786,5903,6689,video
CompanyJ_2503,Following in his dad s footsteps Hard work paid off for Zaire Wade during his junior season DWadeDay ,101,1202,7834,9036,video
CompanyJ_2504,Trae Young got ejected with his 2nd technical after trash talking Kris Dunn ,76,3477,20295,23772,video
CompanyJ_2505,The Beard is a baaaaad man via NBA ,35,7689,38203,45892,video
CompanyJ_2506,Another 40 point game for The Beard another L for the Celtics 42 PTS 7 REBS 4 ASTS 2 STLS ,90,620,3771,4391,photo
CompanyJ_2507,Kristine Anigwe put women s college hoops on notice with a 32 amp 30 game ,74,915,4312,5227,photo
CompanyJ_2508,Zubac enjoying LAC ,19,965,7114,8079,photo
CompanyJ_2509,This kid stared everybody down like he hit a game winner in Game 7 of the Finals ,81,9829,60947,70776,video
CompanyJ_2510,Russ got a tech for talking to himself ,39,1000,7138,8138,video
CompanyJ_2511, ,1,2012,12428,14440,photo
CompanyJ_2512,From D Wade to Z Wade The legacy continues DWadeDay ,52,862,5729,6591,photo
CompanyJ_2513,Blake deserves the bucket for this ridiculous shot ,51,2682,17775,20457,video
CompanyJ_2514,CLUTCH BRODIE ,14,2274,13068,15342,video
CompanyJ_2515, SnoopDogg is ready to sell his Lakers box seats for 5 They f king suck NSFW ,77,7434,30032,37466,video
CompanyJ_2516,To the rescue russwest44 ,25,898,9777,10675,photo
CompanyJ_2517,A amp R Bron and 2Chainz dropped a classic with RapOrGoToTheLeague ,67,469,2902,3371,video
CompanyJ_2518,Iconic FinallyMario via OM_English ,35,1491,7464,8955,video
CompanyJ_2519,Jon Gruden is very interested in Kyler Murray per Peter King via dpshow ,72,279,2648,2927,photo
CompanyJ_2520,Lakers Melo are pausing talks on possible contract agreement unless LA can make a turn back toward playoff contention per wojespn ,130,706,5012,5718,photo
CompanyJ_2521, So now the Lakers aren t good enough for you ,46,563,4006,4569,photo
CompanyJ_2522,This is why you don t ball in dress shoes YG via dumbonthedrum ,63,672,4180,4852,video
CompanyJ_2523,Bryce Harper s No 3 Phillies jersey becomes the fastest seller in any sport within the first 24 hours per Fanatics ,115,662,4746,5408,photo
CompanyJ_2524,Andrew Bogut will sign with the Warriors for the rest of the season after he gets clearance from NBL s Sydney Kings per ChrisBHaynes ,133,1938,10751,12689,photo
CompanyJ_2525,Flight from the free throw line via The_ColeAnthony ,52,1002,8062,9064,video
CompanyJ_2526,Doesn t even need his hands to get buckets via neymarjr ,56,574,4727,5301,video
CompanyJ_2527,Texans use 15 4M LB franchise tag on Jadeveon Clowney after no progress on long term deal per AaronWilson_NFL ,110,279,1726,2005,photo
CompanyJ_2528,Mtn Dew s Iced Out Ballers balled out in the MtnDewxRufflesBallersBall Check out MountainDew s squad on the limited edition cans ,129,17,122,139,video
CompanyJ_2529,Blake puts it all into perspective ,35,584,4092,4676,photo
CompanyJ_2530,Mbappe recruiting OBJ via PSG_English ,38,394,3179,3573,video
CompanyJ_2531,The Splash Sisters still tearing up the over 85 league via JulieFoudy ,70,4646,24309,28955,video
CompanyJ_2532,Trae Young on his comparisons to Luka Like Magic and Bird it can be something like that where we both can be great via ringer Winging It Pod ,141,792,8293,9085,photo
CompanyJ_2533,Something to look forward to ,29,646,5794,6440,photo
CompanyJ_2534,The ref s eyebrows literally froze at the coldest game in MLS history via ColoradoRapids btyphoto ,98,1707,9294,11001,photo
CompanyJ_2535,This 5th grader won a middle school 3PT contest with one of the purest jumpers you ll see via inthegymhoops_ IG ,112,15583,69958,85541,video
CompanyJ_2536,The Brazilian Open used adoptable shelter puppies as ball dogs for the fourth straight year The pups stole the show ,116,536,2827,3363,video
CompanyJ_2537,Down goes Luka ,15,1811,10826,12637,video
CompanyJ_2538, via AB84 ,10,2263,14728,16991,photo
CompanyJ_2539,Vince just passed Reggie Miller for 20th on the all time scoring list ,70,1118,9137,10255,video
CompanyJ_2540,The Nets bench celebrations never get old ,42,1297,8615,9912,video
CompanyJ_2541,Loading ,8,1417,8861,10278,photo
CompanyJ_2542,The Barclays crowd goes wild for Dirk after he hits his first shot of the night ,80,812,5916,6728,video
CompanyJ_2543, Damn Vince Carter is still surprised by D Wade in the clutch ,62,547,4740,5287,video
CompanyJ_2544,D Wade moves ahead of MJ ,25,1418,6758,8176,photo
CompanyJ_2545,Kevin Huerter grew up idolizing D Wade so Wade pulled him aside for a jersey swap after the game ,97,10645,74264,84909,video
CompanyJ_2546,Pat Bev ready to bother Bron all night long ,44,2176,16193,18369,video
CompanyJ_2547,Olympic gold medalist sydneyleroux is 5 1 2 months pregnant and still out there competing via brfootball ,105,976,7043,8019,photo
CompanyJ_2548,DSJ dunks off the break are something else ,43,2682,16853,19535,video
CompanyJ_2549,Swipa threw down a windmill ,28,1369,8777,10146,video
CompanyJ_2550, ,1,13326,64878,78204,video
CompanyJ_2551,Another day another Lakers L ,29,1596,7493,9089,photo
CompanyJ_2552,Pat Bev was loving the boos at Staples Center ,46,2104,14033,16137,video
CompanyJ_2553,Kuz gave Bron a boost ,22,4317,28895,33212,video
CompanyJ_2554,The second legs are here ForTheThrone via brfootball ,53,162,1203,1365,video
CompanyJ_2555,Some Lakers fans chanted We want Kobe after LeBron missed a late free throw last night per jovanbuha ,101,1693,8955,10648,photo
CompanyJ_2556,Hit em with the spin before the layup via Alvarez2Neftali ,58,938,6411,7349,video
CompanyJ_2557, When you re on that Yellow Wall you re part of something much bigger BlackYellow created something special in their stands via brfootball ,139,347,1670,2017,video
CompanyJ_2558,3 minute 47 second indoor mile Yomif Kejelcha broke a 21 year old record via RunnerSpace_com ,93,2315,13909,16224,video
CompanyJ_2559,Will Smith will play Venus and Serena Williams dad in new movie King Richard per DeadlineMike ,94,396,3041,3437,photo
CompanyJ_2560,Quinnen Williams ran a 4 83 at 303 pounds at the NFLCombine His breakfast that day Four double stuffed Oreos per VicTafur ,122,448,3267,3715,photo
CompanyJ_2561,Son Heung min nailed the goal and the celebration against Dortmund Can stuholden stevenash and MauriceEdu recreate his volley via brfootball ,141,37,293,330,video
CompanyJ_2562,Victor Oladipo has a long road back after his season ending injury but he s been prepared for this challenge by four women in his life ,135,255,1706,1961,photo
CompanyJ_2563,Mike Tyson at 52 via BoxingL1fe ,32,20149,88025,108174,video
CompanyJ_2564,Brandone Francis hadn t seen his mom in two years She came from the Dominican Republic to surprise him at senior night via TexasTechMBB ,136,2737,12641,15378,video
CompanyJ_2565,The only player who can save the Lakers ,40,6252,22121,28373,video
CompanyJ_2566,Nate Burleson makes his pitch to be on Monday Night Football Hell yeah I d take the job via AdamLefkoe ,103,86,733,819,video
CompanyJ_2567,Chiefs Tyreek Hill have begun negotiations on a potential record setting deal per RapSheet ,91,735,5715,6450,photo
CompanyJ_2568,A grape was tossed from the roof and he actually caught it in his mouth via uhlexeo Instagram ,94,1232,10538,11770,video
CompanyJ_2569,Entering game Real Madrid 2 1 Ajax After 18 minutes Real Madrid 2 3 Ajax aggregate ,83,250,1492,1742,photo
CompanyJ_2570,Lakers fans want that old thing back via michael manea IG ,58,10170,35018,45188,link
CompanyJ_2571,The turn the pass the finish via brfootball ,44,885,4405,5290,video
CompanyJ_2572,Real Madrid needs 3 goals to advance with less than 15 minutes left ,68,702,3816,4518,photo
CompanyJ_2573,The Champions League kings are kicked off the throne ,53,747,3184,3931,photo
CompanyJ_2574, via brfootball ,16,651,2982,3633,photo
CompanyJ_2575,Blown leads for returning champs ,33,301,2189,2490,photo
CompanyJ_2576,Ajax too smooth via brfootball ,31,1895,9907,11802,video
CompanyJ_2577,Trae Young is keeping the battle for ROY interesting ,53,742,5143,5885,video
CompanyJ_2578,Embiid tampering for Madrid ,28,852,6051,6903,photo
CompanyJ_2579, Drake training with world heavyweight champ anthonyfjoshua ,60,210,1743,1953,photo
CompanyJ_2580,Really scored from that angle via brfootball ,45,1729,9980,11709,video
CompanyJ_2581,Steven Adams is completely unbothered ,38,429,4094,4523,video
CompanyJ_2582,RISE UP ZachLaVine ,19,466,2804,3270,video
CompanyJ_2583,That was tough Drose ,21,1449,9628,11077,video
CompanyJ_2584,Duke survives Wake Forest 71 70 off 28 points from RJ Barrett who set the Blue Devils freshman season scoring record with 696 pts ,130,563,3807,4370,photo
CompanyJ_2585,Beard Behavior ,15,564,4111,4675,video
CompanyJ_2586,Another monster game for KAT 41 PTS 15 27FG 14 REBS 2 STLS ,59,386,3201,3587,video
CompanyJ_2587,CLUTCH CONLEY 40 piece and a 4 point play to seal the game ,59,2028,13166,15194,video
CompanyJ_2588,Dray with the block and stare down on Tatum ,44,1251,9378,10629,video
CompanyJ_2589,Jaylen Brown got UP ,20,1244,8810,10054,video
CompanyJ_2590,Tatum with a lot of room to work ,33,671,6732,7403,video
CompanyJ_2591, TATUM ,7,4671,21537,26208,video
CompanyJ_2592,Things got chippy between Boogie and the Celtics ,49,1590,10735,12325,video
CompanyJ_2593,Huge night for Gordon Hayward 30 PTS 7 REB 4 AST in 28 min off the bench 128 95 W over the Warriors ,100,1545,10387,11932,photo
CompanyJ_2594,A week makes all the difference ,32,1738,18801,20539,photo
CompanyJ_2595,21 year old Frenkie de Jong left Modric shook ,46,820,5776,6596,photo
CompanyJ_2596,19 years ago today SHAQ put up 61 points on his birthday via NBAonTNT ,70,3471,21979,25450,video
CompanyJ_2597,Out of the Champions League Out of the Copa del Rey Third in La Liga Something s missing for Real Madrid via brfootball ,120,214,1209,1423,photo
CompanyJ_2598,Reese is a 4 0 high school player and he can BALL via r3eseeee IG ,66,910,6110,7020,link
CompanyJ_2599,Andrew Bogut has received his letter of clearance from NBL and is working to finalize a one year minimum deal to return to the Warriors per ShamsCharania ,154,447,3167,3614,photo
CompanyJ_2600,5 9 Chris Clemons is serving up 30 1 PPG as the nation s leading scorer via gocamels ,85,2386,9372,11758,video
CompanyJ_2601, Take It There with TaylorRooks is dropping in April ,53,112,585,697,video
CompanyJ_2602, Pogba s a rapper but I m the beat maker From a personal recording studio to his own framed jersey RomeluLukaku9 takes TaylorRooks on a tour of his house ,154,130,579,709,video
CompanyJ_2603,Well then ,10,455,3987,4442,photo
CompanyJ_2604,PSG fans really bringing it via leedavey99 ,43,287,1666,1953,video
CompanyJ_2605,LUKAKU TWO MINUTES IN ,22,340,2466,2806,video
CompanyJ_2606,To be fair the Wolves made it last year ,40,876,7886,8762,photo
CompanyJ_2607,Lukaku s last 3 games Two goals Two goals Two goals On fire ,60,581,3292,3873,photo
CompanyJ_2608,Pepe s F k you Dzeko s flop ,28,1285,7815,9100,video
CompanyJ_2609,COMEBACK COMPLETE via brfootball ,33,1548,5592,7140,photo
CompanyJ_2610,Sealed the deal MarcusRashford via brfootball ,46,1059,4192,5251,video
CompanyJ_2611,Against Barcelona in 2017 Against Manchester United in 2019 PSG choked ,71,1044,4234,5278,photo
CompanyJ_2612,Neymar couldn t believe it via brfootball ,42,1191,8293,9484,video
CompanyJ_2613,Rashford was the Golden Boy today via brfootball ,49,544,4374,4918,photo
CompanyJ_2614,BEAL CAUGHT A BODY ,19,1221,5931,7152,video
CompanyJ_2615,D Lo brought out the shammgod ,30,9985,51214,61199,video
CompanyJ_2616, TALK TO EM ecambage ,21,635,3121,3756,photo
CompanyJ_2617,Wade and Kemba Respect ,23,899,7336,8235,video
CompanyJ_2618,The Nets are having so much fun ,32,1250,9356,10606,video
CompanyJ_2619,HUSTLE via NBA ,15,1701,7851,9552,video
CompanyJ_2620,ZACH LAVINE CLUTCH via NBA ,27,3563,20131,23694,video
CompanyJ_2621,They really made the Sixers come back out for 5 of a second ,60,1061,7781,8842,video
CompanyJ_2622,Fox making plays in less than 3 seconds ,40,400,3944,4344,video
CompanyJ_2623,,0,624,4076,4700,photo
CompanyJ_2624,LeBron pushes past MJ on the all time scoring list ,51,6927,22362,29289,photo
CompanyJ_2625,MJ looking at the score ,24,1653,6893,8546,photo
CompanyJ_2626,DBook gets buckets however he wants erupts for 41 ,50,979,6016,6995,video
CompanyJ_2627, HISTORY MADE ,14,6841,34837,41678,photo
CompanyJ_2628,The King taking in the moment Via NBA ,38,1696,10788,12484,video
CompanyJ_2629,Kids from the school LeBron built congratulate him on passing MJ Powerful via IPROMISESchool ,93,1955,9887,11842,video
CompanyJ_2630,Hayward puts away the Kings ,28,828,5122,5950,video
CompanyJ_2631,17 games remaining 6 games out from 8th seed ,45,744,4360,5104,photo
CompanyJ_2632,Rondo wyd ,10,1412,7832,9244,video
CompanyJ_2633,Like Mike ,10,762,5779,6541,photo
CompanyJ_2634,64 603 points between them Two of the GOATs ,44,1052,10150,11202,photo
CompanyJ_2635,A Manchester United fan accidentally broke his TV celebrating The instant regret in his voice NSFW via mr_miami9 davido_picasso IG ,131,2637,10965,13602,video
CompanyJ_2636,Clutch LaVine from courtside via tonygill670 ,45,220,2680,2900,video
CompanyJ_2637,Respect KMbappe MarcusRashford ,31,251,2596,2847,photo
CompanyJ_2638,Leo Messi will return to the Argentina squad for the first time since they were eliminated from the World Cup via brfootball ,125,683,6430,7113,photo
CompanyJ_2639,March 7 2010 ,13,2525,11442,13967,photo
CompanyJ_2640,The mountaindew x ruffles Ballers Ball had fans going crazy all day long at BRxNC AllStarWeekend2019 ,101,19,91,110,video
CompanyJ_2641,Pizza put him to sleep via 15SOF ,33,1383,8291,9674,video
CompanyJ_2642,Manchester United pulled off an incredible comeback and Pogba and Lingard went wild ,84,204,1550,1754,video
CompanyJ_2643,Three point specialists on what it takes to survive in the corner Don t get distracted by the bench and don t step out of bounds ,129,99,939,1038,photo
CompanyJ_2644,Bron on passing his idol MJ Couldn t have in a trillion years thought that would be possible especially knowing where I come from ,130,702,5710,6412,photo
CompanyJ_2645,March 7 2012 Messi becomes the first player to score five goals in a Champions League match FIVE via brfootball ,112,635,3815,4450,video
CompanyJ_2646,A legendary night for No 23 ,28,680,4306,4986,video
CompanyJ_2647,Nutmegged the defender AND the keeper for the goal ,51,477,3677,4154,video
CompanyJ_2648,Championship game winners are once in a lifetime via obaihamidi shakpryce IG ,77,4284,29295,33579,video
CompanyJ_2649,The Lakers will put LeBron on a minute restriction for the rest of the season and likely won t let him play in back to backs per ChrisBHaynes ,142,1610,8769,10379,photo
CompanyJ_2650,The renovations to this rec gym left these kids speechless In Partnership with newyorklife X B R ,97,92,701,793,video
CompanyJ_2651,The Lakers season ended in July according to HowardBeck ,56,743,3531,4274,video
CompanyJ_2652,N C State commit Jalen Lecque with an in game Eastbay ,54,912,5671,6583,video
CompanyJ_2653,These kids were left speechless by the renovations to their rec court thanks to New York Life partner of the ACC In Partnership with NewYorkLife X B R ,151,62,406,468,video
CompanyJ_2654,Rondo clears the air ,21,6155,31600,37755,photo
CompanyJ_2655,D Rose told this fan Stay after I gotchu via chrissitto3 Instagram ,67,4169,38801,42970,video
CompanyJ_2656,Giannis getting more and more confident with his jumper ,56,531,5006,5537,video
CompanyJ_2657,Bucks Sterling Brown named all 50 states in 30 seconds ,55,1590,12939,14529,video
CompanyJ_2658,Tacko Fall sees his mother for the first time after seven years She traveled from Senegal to UCF to watch him play for the first time via UCF_MBB ,146,4918,34608,39526,video
CompanyJ_2659,One more year please mrvincecarter15 ,37,548,4189,4737,photo
CompanyJ_2660,Brook Lopez doesn t get enough credit for redefining his game ,62,2168,16004,18172,video
CompanyJ_2661,Giannis took out his frustration for getting T ed up with this dunk ,68,310,2917,3227,video
CompanyJ_2662,Tony Snell had Bogdanovic playing Twister ,42,642,3440,4082,video
CompanyJ_2663,Giannis EATING on both ends ,28,1000,6002,7002,video
CompanyJ_2664,David Irving explains why he s done with football while smoking a blunt NSFW ,77,3012,9457,12469,video
CompanyJ_2665,Russ rocked the baby on Dame early ,35,607,4389,4996,video
CompanyJ_2666,Russ told Blazers fans to zip it up ,36,611,4593,5204,video
CompanyJ_2667,Steelers are nearing a deal to send Antonio Brown to the Bills per Rapsheet ,76,3269,11239,14508,photo
CompanyJ_2668,AB hearing about getting traded to the Bills ,45,1566,6521,8087,photo
CompanyJ_2669,Russ really just knocked down Nurkic ,37,1871,12934,14805,video
CompanyJ_2670, AB84 isn t having it ,22,2338,9093,11431,photo
CompanyJ_2671,Chuck has Portland going to the Finals this year via NBAonTNT ,62,1177,6491,7668,video
CompanyJ_2672,Larry Fitzgerald tried to put AB on game ,41,783,4484,5267,photo
CompanyJ_2673,Russ continues to taunt Blazers fans ,37,706,4261,4967,video
CompanyJ_2674,Dame pulled up on Russ from DEEP ,33,853,5926,6779,video
CompanyJ_2675,Playoff intensity at the Rose Garden Nurkic ejected with 2nd technical after headbutt PG also charged with technical ,117,417,3047,3464,video
CompanyJ_2676,RUSS REALLY DRIBBLED OUT OF BOUNDS ,35,226,2270,2496,status
CompanyJ_2677,AB pleading his case to not get traded to Buffalo ,50,1338,5008,6346,video
CompanyJ_2678,Russ carried the Thunder to a BIG TIME win in Portland ,55,1038,5725,6763,photo
CompanyJ_2679,Dame and Russ went at it ,25,812,4871,5683,photo
CompanyJ_2680,Bills GM says team won t complete trade for Antonio Brown We have moved on and our focus is on free agency per AdamSchefter ,124,1364,5495,6859,photo
CompanyJ_2681,LaMelo Ball dropped 42 points in SPIRE s first playoff game ,60,1843,13244,15087,video
CompanyJ_2682,Strong Confident Bold Phenomenal InternationalWomensDay ,56,2188,7406,9594,video
CompanyJ_2683,Today all 28 members of the USWNT have filed a lawsuit for gender discrimination against the United States Soccer Federation ,125,2820,9196,12016,photo
CompanyJ_2684,Chuck wanted no part of a wrestling match with Shaq via NBAonTNT ,65,6902,36716,43618,video
CompanyJ_2685,Is he Paul George Is he Rudy Gay Cam Reddish is the biggest enigma in this year s NBA draft ,92,352,2725,3077,photo
CompanyJ_2686,Zach LaVine has scored more points than anyone in the NBA outside of Russell Westbrook since the All Star break ,112,2958,18295,21253,photo
CompanyJ_2687,Marvin Williams knows how important it is to give back to your community In Partnership with newyorklife X B R ,111,42,314,356,video
CompanyJ_2688,Patrick Beverley and the Clippers aren t backing down on this playoff push ,75,300,2477,2777,video
CompanyJ_2689,The Mamba gives his take on Ben Simmons ,40,979,6829,7808,photo
CompanyJ_2690,Jayson Tatum I m not 20 no more via celtics ,44,4295,26935,31230,video
CompanyJ_2691,Kyrie said he has to school these youngins when he plays Tatum and Brown 1 on 1 via chrisgrenham ,97,762,5251,6013,video
CompanyJ_2692,Bron s doppelgänger is already in the offseason via michellethi24 ,66,2767,13543,16310,video
CompanyJ_2693, NASCAR FIGHT via NASCAR ,25,874,3976,4850,video
CompanyJ_2694,Robin Lopez gave the work to Drummond ,38,3914,23608,27522,video
CompanyJ_2695,Gobert finishing on his own ,28,188,2184,2372,video
CompanyJ_2696,Does Dirk have a point ,23,11471,61437,72908,photo
CompanyJ_2697,Oh no Thon ,11,410,3602,4012,video
CompanyJ_2698,Andre Drummond believed in this step back jumper ,49,4711,26963,31674,video
CompanyJ_2699,Joakim was HYPED after hitting a mid range jumper ,50,509,6000,6509,video
CompanyJ_2700,LaVine is smooth with the acrobatic moves ,42,210,2366,2576,video
CompanyJ_2701,Steph really is a dunker now via NBCSWarriors ,46,1097,7874,8971,video
CompanyJ_2702,Blake been shaking bigs all season ,35,1456,11245,12701,video
CompanyJ_2703,Standing ovation for Joakim Noah as he checks out ,50,492,4212,4704,video
CompanyJ_2704,Ready for Playoff Harden During this 7 game win streak Rockets have beaten the Celtics Raptors and Sixers by double digits ,123,565,3912,4477,photo
CompanyJ_2705,The effort made Kawhi smile ,28,580,5851,6431,video
CompanyJ_2706,What a sequence for Boogie via warriors ,40,512,3958,4470,video
CompanyJ_2707,Ja Morant making the 360 look easy via Mike_Schmitz ,52,433,3903,4336,video
CompanyJ_2708,Steph from way way back via NBA ,32,1613,11968,13581,video
CompanyJ_2709,Nader poster OH MY ,19,1091,6889,7980,video
CompanyJ_2710,39 points in his return Nobody could stop Klay tonight ,55,516,4402,4918,photo
CompanyJ_2711,Klay went 9 for 11 from 3PT land vs the Nuggets ,48,840,5563,6403,video
CompanyJ_2712,Julio Jones could play defense too via thecheckdown ,52,7211,38935,46146,video
CompanyJ_2713,Imagine trusting your friends to take this shot via NoahSchone ,63,1081,7125,8206,video
CompanyJ_2714, 3x U S Soccer Athlete of the Year First American to score a premier league hat trick Tied for most international goals in USMNT history Happy Birthday to a real one Clint Dempsey ,180,527,4540,5067,photo
CompanyJ_2715,He still made the play via Sugar_ShaneM ,40,643,4313,4956,video
CompanyJ_2716, THIS IS MY HOUSE 10 years ago today D Wade reminded everyone who runs Miami ,77,4783,22718,27501,video
CompanyJ_2717, BLAKE IS WAY MORE THAN JUST A DUNKER ,38,8885,45110,53995,video
CompanyJ_2718, He s throwing people under the bus I ve never seen him like this That s going to taint him now when he finishes Anonymous West execs rip LeBron s leadership ,158,596,2796,3392,photo
CompanyJ_2719,Kyrie says he feels for LeBron calls criticism a little unfair because of how much time he missed per joevardon ,112,1376,7573,8949,photo
CompanyJ_2720,Brandon Ingram in expected to miss the remainder of the season with Deep Venous Thrombosis DVT in his right arm ,112,938,5083,6021,photo
CompanyJ_2721,Gwynedd Mercy s coach gave the pregame speech of the year MeekMill via PrayersNhoops ,85,3498,11388,14886,video
CompanyJ_2722,KD and Boogie were playing hot potato ,38,1469,11733,13202,video
CompanyJ_2723,Does Kyrie have a point ,24,654,4451,5105,photo
CompanyJ_2724,Down 16 30 seconds left Watch the comeback NSFW via Arhamur_ ,61,9141,39482,48623,video
CompanyJ_2725,Bronny James AAU team not playing around in 2019 ,49,3009,19864,22873,video
CompanyJ_2726,Lonzo Ball is out for the rest of the season after having his ankle re evaluated per ShamsCharania ,99,1183,6505,7688,photo
CompanyJ_2727,Father son alley just like they drew it up via patkelsey ,57,10461,38850,49311,video
CompanyJ_2728,UNC beats Duke 79 70 ,21,1722,6607,8329,video
CompanyJ_2729,Pat Beverley is always ready ,29,274,2001,2275,photo
CompanyJ_2730,D Lo knocked down both free throws as Hawks fans chanted You re a snitch ,73,1219,7782,9001,video
CompanyJ_2731,KAT GOT UP ,11,537,3436,3973,video
CompanyJ_2732,Coach K expects Zion Williamson to return for the ACC tournament ,65,795,5497,6292,photo
CompanyJ_2733,Alex Rodriguez announces his engagement to Jennifer Lopez via AROD ,67,1092,6675,7767,photo
CompanyJ_2734,Ice Trae stays launching from the logo ,39,1890,13989,15879,video
CompanyJ_2735,This Ja Morant dunk sounded like a cannon went off via CBSSports ,65,6223,27877,34100,video
CompanyJ_2736,The strength of Jarrett Allen s afro ,37,246,2263,2509,video
CompanyJ_2737,That up and under will never get old from Rose ,47,2095,11437,13532,video
CompanyJ_2738,It s just too easy for Uncle Drew via celtics ,46,2612,10935,13547,video
CompanyJ_2739,Bradley Beal 1 8 seconds Ice cold ,34,1552,8948,10500,video
CompanyJ_2740,D ROSE DAGGER ,14,3632,19205,22837,video
CompanyJ_2741,Kyrie and Bron still do their Cavs handshake ,45,5684,38928,44612,video
CompanyJ_2742,Cody Zeller saw an opportunity and he took it ,46,3881,23601,27482,video
CompanyJ_2743, ,1,1687,12151,13838,photo
CompanyJ_2744, He s always been a championship contender I can only imagine Kyrie knows it s hurting Bron to potentially miss the playoffs via LoJoMedia ,139,795,5213,6008,video
CompanyJ_2745,BREAKING Antonio Brown is heading to the Raiders per ProFootballTalk ,69,10551,33190,43741,photo
CompanyJ_2746,Steelers are trading AB for a 3rd round pick and a 5th round pick in 2019 per RapSheet ,87,2674,9404,12078,link
CompanyJ_2747,The Raiders are re working Antonio Brown s contract to make him the highest paid WR in the league He went from 0 guaranteed in the next three years to 30 125M per ProFootballTalk BOOMIN ,186,1471,6190,7661,photo
CompanyJ_2748,With AB84 to the Raiders his wild trade saga is finally over ,61,552,3693,4245,video
CompanyJ_2749,A fan ran onto the field to punch an opposing player in the head via SkyNews ,77,1871,6261,8132,link
CompanyJ_2750,EDEN HAZARD AT THE DEATH via NBCSportsSoccer ,45,919,6034,6953,video
CompanyJ_2751,Jeff Van Gundy says the Lakers should consider trading LeBron over the summer ,78,2186,11995,14181,video
CompanyJ_2752,Tyson was not tryna get tagged at home via nicawawa Instagram ,62,628,5189,5817,video
CompanyJ_2753,Arsenal 2 0 Manchester United Arsenal spoils the party via brfootball ,70,948,4515,5463,photo
CompanyJ_2754,James Harden could go scoreless the rest of the season and still average 28 6 PPG which would lead the league H T NBA_Reddit ,125,5757,25088,30845,photo
CompanyJ_2755,Crafty DwyaneWade ,18,1227,7921,9148,video
CompanyJ_2756,Marcus Morris has Kyrie s back ,31,368,3277,3645,photo
CompanyJ_2757,Former No 1 pick Greg Oden went back to Ohio State to get his degree Today they honored him at senior day via chasshill ,120,2122,16163,18285,video
CompanyJ_2758, Basically I come from other planet Like Superman from Krypton 7 3 Boban 7 6 Tacko Fall and 7 2 Travon Pearson on the difficulties of being a giant in today s game and everyday life ,182,114,1085,1199,photo
CompanyJ_2759,JoJo getting crafty via NBA ,28,687,5861,6548,video
CompanyJ_2760,INSANITY ,9,34298,132906,167204,video
CompanyJ_2761,AB is so happy to be a Raider via AB84 ,39,4808,27013,31821,video
CompanyJ_2762,Coldest photo of the season ,28,8493,59558,68051,photo
CompanyJ_2763,Harden got away with one ,25,502,4706,5208,video
CompanyJ_2764,Sheesh jcollins20_ ,19,740,5589,6329,video
CompanyJ_2765,Snow really stopped them from scoring foxsoccer ,48,4349,22594,26943,video
CompanyJ_2766,Luka doing it all ,18,518,4280,4798,video
CompanyJ_2767,Klay s been on one lately ,26,1253,9035,10288,video
CompanyJ_2768,CLUTCH CP3 ,11,1005,5315,6320,video
CompanyJ_2769,Spurs have a serious bat problem ,33,1651,10048,11699,video
CompanyJ_2770,Every little kid wants to be like their sports hero ,52,1063,13069,14132,video
CompanyJ_2771,Booker scored 13 straight points in the 4th and finished with 37 8 11 in a win against the Warriors ,100,5103,28426,33529,video
CompanyJ_2772,Derrick Jones Jr climbed the ladder for this one StateFarm ,59,2087,11977,14064,video
CompanyJ_2773,Only 4 wins in the Warriors last 10 Lost to the last place Suns Lost by 33 to the Celtics Lost to the Magic Lost by 22 to the Trailblazers ,139,949,7756,8705,photo
CompanyJ_2774,Block was TOUGH via yohelyortiz ,32,542,3622,4164,video
CompanyJ_2775,Zinedine Zidane is set to return to Real Madrid tomorrow on a deal until the end of the season per multiple reports via brfootball ,131,822,2856,3678,photo
CompanyJ_2776,Let the bodies hit the floor via arat gym IG ,45,698,3760,4458,video
CompanyJ_2777,Update Eagles deal with Malik Jackson is expected to be three year deal worth 30M per RapSheet ,95,229,1313,1542,link
CompanyJ_2778,Will Simmons and Embiid bring a title to Philly ,48,1241,8477,9718,photo
CompanyJ_2779,Forrest Whitley was a 265 lb high schooler who frequented Whataburger Then he lost 70 pounds to become MLB s No 1 pitching prospect ,132,167,1189,1356,photo
CompanyJ_2780,Trent Brown intends to sign a four year 66M contract 36 75M guaranteed with the Raiders making him the highest paid OL in NFL history per AdamSchefter ,151,913,4800,5713,photo
CompanyJ_2781,Lakers coaching staff wanted to re sign Brook Lopez and Julius Randle before Magic signed JaVale Beasley and Lance per billoram ,128,1605,7585,9190,photo
CompanyJ_2782,DeSean s Jackson looking forward to his next destination Bucs can clear 10M in cap space by releasing him ,106,228,2005,2233,photo
CompanyJ_2783,Breaking Zinedine Zidane replaces Solari as Real Madrid manager via brfootball ,79,807,2952,3759,photo
CompanyJ_2784,Andre Ingram will join the Lakers on their upcoming five game road trip per LoJoMedia ,86,2964,15062,18026,photo
CompanyJ_2785,Last time Andre Ingram was on the court ,40,2535,11980,14515,video
CompanyJ_2786,24 6 PPG 10 0 APG Electrifying dunks Ja Morant is about to take over March Madness ,83,1789,9565,11354,video
CompanyJ_2787,Real Madrid since Zidane left in May Lose Ronaldo to Juventus Lose Super Cup to Atleti Fired their replacement manager after 138 days Knocked out of Copa del Rey Lose 5 1 1 0 and 3 0 to Barcelona Knocked out of Champions League in Round of 16 But now he s back ,261,794,3186,3980,photo
CompanyJ_2788,Former Giants safety Landon Collins is signing a six year 84M deal with the Redskins per RapSheet ,98,2974,11658,14632,photo
CompanyJ_2789,DAD GAME STRONG via Yo_bino ,28,5503,24934,30437,video
CompanyJ_2790,Kyrie is holding himself accountable ,37,659,4641,5300,photo
CompanyJ_2791,Steve Kerr joked that he said I beg to differ with Draymond s approach in response to the recent lip reading video via anthonyVslater ,134,345,2607,2952,video
CompanyJ_2792,Frank Gore has agreed to a one year 2M deal with the Bills per AdamSchefter ,76,484,3436,3920,photo
CompanyJ_2793,Breaking Nick Foles is signing with the Jaguars per RapSheet ,61,3459,19626,23085,photo
CompanyJ_2794,Breaking Bucs are trading DeSean Jackson to the Eagles per caplannfl ,69,2924,8713,11637,photo
CompanyJ_2795,Never forget when DeSean Jackson walked off against the Giants via NFL ,71,7541,30942,38483,photo
CompanyJ_2796,The moment Andre Ingram found out he was heading back to the NBA via SouthBayLakers ,84,5189,30136,35325,video
CompanyJ_2797,Terrell Suggs expected to sign with the Cardinals per RapSheet ,63,789,4254,5043,photo
CompanyJ_2798, One time for the one time DeSeanJackson11 is happy to be back in Philly ,73,1692,6665,8357,video
CompanyJ_2799,Breaking Tyrann Mathieu and the Chiefs are expected to ink a deal per RapSheet ,79,1951,10397,12348,photo
CompanyJ_2800,Conor McGregor arrested for smashing fan s phone outside of Miami Beach hotel per MiamiHerald ,94,927,4641,5568,photo
CompanyJ_2801,Kings team chemistry is on another level this season ,53,3227,31278,34505,video
CompanyJ_2802,The Nets bench celebration is A1 ,33,2333,11429,13762,video
CompanyJ_2803,Ibaka and Chriss out here throwing punches ,43,16773,50272,67045,video
CompanyJ_2804,Ingles put him on skates Couldn t get the bucket though ,56,1351,10502,11853,video
CompanyJ_2805, JoelEmbiid named his new puppy after Sam Hinkie TheProcess ,60,252,2328,2580,photo
CompanyJ_2806,CP3 playing catch with Shumpert s daughter Junie during the game ,65,861,7597,8458,video
CompanyJ_2807, ANKLES ,8,5638,22777,28415,video
CompanyJ_2808,Russ feelin it ,15,1772,10531,12303,video
CompanyJ_2809,GOAT 6th Man ,13,4050,26434,30484,photo
CompanyJ_2810,Russ explains what happened during the game vs Utah ,52,3486,16181,19667,photo
CompanyJ_2811,22 years ago today rookie Allen Iverson hit Michael Jordan with one of the most iconic crossovers ever ,103,18961,70128,89089,video
CompanyJ_2812,David Beckham s face when they unveiled this statue of him via LAGalaxy ,72,8854,45448,54302,video
CompanyJ_2813,Dwyane clowns Zaire for inventing his celebration via dwyanewade ,65,1805,13794,15599,photo
CompanyJ_2814,Bring on the second legs Watch on brlive ,41,79,766,845,photo
CompanyJ_2815,After LeBron won his first ring in Cleveland David Griffin told his team to get KD per ZachLowe_NBA ,100,309,1953,2262,photo
CompanyJ_2816,Inspiration for the next generation In Partnership with NewYorkLife X B R ,74,35,281,316,video
CompanyJ_2817,Couldn t stop em via USLChampionship ,37,1521,9417,10938,video
CompanyJ_2818,Salah puts the fans first via brfootball ,41,112,1159,1271,photo
CompanyJ_2819,These jersey destructions are getting out of hand via tnick1236 IG ,67,948,6006,6954,video
CompanyJ_2820,These kids inventing new crossover moves via andrizzle432 ,58,5399,24228,29627,video
CompanyJ_2821,These bar exercises are EXTRA via AlriginalBear ,48,192,1236,1428,video
CompanyJ_2822, ,1,739,5421,6160,photo
CompanyJ_2823,How Kyler Murray became a two sport sensation The best high school player I ve coached against He cost me three state championships ,132,97,738,835,photo
CompanyJ_2824,CURRY DOESN T MISS via AshleyNevel ,35,1675,9155,10830,video
CompanyJ_2825,Former Patriots DE Trey Flowers agrees to a five year 90M 56M guaranteed deal with the Lions TomPelissero ,106,313,1950,2263,photo
CompanyJ_2826,Oladipo just started walking again and he s already taking shots standing via NBATV ,84,7414,41242,48656,video
CompanyJ_2827,Raymond Felton has Russ back ,29,731,5150,5881,photo
CompanyJ_2828, spidadmitchell plans to work with the Jazz to make their communities more inclusive As a black man living in a community I love this incident hits close to home ,162,599,4551,5150,photo
CompanyJ_2829,These kids recreated the iconic Bron Wade photo and it s pretty on point via _lim06_ tree_kpf Instagram ,104,660,5754,6414,photo
CompanyJ_2830,Juventus opening goal was disallowed because of interference from Ronaldo They weren t happy via brfootball ,108,118,916,1034,video
CompanyJ_2831,Serge Ibaka has been suspended for 3 games and Marquese Chriss for 1 game per ShamsCharania ,92,368,1876,2244,link
CompanyJ_2832,RONALDO ,8,937,4250,5187,video
CompanyJ_2833,Jazz announce they ve banned the fan who engaged in the inappropriate interaction with Russ ,92,3676,21459,25135,photo
CompanyJ_2834,Elena Delle Donne stopped by St John s College High to surprise Azzi Fudd the first sophomore to ever win the Gatorade National Girls Basketball POY award Gatorade ,164,128,530,658,video
CompanyJ_2835,Ronaldo loves scoring in the Champions League and Ronaldo loves scoring against Atletico via brfootball ,104,741,2836,3577,photo
CompanyJ_2836,NBA fines Westbrook 25K for directing profanity and threatening language to a fan ,82,800,4314,5114,link
CompanyJ_2837,Ronaldo JUST over the line to bring it 2 2 on aggregate via brfootball ,71,608,3149,3757,video
CompanyJ_2838,HAT TRICK RONALDO ,18,4071,10846,14917,video
CompanyJ_2839,Big Game Player ,16,3415,12461,15876,photo
CompanyJ_2840,A legendary comeback from Juventus via brfootball ,50,1036,4536,5572,photo
CompanyJ_2841,Hat trick complete Comeback complete via brfootball ,52,1347,5736,7083,video
CompanyJ_2842,Ronaldo trolls Atletico with the celebration Diego Simeone did against Juventus in the first leg ,97,2435,9179,11614,video
CompanyJ_2843,Luka vs DeRozan tonight MyStraightTalk ,39,2135,27726,29861,video
CompanyJ_2844,UCL King via brfootball ,24,501,2661,3162,photo
CompanyJ_2845,Lou Will Professional Bucket Getter Will he go back to back as 6th Man of the Year ,83,334,2362,2696,video
CompanyJ_2846,What a comeback cristiano ,26,1317,5875,7192,video
CompanyJ_2847,Former Pats WR Cordarrelle Patterson intends to sign a 5M per year deal with the Bears per AdamSchefter ,104,542,2914,3456,photo
CompanyJ_2848,Manchester City scored SEVEN tonight ,37,245,1710,1955,video
CompanyJ_2849, SELL THE TEAM Pacers fans have some advice for the Knicks ,59,361,2375,2736,video
CompanyJ_2850,BREAKING OBJ has been traded to the Browns per MikeGarafolo ,60,36964,98472,135436,photo
CompanyJ_2851,,0,12841,53528,66369,photo
CompanyJ_2852,From LSU to Cleveland Jarvis Landry and Odell Beckham Jr are teammates again ,77,16238,58852,75090,photo
CompanyJ_2853,Giants get the Browns first round pick No 17 overall and the Browns second 3 round pick in 2019 plus Jabrill Peppers per AdamSchefter ,134,3154,11857,15011,link
CompanyJ_2854,Browns 2019 depth chart is wild QB Baker Mayfield RB Nick Chubb WR Odell Beckham Jr WR Jarvis Landry WR Antonio Callaway TE David Njoku ,136,8731,32537,41268,photo
CompanyJ_2855, New King of Cleveland ,23,1781,7885,9666,photo
CompanyJ_2856, ,1,4827,16362,21189,photo
CompanyJ_2857,OBJ s new teammates approve ,28,986,6502,7488,photo
CompanyJ_2858, A first third and Jabrill ,27,2528,11335,13863,photo
CompanyJ_2859,Jan 31 Kristaps to the Mavs March 12 OBJ to the Browns Tough couple of weeks for New York ,90,1793,8162,9955,photo
CompanyJ_2860,OBJ saying goodbye to Saquon via theshiggster ,46,9797,31995,41792,video
CompanyJ_2861,Oh my Embiid ,13,1392,6754,8146,video
CompanyJ_2862, ,1,2771,11047,13818,video
CompanyJ_2863,OKAY BRON ,10,7941,37115,45056,video
CompanyJ_2864,Andre Ingram gets a standing ovation from the Bulls crowd ,58,1580,12527,14107,video
CompanyJ_2865,YEAR 16 ,8,4702,27402,32104,photo
CompanyJ_2866,Lakers having fun again ,24,3479,17337,20816,video
CompanyJ_2867, UPSET ALERT Saint Mary s takes down No 1 Gonzaga 60 47 in the WCC championship The Gaels are going dancing ,108,1876,9922,11798,photo
CompanyJ_2868,KAT BACK TO BACK ,17,906,5103,6009,video
CompanyJ_2869,KAT step back ,14,2982,16979,19961,video
CompanyJ_2870,Le Veon Bell will sign with the New York Jets per AdamSchefter ,63,4174,13077,17251,photo
CompanyJ_2871,Bell will sign a 4 year 52 5M contract per AdamSchefter ,56,2659,12094,14753,link
CompanyJ_2872,Get used to this on Sundays ,28,3163,26346,29509,photo
CompanyJ_2873,After sitting out last year LeVeonBell is finally on the move ,62,311,2756,3067,video
CompanyJ_2874,2 0 down to Wolfsburg in 2016 2 0 down to Atleti in 2019 Champions League hat trick hero Cristiano via brfootball ,114,640,4181,4821,photo
CompanyJ_2875,OBJ and Baker at their first Browns practice ,45,12990,67588,80578,video
CompanyJ_2876,After being diagnosed with a rare form of ocular cancer this fan got an FCBayernUS prosthetic eye to show his love for the club and raise awareness of the disease ,163,384,2182,2566,video
CompanyJ_2877,The control this kid has via ramelldo07 ,40,4454,22179,26633,video
CompanyJ_2878,Earl Thomas will sign a 4 year 55M deal with the Baltimore Ravens including 22M in the first 9 months per AdamSchefter ,119,3689,18491,22180,photo
CompanyJ_2879,Mark Ingram will sign a 3 year 15M deal with the Baltimore Ravens per AdamSchefter ,83,1882,8812,10694,photo
CompanyJ_2880,The incredible story of the war veteran and Holocaust survivor who made FCBayernUS the club it is today via brfootball ,119,191,1134,1325,video
CompanyJ_2881,The Warriors are headed to Houston and Steph Curry is headed to NASA ,69,285,2803,3088,video
CompanyJ_2882,Penny Hardaway returned home to coach after a dying childhood friend reached out for help He scribbled on the paper 1 Cent ,123,3541,13797,17338,video
CompanyJ_2883,ICE COLD from Messi ,20,2517,13031,15548,video
CompanyJ_2884,Sadio Mane made Neuer look silly via brfootball ,48,905,4081,4986,video
CompanyJ_2885,Tyrell Williams is signing a 4 year 44M deal with the Oakland Raiders per AdamSchefter ,87,508,3279,3787,photo
CompanyJ_2886, luissuarez9 ,13,1622,8674,10296,video
CompanyJ_2887,HUGE goal from VirgilvDijk to put Liverpool ahead ,50,171,1060,1231,video
CompanyJ_2888,Messi said sit down ,20,3024,12640,15664,video
CompanyJ_2889,A massive performance in Munich sends Liverpool to the UCL quarter finals via brfootball ,89,263,1211,1474,photo
CompanyJ_2890,Barcelona skip into the quarterfinals ,38,238,1523,1761,photo
CompanyJ_2891,The Champions League final 8 via brfootball ,44,764,2994,3758,photo
CompanyJ_2892,That was the Champions League last 16 via brfootball ,53,3217,7954,11171,video
CompanyJ_2893,OBJ has Cleveland buzzing ,26,466,3448,3914,video
CompanyJ_2894,Tuesday Hat trick from Ronaldo Wednesday Two goals and two assists from Messi Back to back performances via brfootball ,119,1187,6726,7913,photo
CompanyJ_2895,Ravens making moves ,20,752,5259,6011,photo
CompanyJ_2896,The newest Raider is all smiles ,32,2046,14087,16133,photo
CompanyJ_2897, Raider Nation How crazy is that derekcarrqb and AB84 are ready to get started ,79,692,3857,4549,video
CompanyJ_2898, 3 6 0 ,7,380,3845,4225,video
CompanyJ_2899,Rock the baby Russ via okcthunder ,34,880,5823,6703,video
CompanyJ_2900,What a recovery via JKollerKLKN ,32,481,3739,4220,video
CompanyJ_2901,BRODIE FEELIN IT via okcthunder ,32,3421,17585,21006,video
CompanyJ_2902,What is Noah doing ,19,2986,16400,19386,video
CompanyJ_2903,Oh no Boogie via NBCSWarriors ,30,1751,10721,12472,video
CompanyJ_2904,From playing the Lakers as a rookie to playing for them as a 3x champ via KingJames ,84,3196,23839,27035,photo
CompanyJ_2905,Monster game for Boogie 27 PTS 8 REBS 7 ASTS ,45,644,4536,5180,video
CompanyJ_2906,In response to the incident with Russ a Jazz fan started a GoFundMe to raise 25k for the Human Rights Campaign ,111,297,3082,3379,photo
CompanyJ_2907,Steph was fed up with Harden ,29,5598,33571,39169,video
CompanyJ_2908,OBJ says thank you to NY ,25,2626,18196,20822,photo
CompanyJ_2909,How did that happen via SkyFootball ,36,264,1642,1906,video
CompanyJ_2910,Light work for Pat Bev ,23,385,3045,3430,photo
CompanyJ_2911,Bron vs Kawhi tonight MyStraightTalk ,37,3957,44837,48794,video
CompanyJ_2912,Steph Curry turns 31 today and he s already one of the greats 2x MVP 3x champion 50 40 90 club GOAT shooter 1st unanimous MVP Revolutionized the game ,150,7348,34625,41973,photo
CompanyJ_2913, ,1,407,3076,3483,photo
CompanyJ_2914,Respect via brfootball ,23,293,2886,3179,photo
CompanyJ_2915,Zion Williamson cleared to play tonight for the first time since February ,74,2329,17401,19730,photo
CompanyJ_2916,We asked NBA execs What is LeBron James trade value I wouldn t roll up the truck and give more than one protected first ,120,343,1884,2227,photo
CompanyJ_2917,Ray Allen hasn t seen a more dominant tournament performance than Kemba s 6 game run in 2011 From BR x uninterrupted x Audi ,124,515,2782,3297,video
CompanyJ_2918,Everybody got that one uncle at the family BBQ via HookShotCharlie ,67,1503,9935,11438,video
CompanyJ_2919,The Raptors and Drake are opening an OVO Athletic Centre ,57,1156,4937,6093,video
CompanyJ_2920, ,1,1211,6418,7629,photo
CompanyJ_2921,Nevada stars Cody and Caleb Martin regularly faced racism including threats of violence growing up in a small North Carolina town The twins mother You re thinking What s next Are they going to set your house on fire ,216,1156,3485,4641,video
CompanyJ_2922,This kid is stressed about what jersey he s going to wear now that OBJ is in Cleveland via realkingarthur___ IG ,112,962,5346,6308,video
CompanyJ_2923,ZION BACK ,10,6240,42325,48565,photo
CompanyJ_2924,Former Eagles WR Golden Tate is signing with the Giants per AdamSchefter ,73,964,5376,6340,photo
CompanyJ_2925,Aubameyang pulled out the Black Panther mask to celebrate ,58,484,2627,3111,video
CompanyJ_2926,Will Kawhi stay in Toronto A lot of that might depend on a Raptors title run says HowardBeck ,93,134,1118,1252,video
CompanyJ_2927,Schroder got the ball on a string ,34,543,5315,5858,video
CompanyJ_2928,Tatum got nice with it ,23,784,5577,6361,video
CompanyJ_2929,Bron with AUTHORITY ,20,2403,15025,17428,video
CompanyJ_2930,Swipa did Marcus Smart dirty with the cross ,44,1210,6290,7500,video
CompanyJ_2931,Wes Matthews putback FOR THE WIN ,33,934,6079,7013,video
CompanyJ_2932,Welcome back Zion via CBSSports ,32,3967,21259,25226,video
CompanyJ_2933,Kevin Harlan really broke down someone spilling a drink courtside ,66,803,5743,6546,video
CompanyJ_2934,Dirk s fakes will never get old ,32,1626,12375,14001,video
CompanyJ_2935,SPIDA MITCHELL S BOUNCE OH MY ,30,2793,19309,22102,video
CompanyJ_2936,Zion puts on a show in his return 29 PTS 14 REB 5 STL 1 BLK 13 13 FG ,69,7686,43180,50866,photo
CompanyJ_2937,JOKER CALLED GAME ,18,520,3765,4285,photo
CompanyJ_2938,JOKIC FOR THE WIN ,18,3901,21350,25251,video
CompanyJ_2939,The road to the Champions League final is set via brfootball ,61,576,1970,2546,photo
CompanyJ_2940,LeBron told Kawhi they would be in touch after Raptors Lakers via NBA ,70,2330,20981,23311,video
CompanyJ_2941,Browns RB Kareem Hunt is being suspended eight games for violating the NFL s personal conduct policy per AdamSchefter ,118,905,4973,5878,photo
CompanyJ_2942,Lil Durk needs a 10 day via lildurk ,36,4859,25067,29926,video
CompanyJ_2943,Tom Brady is doing film work ahead of a family ski trip It never stops via tombrady IG ,87,1269,9674,10943,video
CompanyJ_2944,Just in time for the playoffs GameOfZones ,42,357,1649,2006,video
CompanyJ_2945,De Aaron Fox had no use for this dumbass question via NBCSKings ,64,2756,15742,18498,video
CompanyJ_2946, This ain t no college killa Dirk is a legend via NBAonTNT ,59,7643,38752,46395,video
CompanyJ_2947,Ronaldo wins Champions League Player of the Week after scoring a hat trick for Juventus comeback via brfootball ,112,239,1881,2120,photo
CompanyJ_2948,Jokic with the winning plays Should he be in the top 5 conversation via cbajaj12 IG ,84,394,4288,4682,video
CompanyJ_2949,Paul George opens up about choosing OKC wanting to stay with Westbrook and his transformation into an MVP candidate ,116,404,2661,3065,photo
CompanyJ_2950,Dad had a few drinks and put on a SHOW with the basement hoop via logankelleher_ ,81,8714,51766,60480,video
CompanyJ_2951,PG wanted another chance to leave a legacy with Westbrook ,58,584,4621,5205,photo
CompanyJ_2952,Went full Derrick Jones Jr ,27,563,4206,4769,video
CompanyJ_2953,Paul George has been on one this year ,38,2809,11604,14413,video
CompanyJ_2954,Zion s high school dunks are still WILD ,40,319,2174,2493,video
CompanyJ_2955,KD says he doesn t like being referred to as the second best player in the world That streetball mentality in me still gets riled up about it via boardroom ,156,555,4458,5013,photo
CompanyJ_2956,Landon Donovan still nutmegging players at 37 via SanDiegoSockers ,66,313,2793,3106,video
CompanyJ_2957,Chiefs are aware of a battery investigation involving Tyreek Hill and a juvenile per st_vockrodt and bepryor ,109,472,1918,2390,photo
CompanyJ_2958,Baker Mayfield can rip baseballs too via Haudricourt ,53,448,3647,4095,video
CompanyJ_2959,Buffalo Bulls are getting hot in March again ahead of Selection Sunday ,71,428,2376,2804,video
CompanyJ_2960,DeSean Jackson got a warm welcome back from Philly fans ,56,757,5548,6305,video
CompanyJ_2961,Blake s handles have been a problem for defenders all season ,61,5438,30886,36324,video
CompanyJ_2962,Jimmy hugs Bjelica after aggressive foul ,41,277,3158,3435,video
CompanyJ_2963,Kemba s moves are unfair ,25,1668,10426,12094,video
CompanyJ_2964,Winslow GOT UP on D Wade s alley oop ,37,1620,8935,10555,video
CompanyJ_2965,KCP on Thon Maker Oh my ,24,606,3593,4199,video
CompanyJ_2966,Oubre tried it ,15,431,4113,4544,video
CompanyJ_2967,Booker made something out of nothing ,37,897,6753,7650,video
CompanyJ_2968,Never jump with Derrick Jones Jr ,33,6126,35055,41181,video
CompanyJ_2969,Dwyane Wade went to the locker room after appearing to land awkwardly on hip ,77,268,2361,2629,video
CompanyJ_2970,PJ Tucker wasn t buying Booker s flop ,38,226,2092,2318,video
CompanyJ_2971,Giannis looked like Magic Johnson on this dime ,47,594,4970,5564,video
CompanyJ_2972,ZION INCOMING via CBSSports ,28,2751,16395,19146,video
CompanyJ_2973,This Admiral Schofield poster had everybody out of their seat ,62,1891,8466,10357,video
CompanyJ_2974,No 5 Duke upsets No 3 UNC 74 73 and advances to ACC title game Zion Williamson 31 PTS 11 REB 13 19 FG ,102,4428,23877,28305,photo
CompanyJ_2975,Ben Simmons addressed recent New Zealand tragedy Simmons had pray for New Zealand written on game shoes today via NBCSPhilly ,125,575,4326,4901,video
CompanyJ_2976,Doc Rivers and Jim Boylen got ejected at the same time ,55,1466,8523,9989,video
CompanyJ_2977,French officials have refused to allow parents to name their child Griezmann Mbappe Authorities can decline names if it s contrary to the interest of the child per le_Parisien ,176,776,5050,5826,photo
CompanyJ_2978,Ben Simmons passing gt ,23,2958,19112,22070,video
CompanyJ_2979,On this day in 2007 Kobe began one of the most ridiculous scoring streaks of all time 65 PTS W 50 PTS W 60 PTS W 50 PTS W ,122,13113,56736,69849,photo
CompanyJ_2980,Amid a breakout season Buddy Hield speaks on the hate he got after being traded for Boogie ,91,145,1488,1633,photo
CompanyJ_2981,CJ McCollum was always a problem Seven years ago today the junior dropped 30 PTS for No 15 seeded Lehigh and upset No 2 seeded Duke via marchmadness ,149,5827,29952,35779,video
CompanyJ_2982,This Zion impression is too accurate via maxisnicee ,52,8132,41061,49193,video
CompanyJ_2983,Blake Griffin turns 30 today and his game keeps evolving PPG 1st 3PT 1st 3PT 2nd AST 2nd Taking ankles regularly Pistons 6th in the East ,137,1563,9900,11463,photo
CompanyJ_2984,Brandon Ingram expected to make a full recovery for next season after successful surgery to treat DVT in right arm ,115,1284,9187,10471,photo
CompanyJ_2985,A smooth 30 piece for Kyrie in the win today 12 24 FG 11 REB 9 AST ,67,1263,7969,9232,video
CompanyJ_2986,Buddy was always listening ,27,383,3113,3496,photo
CompanyJ_2987,Dame pulling up as Stone Cold again tonight to celebrate 3 16 via trailblazers ,79,11752,50227,61979,video
CompanyJ_2988,Everybody needs a teammate like this via RonnieLoveee ,54,11298,50054,61352,video
CompanyJ_2989,Is Raymond doing his best pregame Steph impression via NBA ,59,1043,10722,11765,video
CompanyJ_2990,Johnny Manziel is back QB has signed with the TheAAF and will go through the waiver system per AdamSchefter ,108,1989,8404,10393,photo
CompanyJ_2991,Steph brought out all the moves on Morris via NBA ,50,2067,15157,17224,video
CompanyJ_2992,Bradley Beal drilled a career high 9 3PTs and dropped 40 PTS on the Grizzlies ,78,817,5299,6116,video
CompanyJ_2993,Pelicans called a timeout when they had none left and it cost them the game in OT ,82,1279,6721,8000,video
CompanyJ_2994,The Utah bench couldn t believe Spida s handles on this sequence ,65,636,5676,6312,video
CompanyJ_2995,Duke takes down FSU to win the ACC Title ,41,4101,21155,25256,photo
CompanyJ_2996,Steph went off for 33 PTS vs the Thunder ,41,719,4762,5481,video
CompanyJ_2997,Jokic gets tossed immediately after arguing this call ,54,1275,10045,11320,video
CompanyJ_2998,Paul Millsap CLUTCH ,20,366,3338,3704,video
CompanyJ_2999,No better hype man on St Patrick s Day than TheNotoriousMMA NSFW ,65,1804,10864,12668,video
CompanyJ_3000,Russ was heated last night Klay and Looney just laughed ,56,2068,16433,18501,video
CompanyJ_3001,Dwyane Wade considered retiring during Big 3 era due to constant knee pain I didn t want to do it anymore I didn t want to be in pain anymore per DanWoikeSports ,161,837,6004,6841,photo
CompanyJ_3002,Myles Turner s grandma watching him play via Original_Turner ,61,1585,12965,14550,video
CompanyJ_3003,In 2003 the Nets drafted Kyle Korver 51st and traded him for 125K They used it for their summer league fee and a copy machine Today he turns 38 as one of the greatest shooters of all time ,188,10348,63042,73390,photo
CompanyJ_3004,Clyde Frazier criticizes LeBron for not being part of the team and says he doesn t really care ,95,4514,20830,25344,video
CompanyJ_3005,McGregor wished Boone Jenner good luck then instructed Zdeno Chara to put him through the net via TheNotoriousMMA H T PeteBlackburn ,132,615,4784,5399,video
CompanyJ_3006,Wonder if DeAndre wanted Dotson to shoot this sound on NSFW ,60,3138,19651,22789,video
CompanyJ_3007,Iso Zo caught em ,17,416,2941,3357,video
CompanyJ_3008, 18 years old I was 135 soaking wet Jason Terry knows Zion is just built different From Bleacher Report x uninterrupted x audi ,127,444,2771,3215,video
CompanyJ_3009,Bron always comes ready to play at MSG ,39,492,4172,4664,video
CompanyJ_3010,HEZONJA BLOCKS LEBRON TO WIN ,29,5197,24615,29812,video
CompanyJ_3011,Andre Ingram movie coming KennyAlbert on the Knicks broadcast There s talk a movie will be made about his life story ,117,399,2984,3383,photo
CompanyJ_3012,Wade still crafty ,18,1545,10460,12005,video
CompanyJ_3013,They re 13 via certified brose superjyles IG ,45,1987,12194,14181,video
CompanyJ_3014,The staredown after the block ,30,2022,12587,14609,video
CompanyJ_3015,Ben Simmons with back to back dunks in the 1st quarter BULLY via NBA ,69,1043,7251,8294,video
CompanyJ_3016,Mike Scott needed a quick sip via shaqtin ,42,1962,10905,12867,video
CompanyJ_3017,Messi makes free kicks look easy ,33,753,5825,6578,photo
CompanyJ_3018,Three years ago today Taurean Prince broke down the art of rebounding Classic via marchmadness ,95,20238,91251,111489,video
CompanyJ_3019,MESSI HAT TRICK ,16,1353,8650,10003,photo
CompanyJ_3020,Messi holds the Barcelona record for Goals Trophies Ballon d Ors And now wins The record breaking never stops via brfootball ,125,1516,7106,8622,photo
CompanyJ_3021,MSU takes down Michigan 65 60 for the Big 10 title McQuaid 27 PTS 4 REBS ,73,584,2730,3314,photo
CompanyJ_3022,East Region No 1 Duke No 16 NC Central N Dakota State No 8 VCU No 9 UCF No 5 Miss State No 12 Liberty No 4 V Tech No 13 St Louis No 6 Maryland No 11 Belmont Temple No 3 LSU No 14 Yale No 7 Louisville No 10 MN No 2 MSU No 15 Bradley ,232,2031,7229,9260,photo
CompanyJ_3023,Giannis dropped 52 in another MVP worthy performance MetroByTMobile ,68,1800,8877,10677,video
CompanyJ_3024,Ja Morant vs Markus Howard in the 1st round ,44,3565,18660,22225,photo
CompanyJ_3025,Your No 1 seeds Did they get it right exxonmobil ,49,1174,10938,12112,video
CompanyJ_3026,The field is set and brackets are open Sign up to play ,55,911,3096,4007,photo
CompanyJ_3027,When you cram for March Madness and still fail ,47,543,2983,3526,video
CompanyJ_3028,Giannis adding to his MVP case ,31,412,2763,3175,photo
CompanyJ_3029,Embiid really crossed Giannis ,30,2488,15260,17748,video
CompanyJ_3030,MCW got t ed up for clapping in Trae s face Trae responded by hitting a FT and winking at him ,94,451,3905,4356,video
CompanyJ_3031,History has proven that every March a new star is born ,55,1771,13090,14861,photo
CompanyJ_3032,What a photo ,13,8547,50696,59243,photo
CompanyJ_3033, C O L D ,9,8267,45777,54044,video
CompanyJ_3034,Pat Bev wasn t letting go ,26,214,2414,2628,video
CompanyJ_3035,LOU WILL FOR THE WIN ,21,7374,34330,41704,video
CompanyJ_3036,Lou Will winner from courtside via bmac_175 IG ,47,1105,10511,11616,video
CompanyJ_3037,Now and then MarchMadness ,26,3919,22693,26612,photo
CompanyJ_3038,Lionel Messi s last three games Hat trick Two goals two assists One goal one assist 39 goals 15 assists in 37 games total this season via brfootball ,149,1671,10054,11725,photo
CompanyJ_3039,24 years ago ,13,3293,18494,21787,photo
CompanyJ_3040,Bros obj x neymarjr ,20,447,5161,5608,photo
CompanyJ_3041,Six years ago today One of KingJames meanest dunks via NBATV ,61,9544,35910,45454,video
CompanyJ_3042,There s a science to building a bust proof bracket ,51,171,1316,1487,video
CompanyJ_3043,Young Flash was a problem The 2003 NCAA tournament started 16 years ago today when D Wade made his run to the Final Four via MarchMadness ,138,1730,8360,10090,video
CompanyJ_3044, Left baseball frustrated Mysteriously returned to Bulls practice Sparked a media frenzy Put out the I m back fax Returned rocking No 45 Still dominated after almost two years comeback ,185,3564,15898,19462,photo
CompanyJ_3045,Is Giannis the modern Shaq Freak this season age 24 27 5 PPG 12 7 REB 6 0 AST 58 FG Diesel in 1996 97 age 24 26 2 PPG 12 5 REB 3 1 AST 55 7 FG ,143,4129,29232,33361,photo
CompanyJ_3046,If this year s tournament is anything like last year s buckle up GreatClips ,76,412,2335,2747,video
CompanyJ_3047,Past meets the present MarchMadness ,36,6664,32616,39280,photo
CompanyJ_3048, I remember when you used to shoot from tougher angles than that Brad Stevens and IT reunited in Boston via JoeGiza ,116,830,6962,7792,video
CompanyJ_3049, TaylorLewan77 and Quenton Nelson recreated the Clout video and it s amazing ,77,3034,12743,15777,video
CompanyJ_3050,IT could play in Boston tonight for the first time since getting traded His Celtics run was unforgettable 28 9 PPG in 2016 17 Led the NBA in 4Q points that year T shortest All Star ever Played a day after losing his sister Dropped 53 in the playoffs weeks later ,262,2029,11997,14026,photo
CompanyJ_3051,IT gets choked up talking about his time in Boston Anywhere I go in this city people show real love and I just embrace it via NBATV ,132,2000,14851,16851,video
CompanyJ_3052,Blake Bortles is finalizing a deal to join the Rams as a backup per JeffDarlington ,83,367,2420,2787,photo
CompanyJ_3053,What a moment Celtics pay tribute to IT ,40,10035,43439,53474,video
CompanyJ_3054,Ingles had Beal stumbling ,26,847,5538,6385,video
CompanyJ_3055,Sheesh Steph via NBCSWarriors ,30,5719,22286,28005,video
CompanyJ_3056,History for Dirk ,17,2078,11596,13674,photo
CompanyJ_3057,DJJ s bounce is insane ,23,1163,6632,7795,video
CompanyJ_3058,Kyrie cookin ,13,1114,7848,8962,video
CompanyJ_3059,Steph was heated via NBCSWarriors ,34,426,3374,3800,video
CompanyJ_3060,That was cold DeMar ,20,2379,15519,17898,video
CompanyJ_3061,It s Wade s OneLastDance but the man s still getting buckets 25 PTS 4 REBS 5 ASTS W over the Thunder ,101,1343,6122,7465,video
CompanyJ_3062, ,1,543,5772,6315,photo
CompanyJ_3063,Best NBA coach of all time ,27,4222,26628,30850,photo
CompanyJ_3064,Seems legit via trailblazers ,29,5312,38256,43568,video
CompanyJ_3065,The 2003 NCAA tournament was legendary Melo Led Cuse to 1st national title as a frosh Won tourney MOP Avg 20 2 PTS 9 8 RBS Wade Led Marquette to 1st Final Four since 77 Had 4th triple double in tourney history Avg 21 8 PTS 6 6 RBS 6 0 AST MarchMadness ,252,2271,11771,14042,photo
CompanyJ_3066,BREAKING Mike Trout is finalizing a record breaking 12 year contract worth more than 430 million with the Angels per JeffPassan ,128,8621,32610,41231,photo
CompanyJ_3067,Trout s extension will put him at a career earnings total of 577 85M most ever in major American sports per spotrac ,116,2061,9103,11164,photo
CompanyJ_3068,There can only be one TheNotoriousMMA via brfootball ,53,88,973,1061,photo
CompanyJ_3069,Trolling fans everywhere he goes Michigan freshman Ignas Brazdeikis is the villain of MarchMadness ,99,982,6065,7047,video
CompanyJ_3070,Damon Jones finally speaks about JR Smith soup incident The soup was on my arm and it was hot as hell per JalenandJacoby ,121,438,2929,3367,photo
CompanyJ_3071,LSU s Wayde Sims was shot and killed in September but his best friend Skylar Mays still feels his presence on the court When shots go in I m like Yeah that was Wayde Watch the full story ,187,2064,7989,10053,video
CompanyJ_3072,This trio is worth more than a billion ,39,820,3749,4569,photo
CompanyJ_3073, ,1,278,2040,2318,photo
CompanyJ_3074,Florida prosecutors offer to drop solicitation of prostitution charges against Robert Kraft and others if they admit they would have been proven guilty per andrewlbeaton ,170,256,791,1047,photo
CompanyJ_3075,Mbappe s new celebration is cold via btsportfootball ,53,1397,8854,10251,video
CompanyJ_3076,Dedric Lawson was dubbed the worst athlete at the 2016 NBA combine But after becoming a star at Kansas he thinks he s proved the doubters wrong ahead of this summer s draft writes byDavidGardner ,195,166,810,976,photo
CompanyJ_3077,Kyler Murray is meeting with the Cardinals HC and GM at Oklahoma today per AaronWilson_NFL ,91,198,1547,1745,photo
CompanyJ_3078,Can t leave Pat Bev hanging via scstateofmind_ IG ,50,661,7498,8159,video
CompanyJ_3079,Ref who made wrestler cut his dreads before match claims defamation wants 100k per TMZ_Sports ,94,237,1170,1407,photo
CompanyJ_3080,Last year was full of upsets Which top seeds are going down this year GreatClips ,81,91,682,773,video
CompanyJ_3081,No 1 recruit and Memphis commit James Wiseman wins Gatorade National Player of the Year ,88,956,3500,4456,video
CompanyJ_3082,LET US MARCH MarchMadness ,26,702,3401,4103,photo
CompanyJ_3083,NOPE MarchMadness ,18,378,3877,4255,video
CompanyJ_3084,Vince isn t a fan of Trae s dunks ,34,275,3298,3573,video
CompanyJ_3085, GET THAT MAN A MAP ,20,6557,25165,31722,video
CompanyJ_3086,LB Vontaze Burfict is signing a 1 year contract with the Raiders per TomPelissero ,82,400,1767,2167,photo
CompanyJ_3087,Clay Matthews is signing with the Rams on a 2 year deal per RapSheet ,69,2004,8984,10988,photo
CompanyJ_3088,Kemba in March gt gt gt ,24,2247,14429,16676,video
CompanyJ_3089,With 31PTS tonight The Beard has now scored at least 30 against every team in the league this season ,101,959,5142,6101,video
CompanyJ_3090,Drake attempted his own half court challenge and it didn t go well via dinoocicvaric Instagram ,95,723,5459,6182,video
CompanyJ_3091,FORTY PIECE FOR DLO ,20,1242,7641,8883,video
CompanyJ_3092,D Lo dropped 27 in the fourth and a career high 44 PTS Sheesh ,62,7481,29616,37097,video
CompanyJ_3093, I m built for this s t Talk your talk D Lo ,44,16294,70275,86569,video
CompanyJ_3094, Silence the doubters ,22,5678,31963,37641,photo
CompanyJ_3095,Oh my Pat Bev ,14,593,3939,4532,video
CompanyJ_3096, I don t think he s a late bloomer he s right on time Lou Williams on D Lo s rise via TomerAzarly ,98,3917,26542,30459,video
CompanyJ_3097,After seeing Steph hit a ridiculous half court shot Matt Millet a Special Olympics athlete recreated one himself via SpOlympicsMA ,130,561,4407,4968,video
CompanyJ_3098,Fans show all the respect to Ichiro at the Tokyo Dome as he comes out the game via Cut4 ,88,304,2520,2824,video
CompanyJ_3099,Duke s RJ Barrett is leading the Canadian revolution of MarchMadness ,69,343,2451,2794,video
CompanyJ_3100,Mbappe s teammates celebrated his winning goal in France training like it was in the World Cup via equipedefrance ,114,1169,9608,10777,video
CompanyJ_3101,Sansa Stark with a top 10 celebrity Jumbotron appearance via jenshames ,71,4364,21947,26311,video
CompanyJ_3102,Jihad Ward nearly launched the medicine ball through the wall via Colts ,72,2016,17171,19187,video
CompanyJ_3103,He got death threats for decommitting from Wisconsin to pick UK People put his head on posters of snakes One man told him I hope you get hit by a truck But Tyler Herro doesn t care I like it when people are against me ,218,1610,7279,8889,photo
CompanyJ_3104,29 points 4 threes 8 14 from the field Belmont s Kevin McClain was on one vs Temple last night ,95,140,1338,1478,video
CompanyJ_3105,Pogba bought NBA style championship rings for the World Cup winning France team and they are incredible via jasonofbh ,118,2953,13697,16650,photo
CompanyJ_3106,Jake Olson USC s blind long snapper does 17 reps on the bench press to raise money for retinoblastoma after it took his eyesight via LindseyThiry ,146,1137,6668,7805,video
CompanyJ_3107,360 view of France s World Champions 11 carat diamond encrusted ring via JasonofBH ,83,716,3332,4048,video
CompanyJ_3108,KD brought pizza to these fans hotel room after meeting their dad in the elevator via TommyMount223 ,100,5001,35600,40601,video
CompanyJ_3109,Steve Nash visits his godson RJ Barrett to go inside Duke s brotherhood with Zion then Coach K reveals why RJ will be one of the best players in the NBA right away Watch the full story ,185,1045,5104,6149,video
CompanyJ_3110,No 2 2020 recruit Jalen Green dunked all over this 7 footer via sportstop100 ,77,537,2527,3064,video
CompanyJ_3111,Joe Golding says he s going to wear his ripped dress pants vs Kentucky after tearing them in the Southland Conference Championship game via marchmadness ,153,125,938,1063,video
CompanyJ_3112,Wise words from The Mamba ,26,1667,8772,10439,photo
CompanyJ_3113,Say it with your chest Dame ,28,5178,25553,30731,photo
CompanyJ_3114,Spida Stutter Slam ,19,936,5491,6427,video
CompanyJ_3115,BIG TIME spin move NDSU keeps their tourney run alive MarchMadness ,67,55,571,626,video
CompanyJ_3116,Coach Pop gifts D Wade signed jerseys of Tim Duncan Manu and Tony Parker in pregame ,84,6073,37518,43591,video
CompanyJ_3117,Shamorie Ponds splashed one from the logo to beat the buzzer MarchMadness ,74,221,1518,1739,video
CompanyJ_3118,Joakim is for the kids ,23,261,2187,2448,video
CompanyJ_3119,Jimmy s face after hitting the dagger on the Celtics was priceless ,67,4917,24751,29668,video
CompanyJ_3120,Marcus Smart got ejected for shoving Embiid to the ground ,58,518,2846,3364,video
CompanyJ_3121,D Wade hit a half court heave at the buzzer ,44,1177,5908,7085,video
CompanyJ_3122,Grizzlies and Rockets had one of the most bizarre OT endings to a game this season ,83,370,2185,2555,video
CompanyJ_3123,Joel Embiid making it known ,28,412,2677,3089,photo
CompanyJ_3124,This D Wade dagger on the Spurs was just ridiculous OneLastDance ,65,2810,15405,18215,video
CompanyJ_3125,RUSS FORCES OT via okcthunder ,30,983,6843,7826,video
CompanyJ_3126,Kawhi is the smoothest silencer ,32,752,6122,6874,video
CompanyJ_3127,With their 4th straight loss OKC drops from 5th to tied with No 8 Clips and Spurs Could they see the Warriors in the first round ,129,520,3093,3613,photo
CompanyJ_3128,KD pulled up to see Nick Collison become the 1st OKC player to get jersey retired ,82,986,7797,8783,video
CompanyJ_3129,It takes a lot to impress Kawhi ,32,726,4183,4909,photo
CompanyJ_3130,Ichiro receives a standing ovation as he leaves the field for the last time before his reported retirement via Mariners ,120,1128,6223,7351,video
CompanyJ_3131,Yusei Kikuchi tears up as Ichiro leaves the game via MLB ,57,1607,13430,15037,video
CompanyJ_3132,Madness is here ,16,1470,6572,8042,photo
CompanyJ_3133,Kobe gives out the 2019 Mamba Mentality Challenge ,50,1218,5040,6258,video
CompanyJ_3134,Ichiro Suzuki officially announces his retirement after 19 seasons in MLB and 9 seasons in Japan 3 000 hit club 4 367 combined hits 2001 MLB AL MVP amp ROY 10x MLB All Star 10x MLB Gold Glove Legend ,199,5992,30559,36551,photo
CompanyJ_3135,The Tournament all comes down to one question Can you get hot for 6 games From BR x uninterrupted x Audi Q8 ,108,106,535,641,video
CompanyJ_3136,All eyes on Duke as the tournament kicks off ,45,1293,6102,7395,photo
CompanyJ_3137,From Zion to Ja each region has a star ready to own the whole bracket CaesarsPalace ,84,97,494,591,video
CompanyJ_3138, Duke Terps Tar Heels Spartans NBA players share why their former squads are ready to dance this March CaesarsPalace ,117,69,582,651,video
CompanyJ_3139,A special gift via dwyanewade ,30,1693,13621,15314,photo
CompanyJ_3140,Let s dance MarchMadness ,25,1508,6226,7734,video
CompanyJ_3141,Bill Murray is ready to March MarchMadness ,43,106,1018,1124,video
CompanyJ_3142,DENIED LSU is coming out hot with a 9 0 run marchmadness ,57,166,1121,1287,video
CompanyJ_3143,NAZ REID IS A FRESHMAN marchmadness ,36,541,3458,3999,video
CompanyJ_3144,Out of all the No 1 seed coaches who would you trust And keep your eyes on HoHighlights for pizzahut discounts ,111,48,380,428,video
CompanyJ_3145,Lost em with the Euro marchmadness ,35,803,2771,3574,video
CompanyJ_3146,Don t sleep on Amir Coffey MarchMadness ,40,130,939,1069,video
CompanyJ_3147,11 years ago today Stephen Curry put the nation on notice vs Gonzaga 40 PTS 14 22 FG 8 10 3PT 30 in 2nd half MarchMadness ,122,1418,7406,8824,photo
CompanyJ_3148,Gophs are feelin it from deep MarchMadness ,43,231,1536,1767,video
CompanyJ_3149,Tremont BROKE his ankles MarchMadness ,38,723,2809,3532,video
CompanyJ_3150,HOW D HE GET THAT OFF MarchMadness ,35,177,1507,1684,video
CompanyJ_3151, UPSET ALERT No 10 Minnesota takes down No 7 Louisville 86 76 Kalscheur 24 PTS 5 threes 8 REBS ,95,1231,7310,8541,photo
CompanyJ_3152,Ian Eagle narrating a spilled drink is the definition of MarchMadness ,70,726,3648,4374,video
CompanyJ_3153,Ball movement on No 13 Vermont tied with No 4 Florida St 27 27 at half MarchMadness ,84,130,909,1039,video
CompanyJ_3154,No 15 Bradley showing no fear against Michigan State MarchMadness ,66,212,1767,1979,video
CompanyJ_3155,THIS IS MARCH ,14,961,5529,6490,video
CompanyJ_3156,OKAY NEW MEXICO STATE ,22,323,2487,2810,video
CompanyJ_3157,FOULED WHAT IS GOING ON ,24,635,4143,4778,video
CompanyJ_3158,Chuck s reaction MarchMadness ,30,199,1244,1443,photo
CompanyJ_3159,WHAT A GAME No 5 Auburn holds off unbelievable comeback as No 12 New Mexico State misses clutch free throws in final seconds ,125,413,2372,2785,photo
CompanyJ_3160,When March hits ,16,646,3874,4520,video
CompanyJ_3161,Kabengele letting it be known a triple team won t stop him MarchMadness ,72,508,2367,2875,video
CompanyJ_3162,Bradley not messing around MarchMadness ,40,479,2862,3341,video
CompanyJ_3163,Izzo is heated MarchMadness ,28,603,3700,4303,video
CompanyJ_3164,Gabe Kalscheur caught fire from behind the arc today The Minnesota freshman could be the early breakout star of marchmadness exxonmobil ,136,820,7180,8000,video
CompanyJ_3165, ,1,68,655,723,video
CompanyJ_3166,Ja Morant is ready for MarchMadness ,36,581,3778,4359,video
CompanyJ_3167,Ja Morant getting nice with it EARLY MarchMadness ,50,435,2991,3426,video
CompanyJ_3168,OH MY MARYLAND MarchMadness ,28,3209,11250,14459,video
CompanyJ_3169, Talk your talk Ja ,19,5418,25291,30709,video
CompanyJ_3170,10 points 8 assists 4 rebounds Ja Morant is on triple double watch going into the second half ,94,518,3663,4181,photo
CompanyJ_3171,Ja Morant WOW ,14,18824,62238,81062,video
CompanyJ_3172,Every lottery team watching Ja Morant MarchMadness ,51,2952,15232,18184,photo
CompanyJ_3173,Ja Morant doing it all ,23,1574,7853,9427,photo
CompanyJ_3174,Ja Morant carries No 12 Murray State to the 2nd round 17 PTS 16 AST 11 REB MarchMadness ,88,4088,20309,24397,photo
CompanyJ_3175,Wait for it TurboTax ,21,614,3515,4129,video
CompanyJ_3176,Trae s handles on Rubio ,24,2576,16036,18612,video
CompanyJ_3177,The HoHighlights show is LIVE Look forward to special guest Dennis1SmithJr coming up soon ,90,14,66,80,link
CompanyJ_3178,No 1 Gonzaga dropped 53 PTS in the 1st half MarchMadness ,57,780,6384,7164,video
CompanyJ_3179,Jay Z had Dennis1SmithJr shook the first time they met via HoHighlights ,72,295,1837,2132,video
CompanyJ_3180,Meet me at the RIM MarchMadness ,32,292,2087,2379,video
CompanyJ_3181,Rise up NOVA MarchMadness ,26,100,879,979,video
CompanyJ_3182, UPSET ALERT No 10 Florida knocks out No 7 Nevada 70 61 ,56,790,4681,5471,photo
CompanyJ_3183, Post this picture and tell KD and Kyrie come holla at us in New York Dennis1SmithJr via HoHighlights ,102,856,3909,4765,video
CompanyJ_3184,From the logo Baylor is on from deep MarchMadness ,50,188,1392,1580,video
CompanyJ_3185,Carsen Edwards showing off his in the gym range MarchMadness ,61,209,1616,1825,video
CompanyJ_3186,History for the Wofford star MarchMadness ,42,565,3004,3569,photo
CompanyJ_3187,Owner of the most threes in NCAA history magee_fletcher marchmadness ,69,240,1956,2196,video
CompanyJ_3188,Put this Fox dunk on a poster ,30,1726,10718,12444,video
CompanyJ_3189,Myles Powell has taken over the 2nd half MarchMadness ,54,230,1303,1533,video
CompanyJ_3190,FLETCHER MAGEE IS IN THAT ZONE MarchMadness ,44,478,3494,3972,video
CompanyJ_3191,No 7 Wofford picks up their school s first NCAA tournament win Magee 24 PTS 7 threes ,85,361,3375,3736,photo
CompanyJ_3192,Steph just toys with Bogdanović ,32,606,3760,4366,video
CompanyJ_3193,Baylor celebrates a huge W to Waka Flocka via BaylorMBB ,56,545,3570,4115,video
CompanyJ_3194,They really had Ron Burgundy in the LA Kings booth last night via NHL ,70,8343,40471,48814,video
CompanyJ_3195,Donovan Mitchell surprised his fourth grade teacher s daughter with a scholarship and courtside seats via E_Woodyard ,117,1854,14044,15898,video
CompanyJ_3196,Giannis took notes for an hour after his offseason workouts with Kobe on matchups that gave him problems in the past via TheFrankIsola ,135,435,3604,4039,photo
CompanyJ_3197,No 1 recruit ACC scoring leader Canadian Kobe RjBarrett6 is ready for MarchMadness ,83,394,2177,2571,video
CompanyJ_3198,This KingJames Lakers tattoo via lukalajoie ,44,1696,12056,13752,photo
CompanyJ_3199,DJJ s flight Bron off glass Luka s poster The NBA s top 10 dunks since the All Star break ,90,441,2414,2855,video
CompanyJ_3200,How Duke fans filled out their brackets ,40,3848,16129,19977,video
CompanyJ_3201,Cam Newton says he is giving up sex for a month It makes my mind stronger via latelateshow ,91,1775,9539,11314,photo
CompanyJ_3202,7 6 Tacko Fall next to 5 2 reporter Tracy Wolfson via CBSSports ,64,2756,11908,14664,photo
CompanyJ_3203,Falcons Julio Jones closing in on 4 or 5 year extension that would pay 20M a year per mikefreemanNFL ,101,2075,8666,10741,photo
CompanyJ_3204,Fletcher Magee was an unranked recruit Yesterday he broke the D 1 3PT record exxonmobil ,88,3939,28033,31972,video
CompanyJ_3205,Kobe is over the GOAT debate I really don t care I ve moved on I typically do not engage in things I cannot definitively win per GetUpESPN ,139,961,6007,6968,photo
CompanyJ_3206,14 threes in a row OregonWBB s Sabrina Ionescu is ready for marchmadness ,73,503,3548,4051,video
CompanyJ_3207,NOT TODAY MarchMadness ,23,90,815,905,video
CompanyJ_3208,Culver cooking EARLY He s scored 9 on Texas Tech s 20 points MarchMadness ,74,64,525,589,video
CompanyJ_3209,D Angelo Russell faces the Lakers tonight with a chance to officially eliminate them from the playoffs ,103,9634,57058,66692,photo
CompanyJ_3210,IOWA LOOKING FOR THE UPSET MarchMadness ,40,106,1052,1158,video
CompanyJ_3211,WE VE GOT AN UPSET No 10 Iowa takes down No 7 Cincy 79 72 Garza 20 PTS 7 REBS ,78,431,2513,2944,photo
CompanyJ_3212,Draymond gives perspective on Coach Izzo ,41,273,2104,2377,video
CompanyJ_3213,The cameraman s face ,21,657,4362,5019,video
CompanyJ_3214,UC Irvine coming out hot MarchMadness ,38,229,1707,1936,video
CompanyJ_3215,Owens with AUTHORITY MarchMadness ,34,108,653,761,video
CompanyJ_3216,20 years ago today Stone Cold pulled up on The Rock and the McMahons with a beer truck Historic moment via WWE ,111,4818,13111,17929,video
CompanyJ_3217,Virginia facing another 16 seed MarchMadness ,45,1313,6771,8084,photo
CompanyJ_3218, MarchMadness ,14,919,4924,5843,photo
CompanyJ_3219,IT S HAPPENING MarchMadness ,28,530,3034,3564,video
CompanyJ_3220,ZOT ZOT No 13 UC Irvine upsets No 4 Kansas State Hazzard 19 PTS 4 REBS ,71,1456,6049,7505,photo
CompanyJ_3221,He FLEW for this block ,23,513,3090,3603,video
CompanyJ_3222,From the logo Payton Pritchard is feeling it early MarchMadness ,64,130,1163,1293,video
CompanyJ_3223,Bobby Hurley is BIG MAD ,24,415,4047,4462,video
CompanyJ_3224,Cleared for takeoff right before halftime MarchMadness ,55,65,694,759,video
CompanyJ_3225,Trae Young back at OU supporting the second round bound Sooners via OU_MBBall ,78,411,3571,3982,video
CompanyJ_3226,PUT EM ON A POSTER MarchMadness ,32,527,2569,3096,video
CompanyJ_3227,March Hustle MarchMadness ,26,211,1691,1902,video
CompanyJ_3228,Kenny Wooten is playing volleyball in March MarchMadness ,57,335,1838,2173,video
CompanyJ_3229,No 12 Oregon upsets and knocks out No 5 Wisconsin in dominating fashion 72 54 MarchMadness ,91,643,3215,3858,photo
CompanyJ_3230,Zion wasting no time MarchMadness ,34,808,5228,6036,video
CompanyJ_3231,Lonzo Ball has severed ties with BBB co founder Alan Foster after reports that he has allegedly been unable to account for roughly 1 5M from Ball s business accounts per ramonashelburne pinepaula amp malika_andrews ,215,2983,7891,10874,photo
CompanyJ_3232,Matisse Thybulle lost his mother when he was 17 His dad is making sure there s always support in the bleachers MarchMadness ,124,985,7764,8749,video
CompanyJ_3233,Solid coaching ,15,714,4671,5385,photo
CompanyJ_3234,ZION INCOMING MarchMadness ,27,454,2948,3402,video
CompanyJ_3235,This Zion run and finish was just ridiculous MarchMadness ,58,1152,6080,7232,video
CompanyJ_3236,RJ showed out on the break MarchMadness ,40,361,1995,2356,video
CompanyJ_3237,No 1 Duke settled in and took care of business against No 16 NDSU 85 62 RJ Barrett 26 PTS 14 REB Zion Williamson 25 PTS MarchMadness ,133,483,2576,3059,photo
CompanyJ_3238,LIBERTY 10 0 RUN Could they win their first ever tourny matchup ,64,230,1898,2128,video
CompanyJ_3239,No 12 Liberty completes the comeback to upset No 5 Miss State 80 76 Their first ever NCAA Tournament victory MarchMadness ,122,1083,5060,6143,photo
CompanyJ_3240,Harden dropped 61 PTS on the Spurs and moved into 10th on the all time 3PM list ,80,3333,13145,16478,video
CompanyJ_3241, DON T REACH ,13,377,3286,3663,video
CompanyJ_3242,The Beard can t be stopped ,27,954,4357,5311,photo
CompanyJ_3243,Tacko Fall is a matchup nightmare MarchMadness ,47,260,1905,2165,video
CompanyJ_3244,Giannis put the moves on Olynyk Then he dropped the ball on him while down ,75,1517,8908,10425,video
CompanyJ_3245,Buckeyes bench is feeling it after this alley ,46,376,2922,3298,video
CompanyJ_3246,ONIONS MarchMadness ,20,114,1042,1156,video
CompanyJ_3247,BRON CHASED DOWN D LO ,22,2712,14747,17459,video
CompanyJ_3248,D Lo had a message for Lakers fans ,35,5387,30653,36040,video
CompanyJ_3249,DLo amp the Nets eliminate the Lakers from playoff contention ,62,9082,31472,40554,video
CompanyJ_3250,LeBron misses the playoffs for the first time since 2005 ,57,11816,59307,71123,photo
CompanyJ_3251,Buffalo had to scratch their original game plan for Connecticut via ncaawbb ,76,246,1701,1947,video
CompanyJ_3252,Last time LeBron missed the playoffs was in 2005 That year Netflix was delivering DVDs Apple didn t have an iPhone YouTube was founded Aubrey Graham wasn t Drake yet he was Jimmy Brooks on Degrassi ,198,12493,37100,49593,photo
CompanyJ_3253,A year ago today Zlatan made the move to LA From Premier League to MLS never change ,84,127,1593,1720,photo
CompanyJ_3254,LeBron on Lakers missing playoffs not what we signed up for ,60,341,2893,3234,photo
CompanyJ_3255,He caught AD with the fake but Davis too big for the stepback via mezzynumba9 ,78,343,3130,3473,video
CompanyJ_3256,No rest for The Beard ,22,551,3764,4315,photo
CompanyJ_3257,Naz Reid and LSU are cookin MarchMadness ,41,128,977,1105,video
CompanyJ_3258,Nick Foles tried to introduce himself to Kobe and he responded with Fool I know who you are via JClarkNBCS ,107,13637,83541,97178,video
CompanyJ_3259,A MAN S JAM MarchMadness ,25,173,1444,1617,video
CompanyJ_3260,Here comes Maryland marchmadness ,33,105,779,884,video
CompanyJ_3261,BLOCK PARTY MarchMadness ,25,97,743,840,video
CompanyJ_3262,SKYLAR MAYS COLD MarchMadness ,30,260,1316,1576,video
CompanyJ_3263,Maryland ANSWERS MarchMadness ,30,109,789,898,video
CompanyJ_3264,MARCH MADNESS LSU ADVANCES ,27,2015,8991,11006,video
CompanyJ_3265,March Madness upsets and game winners gt gt gt ,47,534,3203,3737,photo
CompanyJ_3266,LSU players all looked up at the same time and saw the score was 44 number of their late teammate Wayde Sims and knew they had to win He s always with us ,154,1750,12951,14701,video
CompanyJ_3267,Travis Scott brought out Future to perform MarchMadness in ATL via TheNikkoTan ,79,3568,14736,18304,video
CompanyJ_3268,No 7 WOFFORD NOT MESSING AROUND AGAINST KENTUCKY MarchMadness ,62,228,2254,2482,video
CompanyJ_3269,Kentucky starting to lock in MarchMadness ,42,122,1270,1392,video
CompanyJ_3270, ANKLES marchmadness ,21,650,3341,3991,video
CompanyJ_3271,WE VE GOT A GAME MarchMadness ,30,83,765,848,video
CompanyJ_3272,Wildcats hold on No 2 Kentucky defeats No 7 Wofford 62 56 Travis 14 PTS 11 REB MarchMadness ,92,433,2403,2836,photo
CompanyJ_3273,In fourth grade Kyrie Irving wrote that he d play in the NBA and kept the paper until HS Today he turns 27 ROTY 6x All Star NBA champion One of the GOAT ball handlers One of the most clutch shots ever ,201,5322,30783,36105,photo
CompanyJ_3274,Ja Morant has everything under control MarchMadness ,52,1317,7460,8777,video
CompanyJ_3275,LeBron sees a bright future for DLo ,36,784,6233,7017,photo
CompanyJ_3276,Dipo bringing that soul to the gym during rehab via micah_lancaster IG ,71,829,5543,6372,video
CompanyJ_3277,FSU is doing everything right early MarchMadness ,49,117,969,1086,video
CompanyJ_3278,You can hear this dunk MarchMadness ,36,961,5251,6212,video
CompanyJ_3279,Kemba left him stumbling ,25,1902,10152,12054,video
CompanyJ_3280,TWO HANDED WINDMILL OFF THE BREAK MarchMadness ,47,165,1385,1550,video
CompanyJ_3281,Had his teammate doing pushups MarchMadness ,44,168,1708,1876,video
CompanyJ_3282,Michigan went crazy in the locker room MarchMadness ,52,237,1909,2146,video
CompanyJ_3283,This kid couldn t believe it MarchMadness ,42,139,1159,1298,video
CompanyJ_3284,Boban for 3 7 3 big man just drilled his first career triple ,61,2346,18567,20913,video
CompanyJ_3285,No 4 FSU is headed to the Sweet 16 with a 90 62 win over No 12 Murray State Mfiondu Kabengele 22 PTS 7 REB 3 BLK MarchMadness ,126,201,975,1176,photo
CompanyJ_3286, Ja Morant has a brilliant career ahead of him Murray State star gets emotional after tournament run ends against FSU Morant finished with 28 PTS 5 REB 4 AST MarchMadness ,171,1161,7455,8616,video
CompanyJ_3287,Kemba gets super powers when the calendar flips to March ,57,4193,22867,27060,video
CompanyJ_3288,This Gonzaga putback dunk MarchMadness ,39,174,1462,1636,video
CompanyJ_3289,Luka is FEELING IT Three stepbacks in the first quarter ,56,1716,10894,12610,video
CompanyJ_3290,This never gets old OneLastDance ,33,926,6487,7413,video
CompanyJ_3291,COFFEY BODIED HIM ,18,572,3616,4188,video
CompanyJ_3292, Somewhere some parents are very proud of those young men MarchMadness ,71,302,2102,2404,video
CompanyJ_3293,Memorable moment for Minnesota senior Jordan Murphy who checks in one last time MarchMadness ,93,948,5511,6459,video
CompanyJ_3294,Trae hit the game winner and broke out The Silencer COLD BLOODED ,65,2756,13891,16647,video
CompanyJ_3295,Don t retire D Wade ,20,1571,8809,10380,photo
CompanyJ_3296,Carsen Edwards was HOOPING for Purdue tonight 42 PTS 12 21 FG 9 16 3PT W ,73,1490,7588,9078,video
CompanyJ_3297,Ice Trae ,9,327,3035,3362,photo
CompanyJ_3298,Re live Ice Trae s game winner courtside via _jackmallon_ amp dylan mallon3 IG ,79,574,3645,4219,video
CompanyJ_3299,No in between for Zion ,23,1118,7247,8365,photo
CompanyJ_3300,Trae ROTY buzz growing ,23,1167,7334,8501,photo
CompanyJ_3301,KD when asked about Dirk s farewell tour Has Dirk retired yet I feel like everybody s pushing him out the league via loganmmurdock ,131,1394,9315,10709,video
CompanyJ_3302,Dame right on time as always ,29,594,3748,4342,video
CompanyJ_3303, If you don t like that Fox ends it with a windmill ,52,7204,42035,49239,video
CompanyJ_3304,Hockey players out here dunking on ice via NHLCanes ,52,663,4134,4797,video
CompanyJ_3305,Randy Johnson made a bird pop 18 years ago via Cut4 ,52,6867,25411,32278,video
CompanyJ_3306,That time Devin Booker lit the Celtics up for 70 Points ,56,1881,11902,13783,video
CompanyJ_3307,Cockiness got him KO d with 10 seconds left via BTSportBoxing ,62,7189,32858,40047,video
CompanyJ_3308,FAKED EM OUT ,13,554,4283,4837,video
CompanyJ_3309,On this day in 1975 Chuck Wepner survived 15 rounds with Muhammad Ali and inspired Sylvester Stallone to write Rocky Ali I have been so great in boxing they had to create an image like Rocky a white image on the screen to counteract my image in the ring ,254,1840,6571,8411,photo
CompanyJ_3310,No 2 Tennessee cruises into halftime Schofield can t miss 17 PTS 5 REB MarchMadness ,84,140,1296,1436,video
CompanyJ_3311,Gallo wanted no part of this DeAndre alley ,43,396,3369,3765,video
CompanyJ_3312,Chill Coach MarchMadness ,25,343,3264,3607,video
CompanyJ_3313,This Lou Will story In 2011 he convinced a gunman not to rob him in Philly then took him to McDonald s and talked about life ,125,35664,140160,175824,video
CompanyJ_3314,Iowa s defensive intensity MarchMadness ,40,89,803,892,video
CompanyJ_3315,Foul MarchMadness ,18,242,1512,1754,video
CompanyJ_3316,Big saves don t get better than this MarchMadness ,50,202,1264,1466,video
CompanyJ_3317,Stripped it then walked off like a boss ,40,330,3493,3823,video
CompanyJ_3318,No 2 Tennessee holds off No 10 Iowa 25 point comeback win first OT game in tournament 83 77 Grant Williams COOKED 19 PTS 7 REB 4 STL 3 BLK MarchMadness ,152,216,1787,2003,photo
CompanyJ_3319,Chuck was ready to throw down after Gumbel said wrestling isn t real ,69,1803,7764,9567,video
CompanyJ_3320,That s just cold Coby MarchMadness ,35,724,4550,5274,video
CompanyJ_3321,Miedema put both defenders in the dirt via FAWSL ,49,207,1052,1259,video
CompanyJ_3322,Chris Bosh turns 35 today with an underrated legacy 2x champ 11x All Star Sacrificed in MIA Career 19 2 PPG 8 5 REB Ahead of his time as stretch big Helped inspire player movement ,180,3067,16964,20031,photo
CompanyJ_3323,Minor setback for a major comeback ,35,1633,7075,8708,photo
CompanyJ_3324,Coby is getting in his bag MarchMadness ,40,218,1316,1534,video
CompanyJ_3325,Jason Kidd will be a serious candidate for the Lakers job if Luke Walton is fired per wojespn ,94,1269,6490,7759,photo
CompanyJ_3326,Tacko is ready for Zion at the rim ,35,402,2441,2843,photo
CompanyJ_3327,Tacko Fall starting the game off RIGHT MarchMadness ,52,561,4057,4618,video
CompanyJ_3328,Tacko shuts down Zion in the paint and dunks on the other end Oh my MarchMadness ,81,1132,7001,8133,video
CompanyJ_3329,Little man s handles are not fair via TishawnaMonet ,52,3658,14252,17910,video
CompanyJ_3330,Tacko Fall is a man of his word ,32,1177,6762,7939,photo
CompanyJ_3331,UCF is cooking early MarchMadness ,34,101,965,1066,video
CompanyJ_3332,Breaking Gronk has announced his retirement ,44,10356,37131,47487,photo
CompanyJ_3333,OH MY ZION MarchMadness ,24,521,3941,4462,video
CompanyJ_3334,Thank you RobGronkowski ,24,1860,9545,11405,link
CompanyJ_3335,There s only one Gronk Enjoy retirement No 87 ,46,1110,4187,5297,video
CompanyJ_3336,Best TE ever ,13,1011,5813,6824,photo
CompanyJ_3337,This photo is ridiculous ,25,7706,47385,55091,photo
CompanyJ_3338,Tacko is a different type of paint presence MarchMadness ,57,267,1992,2259,video
CompanyJ_3339,UCF IS NOT BACKING DOWN MarchMadness ,37,532,3380,3912,video
CompanyJ_3340,Did this graze the rim MarchMadness ,36,118,853,971,video
CompanyJ_3341,THIS GAME MarchMadness ,23,481,2078,2559,photo
CompanyJ_3342,MADNESS ,8,1182,5082,6264,photo
CompanyJ_3343,ZION AND 1 AND FOULS OUT TACKO FALL MarchMadness ,49,3140,11723,14863,video
CompanyJ_3344,RJ putback as Duke re takes the lead MarchMadness ,50,653,2788,3441,video
CompanyJ_3345,Zion leads Duke to the Sweet 16 ,32,2330,9288,11618,video
CompanyJ_3346,Brutal MarchMadness ,20,3915,16772,20687,video
CompanyJ_3347,THIS IS MARCH MarchMadness ,27,686,3660,4346,photo
CompanyJ_3348,Coach K consoles sobbing UCF players after Duke survives via ShawnKrest ,72,6781,59326,66107,video
CompanyJ_3349,JEREMY LAMB HALF COURT BANK FOR THE WIN ,40,14601,53322,67923,video
CompanyJ_3350,Zion is built for this ,23,734,5475,6209,photo
CompanyJ_3351,Bunch of Jokers in the Liberty fan section MarchMadness ,56,96,823,919,video
CompanyJ_3352,Duke fans watching that final play ,35,851,5046,5897,video
CompanyJ_3353,Kemba definitely didn t think Jeremy Lamb s game winner was going in via Marnsantana ,85,4486,25988,30474,video
CompanyJ_3354,Don t test Wooten s vertical MarchMadness ,42,301,2142,2443,video
CompanyJ_3355,BODIED Marchmadness ,20,421,2735,3156,video
CompanyJ_3356,Sabrina Ionescu is a BUCKET 18th career triple double 29 PTS 10 REBS 12 ASTS 3 STLS via ncaawbb ,96,914,5663,6577,video
CompanyJ_3357,Another Wooten Block MarchMadness ,34,262,2384,2646,video
CompanyJ_3358,Coach Johnny Dawkins postgame speech is class personified via UCF_MBB ,70,4991,27116,32107,video
CompanyJ_3359,Pats fans waking up realizing Gronk really retired ,51,5805,25960,31765,video
CompanyJ_3360,Hero has many definitions WomensHistoryMonth ,45,600,2590,3190,photo
CompanyJ_3361,Mini OBJ broke the entire defense via leehooks24 ryd o Instagram ,65,400,3431,3831,video
CompanyJ_3362,Griezmann goes to Umtiti when he needs a cologne fix via equipedefrance ,72,377,3266,3643,video
CompanyJ_3363,Wrestlemania 35 s header will be Ronda Rousey vs Becky Lynch vs Charlotte Flair It ll be the event s first women s main event ,126,435,2046,2481,photo
CompanyJ_3364,D Wade is going out on his own terms ,37,1551,11233,12784,photo
CompanyJ_3365,Johnny Manziel s already talking trash in the AAF NSFW via TheAAF ,66,1861,11786,13647,video
CompanyJ_3366,D Wade wants to help Zaire reach the league He wants this He wants to be on this NBA level I m going to do my part per ShamsCharania ,133,751,6560,7311,photo
CompanyJ_3367,LeBron has Zo s back ,21,1626,14946,16572,photo
CompanyJ_3368,Manny Machado says he s ready to put his dirty reputation behind him be a leader to MLB s No 1 farm system and turn himself from a villain into the Padres hero ,160,206,1309,1515,photo
CompanyJ_3369,Little man crossed him three times on six dribbles via leelanryder Instagram ,77,1914,15099,17013,video
CompanyJ_3370,Cassius Stanley takes off from wherever he wants ,49,982,7738,8720,video
CompanyJ_3371,The Ball Family had discussions this weekend about folding Big Baller Brand and anything related to former business partner Alan Foster per ramonashelburne ,156,545,2777,3322,photo
CompanyJ_3372,Fans got up for a wild first weekend of March Madness wendys ,61,81,999,1080,link
CompanyJ_3373,LaMelo Ball lit up high school ball this past season ,53,615,3153,3768,video
CompanyJ_3374,Carsen Edwards came into the tournament slumping but torched Villanova for 42 PTS Then he said he had to get back in the gym exxonmobil ,136,2439,15586,18025,video
CompanyJ_3375,Udonis Haslem says Shaq once ate a four course steak dinner at his locker before an afternoon game When he finished it I was like Welp big fella ain t with us for this game per ShandelRich ,189,1899,12599,14498,photo
CompanyJ_3376,Cristiano Ronaldo suffers apparent hamstring injury during Euro qualifier two weeks before Champions League quarterfinals ,122,439,2705,3144,photo
CompanyJ_3377,18 of them to be exact ,23,1646,10369,12015,photo
CompanyJ_3378,USC football basketball commit Drake London with the 540 ,57,1396,7704,9100,video
CompanyJ_3379,James Harden is averaging 27 8 PPG through the first three quarters That d rank No 2 in the league scoring race ,112,1070,7662,8732,photo
CompanyJ_3380,Potential first round pick Jaylon Ferguson is learning from one of his heroes PFHOF19 From B R x Ford ,102,86,318,404,video
CompanyJ_3381,Zion amp Ja Morant put on a show during the first weekend of March Madness ,75,1671,7524,9195,video
CompanyJ_3382,Fran Belibi brought the house down via KP_Rivals amp McDAAG ,60,442,2186,2628,video
CompanyJ_3383,Tale of two eras via NBA ,25,5702,30182,35884,video
CompanyJ_3384,Utah fans give Jimmer a standing ovation ,41,920,8524,9444,video
CompanyJ_3385,Another standing ovation for Jimmer as he gets his first points as a Suns player ,81,486,4023,4509,video
CompanyJ_3386,Despite the loss Devin Booker dropped 59 PTS on the Jazz and joined Tom Chambers as the only Suns players with multiple 50 point games ,135,1148,6112,7260,video
CompanyJ_3387,The Jazz intentionally fouled so Booker couldn t get another bucket ,68,529,3676,4205,video
CompanyJ_3388,Seth Curry stripped D Lo to force OT ,37,513,4612,5125,video
CompanyJ_3389, ,1,513,4521,5034,photo
CompanyJ_3390,Trail Blazers fans show Jusuf Nurkic support as he gets carted off after suffering gruesome left leg injury ,108,1824,8635,10459,video
CompanyJ_3391,Conor McGregor announces retirement from MMA ,45,7470,26731,34201,photo
CompanyJ_3392,Jusuf Nurkic has sustained a compound fracture to his left leg will require surgery and cost him remainder of the season per ChrisBHaynes ,138,561,3148,3709,photo
CompanyJ_3393,The entire NBA s thoughts were with bosnianbeast27 after his horrific injury last night Prayers up for the big man ,115,976,7093,8069,video
CompanyJ_3394,A legend on and off the court Congrats ChrisBosh ,49,1116,5458,6574,video
CompanyJ_3395,Raheem Sterling was subject to racist abuse during England s friendly yesterday but his goal celebration said everything via brfootball ,136,375,2738,3113,photo
CompanyJ_3396,BR x trvisXX x Mitchell amp Ness are up to something ,53,1400,5079,6479,video
CompanyJ_3397,Tacko Fall and Shaq making normal sized water bottles look tiny via marchmadness ,81,4164,31848,36012,video
CompanyJ_3398,Miami legend Tonight the Heat will retire chrisbosh s jersey ,61,2408,11657,14065,video
CompanyJ_3399,40 years ago today Magic Johnson beat Larry Bird in the NCAA championship First game between the two Magic 24 PTS Bird 19 PTS Highest rated college game ever Turned into NBA rivals and friends MarchMadness ,206,786,4617,5403,photo
CompanyJ_3400,Freddie Kitchens first words to OBJ may be I love you via ByKimberleyA ,71,235,1886,2121,video
CompanyJ_3401,Adam Morrison reflects on his CBB legacy from the Dirk Diggler hotel alias to the Larry Bird mustache to infamously crying after Gonzaga s 2006 Sweet 16 loss Watch the full story ,179,462,2608,3070,video
CompanyJ_3402,Fran Belibi and Cole Anthony shut down the McDAAG dunk contest ,63,564,3011,3575,video
CompanyJ_3403,Recently retired UFC fighter Conor McGregor is under investigation in Ireland over sexual assault allegation per nytimes ,121,747,2321,3068,photo
CompanyJ_3404,La Flame and JHarden13 continue to cook during their career years trvisXX x mitchell_ness collab drops 9pm ET tonight ,118,1712,5382,7094,video
CompanyJ_3405,He just gave up on hurdling mid race via geer_carter ,53,365,2880,3245,video
CompanyJ_3406,Jon Gruden said he cried for 3 days after trading Mack but it landed Oakland Antonio Brown Trent Brown and Lamarcus Joyner per VicTafur ,136,377,2997,3374,photo
CompanyJ_3407,Jumping out of a plane while unboxing sneakers is nuts wbmeech ,63,111,866,977,video
CompanyJ_3408, Nobody would have chosen the Milwaukee Bucks to have the best record Giannis is chrisbosh s MVP via NBATV ,107,443,3297,3740,video
CompanyJ_3409, I wish I could be there man to see that number one go into the rafters Bron shows love and congratulates chrisbosh ahead of his jersey retirement via NBA ,155,1430,9162,10592,video
CompanyJ_3410,Forever immortalized ,21,1688,9558,11246,photo
CompanyJ_3411, I m with the MVP via NBAonTNT ,31,2195,11666,13861,video
CompanyJ_3412,The Beard vs Giannis tonight Who s your MVP ,44,429,4036,4465,photo
CompanyJ_3413,Liverpool and Senegal star Sadio Mane is on one via brfootball ,63,134,728,862,photo
CompanyJ_3414,All offensive and defensive pass interference calls as well as non calls can now be challenged per AdamSchefter ,112,3766,13130,16896,photo
CompanyJ_3415,Gordon Hayward throws down a dunk in the same spot where he suffered his season ending injury back in 2017 ,107,563,5216,5779,video
CompanyJ_3416,This Cavs fan hit 57 shots without a miss in 30 seconds via NBA ,64,3212,24602,27814,video
CompanyJ_3417,Chris Bosh got out of his seat after this DJJ POSTER ,53,1953,9752,11705,video
CompanyJ_3418,What a tribute video for Chris Bosh from the Miami Heat ,56,2003,6381,8384,video
CompanyJ_3419,Officially in the rafters Congrats Chris Bosh ,46,3128,14520,17648,video
CompanyJ_3420,Kicking off NBA Remix with a B R trvisXX x mitchell_ness redesigned Houston Rockets jersey Shop NOW ,100,291,1344,1635,photo
CompanyJ_3421,One last Chris Bosh signature yell before signing off ,54,12544,58121,70665,video
CompanyJ_3422,CP3 step back OH NO ,20,2711,9986,12697,video
CompanyJ_3423,Capela went RIGHT AT Giannis ,29,921,4232,5153,video
CompanyJ_3424,D Wade celebrated with fans after hitting this and 1 ,53,946,6775,7721,video
CompanyJ_3425,MVP chants for Giannis with Harden in the building ,51,1010,6983,7993,video
CompanyJ_3426,Bledsoe told Harden to get out ,31,602,4135,4737,video
CompanyJ_3427,Tonight cpulisic_10 became the youngest player ever 20 years 189 days to score 10 USMNT goals via USMNT ,104,359,2539,2898,video
CompanyJ_3428,Despite the loss Luka Doncic matches Magic with 7 triple doubles in a rookie season 28 PTS 12 REB 12 AST ,105,732,5217,5949,video
CompanyJ_3429,DROP EM LANCE ,14,15993,49512,65505,video
CompanyJ_3430,Zo covered up his BBB tattoo via rockrollg IG ,46,3666,23900,27566,photo
CompanyJ_3431,Bron hit the Lance shimmy after this dunk ,42,939,9175,10114,video
CompanyJ_3432,The Lakers bench lost it after Lance dropped Jeff Green ,56,641,5010,5651,photo
CompanyJ_3433,Bron on what it means to see Chris Bosh get his jersey retired in Miami ,72,919,6830,7749,video
CompanyJ_3434,Last night chrisbosh ,21,1884,16068,17952,photo
CompanyJ_3435,Two goals two KingJames Silencer celebrations for CH14_ via brfootball ,71,692,5736,6428,photo
CompanyJ_3436,Celebration inspiration via brfootball ,39,3591,19682,23273,photo
CompanyJ_3437,Giannis has his priorities straight ,36,2566,21594,24160,photo
CompanyJ_3438,Kobe had to choose between ranking himself MJ and Bron from best to worst or eat cow tongue via latelateshow ,109,21506,65145,86651,video
CompanyJ_3439,Fans chanted for Jusuf Nurkic at a Bosnian national team game yesterday via sohuu91 ,84,1451,9001,10452,video
CompanyJ_3440,The first time ever someone in a wheelchair did this move via woody_belfort IG ,79,2843,20202,23045,video
CompanyJ_3441,Jordy Nelson will retire after 10 years in the NFL per 89JonesNTAF 11 15 6 098 yards 57 TDs ,92,1362,7597,8959,photo
CompanyJ_3442,D Wade over Dirk in 06 Dirk over Wade in 11 A frosty All Star encounter The two legends reflect on their unlikely rivalry ahead of their last matchup ,150,270,2216,2486,photo
CompanyJ_3443,Zaire Wade Kyree Walker UNFAIR ,31,1612,10192,11804,video
CompanyJ_3444,All of your favorite stars started somewhere McDAAG ,52,166,1590,1756,photo
CompanyJ_3445,Nico Mannion says he doesn t look like a good player in all honesty But the Red Mamba is the nation s No 1 point guard prospect for a reason Watch the full story ,162,1026,6807,7833,video
CompanyJ_3446, For my friend neymarjr ,24,383,3558,3941,photo
CompanyJ_3447,Clippers were popping champagne and calling out their doubters after clinching a playoff spot via LAClippers ,109,2068,13584,15652,video
CompanyJ_3448,Saquon Dame Jimmy and more Go behind the scenes with some of the best athletes in the world Take It There with TaylorRooks premieres April 3 ,141,146,679,825,video
CompanyJ_3449,Dirk inspired D Wade ,21,304,2973,3277,photo
CompanyJ_3450,MLB players and their Pokemon inspired haircuts ,48,200,1251,1451,video
CompanyJ_3451,Boogie knew the Pelicans would lose AD once they didn t re sign him As soon as all that goofy junk went down I knew per ChrisBHaynes ,133,366,2932,3298,photo
CompanyJ_3452,Pats tribute to Gronk might make you cry Via Patriots ,54,14953,56646,71599,video
CompanyJ_3453,The 25 best teams in NBA history timothyogoodman bodied this mural in the BR office ,84,203,1161,1364,video
CompanyJ_3454,Eagles fans are ruthless ,25,8012,39672,47684,photo
CompanyJ_3455,She risked it all to meet jamesdrodriguez via lauranicole_ ,59,424,3424,3848,video
CompanyJ_3456, Ja speaking facts ,19,1993,12473,14466,video
CompanyJ_3457,Shareef is back after recovering from heart surgery ,52,855,7185,8040,photo
CompanyJ_3458,MIke Conley has done it all for Memphis ,40,1170,6766,7936,photo
CompanyJ_3459,24 0 run by the Thunder Sheesh Via NBA ,39,2276,15542,17818,video
CompanyJ_3460,KD only missed one out of 13 shots tonight He is undeniably one of the smoothest in the game ,93,1590,11019,12609,video
CompanyJ_3461,Wizards bench starting giving CPR after Green s poster ,55,581,4007,4588,video
CompanyJ_3462,DBook has 30 at halftime ,25,1024,7813,8837,video
CompanyJ_3463,SPIDA UP Via NBA ,17,2006,14855,16861,video
CompanyJ_3464,D Book goes off for 50 in back to back nights ,46,2735,19709,22444,video
CompanyJ_3465,Manchester United confirm Ole Gunnar Solskjaer as their permanent manager via brfootball Under Ole so far 9 wins in last 13 league games Only one league defeat Reached UCL quarter finals ,187,477,3833,4310,photo
CompanyJ_3466,Devin Booker called it at halftime I m going for 50 ,52,843,8345,9188,photo
CompanyJ_3467,NFL HOFer Orlando Pace sits down with potential No 1 pick Nick Bosa to talk about the draft pressure and expectations You earn the respect by how you work PFHOF19 From B R x Ford ,179,61,412,473,video
CompanyJ_3468,29 years ago today MJ dropped a career high 69 points ,54,1866,9736,11602,video
CompanyJ_3469,Who s ready for more madness acura ,35,185,1370,1555,video
CompanyJ_3470,Of course The Sandlot makes the list rhyshoskins picks his Mt Rushmore of baseball movies ,90,59,425,484,video
CompanyJ_3471,She gave everybody the work via prepkitty Instagram ,52,21422,80944,102366,video
CompanyJ_3472,Baseball is back and so are its wildest fans via 15SOF ,55,263,1565,1828,video
CompanyJ_3473,He nutmegged a cow via akkadwalid iamabakarov_7 IG ,51,1497,10247,11744,video
CompanyJ_3474,16 years ago today Kobe went off in his last game against MJ Scored 55 points 42 points in the first half 9 of 13 from 3 ,121,3803,18145,21948,photo
CompanyJ_3475,Kid s control is just too good via marcoantonionf11 IG ,55,819,5944,6763,video
CompanyJ_3476,20 years ago today SHAQ threw down a dunk so mean Chris Dudley flung the ball at him Most disrespectful poster ever ,116,2507,10035,12542,video
CompanyJ_3477,Went to the mall to defend strangers via KushPapii ,51,5001,22886,27887,video
CompanyJ_3478,Dirk tries to tell Luka stories but he just responds You re so old via espn_macmahon ,85,1687,12793,14480,video
CompanyJ_3479,Tiger went lefty from his knees under a bush with his club upside down to make par WHAT via PGATOUR ,100,11741,61663,73404,photo
CompanyJ_3480,Manu Ginobili s jersey will be retired in San Antonio tonight Congrats to the Eurostep master ,94,13741,55617,69358,video
CompanyJ_3481,The youngest player ever with back to back 50 point games devinbook ,68,613,3999,4612,video
CompanyJ_3482,Jimmy Butler owes Antonio Brown 30K after betting he could stop AB from catching a pass from Russell Wilson per firstwefeast You re talking about the best receiver in the league and Russ at quarterback ,202,477,3523,4000,photo
CompanyJ_3483,What would Grant Hill tell his younger self 27 years after The Shot he d give the same advice Throw it to Laettner ,115,1051,4771,5822,video
CompanyJ_3484,Bron imitates a bottle of tequila via KingJames ,48,8428,45803,54231,video
CompanyJ_3485,Terance Mann said NAH MarchMadness ,35,199,1319,1518,video
CompanyJ_3486,Boban pulling up from deep like it s regular now ,49,3529,30449,33978,video
CompanyJ_3487,Tennessee playing give and go with shoes MarchMadness ,54,183,2236,2419,video
CompanyJ_3488,OH MY MarchMadness ,19,212,1637,1849,video
CompanyJ_3489,The Heat put together a tribute for Dirk and D Wade s rivalry via MiamiHEAT ,76,3619,15924,19543,video
CompanyJ_3490,What a sequence from Perkins before the half MarchMadness ,58,113,965,1078,video
CompanyJ_3491,Jamal Murray got this to fall ,30,374,3064,3438,video
CompanyJ_3492,The Spurs gave Manu a tribute video ahead of his jersey retirement ,67,2051,7912,9963,video
CompanyJ_3493,SHEESH MarchMadness ,20,975,5015,5990,video
CompanyJ_3494,Perfect cut Big finish MarchMadness ,36,119,938,1057,video
CompanyJ_3495,Schofield is COOKING MarchMadness ,34,287,1970,2257,video
CompanyJ_3496,Gonzaga is heading to the Elite 8 MarchMadness ,47,401,2157,2558,photo
CompanyJ_3497,THIS GAME MarchMadness ,23,755,3646,4401,video
CompanyJ_3498,Ryan Cline is ready for MARCH MarchMadness ,43,1381,7112,8493,video
CompanyJ_3499,Grant Williams saves the day MarchMadness ,42,183,1183,1366,video
CompanyJ_3500,PURDUE HANGS ON MarchMadness ,29,396,2356,2752,photo
CompanyJ_3501,Greek Freak is looking ready to enter playoff mode MetroByTMobile ,66,375,2421,2796,video
CompanyJ_3502,This shot summarizes this game so far MarchMadness ,51,166,1709,1875,video
CompanyJ_3503,Patty Mills CLUTCH 3 pointer gets Tim Duncan Manu and Tony Parker on their feet ,80,1432,8828,10260,video
CompanyJ_3504,Carsen Edwards has been leaving it all out there for the Boilermakers ,70,577,3324,3901,photo
CompanyJ_3505,TTU is ready for flight MarchMadness ,37,321,2197,2518,video
CompanyJ_3506, You got no more hair now but you had hair back in the day That was my favorite tonyparker cracks jokes and thanks Manu ahead of his jersey retirement ,151,1205,5771,6976,video
CompanyJ_3507, Without Manu there were no championships Coach Pop thanks Manu for making him a better coach and helping the Spurs win championships ,134,2895,15336,18231,video
CompanyJ_3508,Culver ENGLISH MarchMadness ,28,269,2257,2526,video
CompanyJ_3509,Flop of the tournament MarchMadness ,36,1173,6780,7953,video
CompanyJ_3510,Officially in the rafters Congrats Manu ,40,2314,12376,14690,video
CompanyJ_3511,Better get familiar with Jarrett Culver ,40,282,2496,2778,photo
CompanyJ_3512,Cavaliers are headed to the Elite Eight No 1 Virginia closes out a close one against No 12 Oregon 53 49 ,104,168,1444,1612,photo
CompanyJ_3513,Tim Duncan remembers Manu getting drafted and having no idea who he was ,72,1480,9287,10767,video
CompanyJ_3514,On this day in 1982 a freshman MJ hit a game winner in the national championship and changed his life That was the birth of Michael Jordan Before that I was Mike Jordan via MarchMadness ,186,3968,22370,26338,video
CompanyJ_3515,Pop knows ,10,451,4833,5284,photo
CompanyJ_3516,No nerves at all for Purdue last night cocacola ,48,559,4560,5119,video
CompanyJ_3517,The amount of Slovenian fans who stayed after Luka vs Dragic via luka7doncic ,77,844,10067,10911,video
CompanyJ_3518,Zlatan s advice via brfootball ,31,1312,8840,10152,photo
CompanyJ_3519,She worked on art projects for over a year and finally delivered them to her favorite player Giannis was touched via Pete Stauffer YouTube ,139,28844,158877,187721,video
CompanyJ_3520,17 0 14 KOs Model YouTube star Golden Boy promotions Main event Saturday night Is KingRyanG the next boxing superstar ,118,1062,6103,7165,video
CompanyJ_3521,Mike Conley is the last remaining player from the Grizzlies playoff teams He has the third longest active single team tenure He just has one question Now what ,159,152,1666,1818,photo
CompanyJ_3522,Coby White the next DLo NBADraftWass says the UNC guard reminds him of the first time All Star exxonmobil ,106,729,5306,6035,video
CompanyJ_3523,LeBron s response to the Lakers roster experiment of choosing playmaking over shooting was to make a loud raspberry sound in disapproval THBPBPTHPT per mcten ,158,366,1965,2331,photo
CompanyJ_3524,Time flies h t spurs ,21,8443,45416,53859,photo
CompanyJ_3525,Tiger is getting into prime Masters form with this eagle via PGATOUR ,69,2970,15108,18078,photo
CompanyJ_3526,The Warriors have already made 2B on their new arena and it hasn t even opened yet per business ,96,666,4340,5006,photo
CompanyJ_3527,Messi vs Ronaldo in the Champions League final via brfootball ,62,476,3330,3806,photo
CompanyJ_3528,Did Boban really yell KOBE ,27,5326,38371,43697,video
CompanyJ_3529,LeBron in warmups The accuracy via maxisnicee ,46,6441,34093,40534,video
CompanyJ_3530,HOF WR Tim Brown shares some insight with draft prospect Hunter Renfrow PFHOF19 AdamLefkoe From B R x Ford ,107,47,351,398,video
CompanyJ_3531,MSU coming out of the gates on MarchMadness ,44,146,1342,1488,video
CompanyJ_3532,Kyrie s handles just never disappoint ,38,1006,7142,8148,video
CompanyJ_3533,LSU can t stop Henry s mid range MarchMadness ,46,109,1056,1165,video
CompanyJ_3534,Kenny rocked his jersey for the UNC Auburn game today Chuck said his didn t fit via NBAonTNT ,93,1557,9387,10944,video
CompanyJ_3535,A Seventh Woods sighting MarchMadness ,38,494,3289,3783,video
CompanyJ_3536,Tremont handles gt gt ,22,211,1587,1798,video
CompanyJ_3537,McCormick doesn t need time to get to the bucket ,49,260,2143,2403,video
CompanyJ_3538,UNC facing biggest deficit in tourney and Roy Williams is not having it ,72,562,4687,5249,video
CompanyJ_3539,No weak stuff in MSU s paint MarchMadness ,42,145,1120,1265,video
CompanyJ_3540,Shaun Livingston put Bayless on a poster Steph literally collapsed ,67,626,4582,5208,video
CompanyJ_3541,DENIED MarchMadness ,20,464,2232,2696,video
CompanyJ_3542,THE BANK IS OPEN AUBURN CANNOT MISS MarchMadness ,49,201,1291,1492,video
CompanyJ_3543, COBY ,6,367,2453,2820,video
CompanyJ_3544,No 2 MSU is headed to the Elite 8 after knocking out No 3 LSU 80 63 Aaron Henry 20 PTS 8 REB 6 AST MarchMadness ,112,332,1395,1727,photo
CompanyJ_3545,All class from UNC players who show support for Chuma Okele s injury Sportsmanship means more than any competition MarchMadness ,128,1027,7122,8149,video
CompanyJ_3546,UNCLE DREW FOR THE WIN ,23,2476,11997,14473,video
CompanyJ_3547,Kiwi Step all 2019 ,19,315,2104,2419,video
CompanyJ_3548,Barkley s Tigers upset Kenny s Tar Heels 97 80 ,47,1225,5618,6843,photo
CompanyJ_3549,Coach Pearl is for his players just wants to hug Okeke talking about the injury MarchMadness ,93,1016,5410,6426,video
CompanyJ_3550,WATCH YA HEAD ZION MarchMadness ,32,830,4016,4846,video
CompanyJ_3551,Jabari on Gobert OH MY ,23,1674,9026,10700,video
CompanyJ_3552,There is no shot Zion cannot block MarchMadness ,48,3961,17828,21789,video
CompanyJ_3553,PJ IS BACK MarchMadness ,24,292,2222,2514,video
CompanyJ_3554, ROMO FOR COLLEGE BASKETBALL MarchMadness ,42,614,4826,5440,video
CompanyJ_3555,The ending of Warriors Timberwolves was the most ridiculous thing you ll see this regular season ,97,9083,35430,44513,video
CompanyJ_3556,AIR WILLIAMSON MarchMadness ,28,1954,7914,9868,video
CompanyJ_3557,In and out catches Zion slipping He still blocks it MarchMadness ,65,1856,9132,10988,video
CompanyJ_3558,No 1 Duke survives and is headed to the Elite 8 after 75 73 win over No 4 Virginia Tech Zion Williamson 23 PTS 5 REB 3 BLK MarchMadness ,136,1285,5427,6712,photo
CompanyJ_3559,Duke survives AGAIN barely MarchMadness ,40,1367,6648,8015,video
CompanyJ_3560,No 3 Houston vs No 2 Kentucky went back and forth all game Wildcats come out on top 62 58 advances to Elite 8 MarchMadness ,123,389,1771,2160,photo
CompanyJ_3561,Sequence of the game Tyler Herro 19 PTS 7 13 FG PJ Washington 16 PTS 6 8 FG ,76,783,4075,4858,video
CompanyJ_3562, ,1,2034,15845,17879,photo
CompanyJ_3563,LeBron moves to 28 0 all time vs Kemba ,39,4111,27974,32085,video
CompanyJ_3564,Welcome to Shaq s Fun House via SHAQ ,37,1867,11407,13274,video
CompanyJ_3565,vs UCF vs Virginia Tech Duke Just Barely ,41,385,3167,3552,photo
CompanyJ_3566,The dribble around the goalkeeper is too smooth via dawriplusksa ,65,2509,10613,13122,video
CompanyJ_3567,Two unreal goals to score in a debut game via MLS ,50,587,3514,4101,video
CompanyJ_3568,Danny Green is the halftime show now via hoodiesvintage IG ,59,711,6572,7283,video
CompanyJ_3569,PERFECT pass for the Rashford finish via NBCSportsSoccer ,57,434,2629,3063,video
CompanyJ_3570,Need someone to break this out in an NFL game via Jackcalhoun14 fiji jo30 IG ,77,1230,7731,8961,video
CompanyJ_3571,Messi reaches 40 goals all competitions for the TENTH consecutive season via brfootball ,88,924,3876,4800,photo
CompanyJ_3572, I GOT THE HORSES IN THE BACK LilNasX took over the ATLHawks hafltime show ,75,7206,33109,40315,video
CompanyJ_3573,31 goals in 29 league games Unstoppable ,40,526,2972,3498,photo
CompanyJ_3574,Tiger s been clutch he just took out Rory McIlroy via PGATOUR ,62,1049,6924,7973,photo
CompanyJ_3575,Brutal Kevin Love ,18,1424,15398,16822,photo
CompanyJ_3576,Manziel is done for the game after taking a blow from his own teammate via TheAAF ,82,349,2909,3258,video
CompanyJ_3577,Boogie is the captain now Welcome to Soul Plane via 1jordanbell ,64,475,3694,4169,video
CompanyJ_3578,Izzo can only think of one guy who can guard Zion Khalil Mack is a guy i look at maybe we could cover him per PeteThamel ,121,471,4227,4698,photo
CompanyJ_3579,LeBron James to sit out for rest of the season ,47,1825,11856,13681,photo
CompanyJ_3580, Shut down for the year More time to start recruiting ,54,1358,7635,8993,photo
CompanyJ_3581,Mike Tyson 2 0 Tackled him and left bite marks via DAZN_USA ,60,280,1465,1745,video
CompanyJ_3582,MAMBA MENTALITY Arike_O went off for 34 PTS 5 REB 4 AST 3 STL and the W via ncaawbb ,84,368,2395,2763,video
CompanyJ_3583,This will be LeBron s longest offseason since 2005 ,51,3031,22460,25491,photo
CompanyJ_3584,Davide Moretti tells his team why he plays basketball as his family sits in the back to surprise him The sophomore hasn t seen them in over a year MarchMadness ,160,455,3429,3884,video
CompanyJ_3585,The Zags and Red Raiders are FEELING IT early MarchMadness ,59,132,1218,1350,video
CompanyJ_3586,Get used to Bryce in Philly ripping dingers Via MLB ,52,1477,8778,10255,video
CompanyJ_3587,CROSSED MarchMadness ,21,344,2030,2374,video
CompanyJ_3588,Harden hit Bogdan with the finger wag after this step back ,59,564,3514,4078,video
CompanyJ_3589,Buckets on both ends non stop MarchMadness ,43,58,563,621,video
CompanyJ_3590,NYPD is investigating Kristaps Porzingis for alleged rape hours after 2018 ACL tear per TinaMoorereport ,104,2783,7144,9927,photo
CompanyJ_3591,D Lo holds it down in Brooklyn ,31,2399,14230,16629,video
CompanyJ_3592,D Lo went for 20 in the 3Q alone ,33,5209,27330,32539,video
CompanyJ_3593, FOLLOW YOUR SHOTS MarchMadness ,32,97,982,1079,video
CompanyJ_3594,BIG TIME THREE IN FRONT OF MOMMA MarchMadness ,46,181,1634,1815,video
CompanyJ_3595,Knicks fans showed love for D Wade s last game at the Garden OneLastDance ,74,595,4135,4730,video
CompanyJ_3596,BIG TIME MarchMadness ,22,146,1091,1237,video
CompanyJ_3597,Definition of HUSTLE MarchMadness ,34,548,2930,3478,video
CompanyJ_3598,Perkins with all the confidence in the world MarchMadness ,58,213,1621,1834,video
CompanyJ_3599,Perkins with the technical foul on the inbounds MarchMadness ,61,162,1072,1234,video
CompanyJ_3600,Texas Tech makes history ,25,1744,7531,9275,photo
CompanyJ_3601,50 PTS 11 REB 10 AST Another 50 point triple double for Harden ,63,2473,12338,14811,video
CompanyJ_3602,The Beard is a cheat code ,26,953,4486,5439,photo
CompanyJ_3603,Cline still hot from last game MarchMadness ,44,127,1297,1424,video
CompanyJ_3604,Jimmy Butler got booed in his first game back in Minneapolis Some of the 76ers players joined in as joke via malika_andrews ,124,430,3274,3704,video
CompanyJ_3605, College basketball s version of Stephen Curry right now Carsen Edwards is cooking MarchMadness ,96,372,3051,3423,video
CompanyJ_3606,Texas Tech going wild to Old Town Road in the locker room after reaching the Final Four Via TexasTechMBB ,105,12371,51376,63747,video
CompanyJ_3607,KAT sends Jimmy s shot to the bench ,36,340,3646,3986,video
CompanyJ_3608,Carsen and Guy trading buckets MarchMadness ,44,529,3088,3617,video
CompanyJ_3609,Mudiay asked D Wade for the jersey after the game Wade said I m already giving it away You hate to see it ,106,2645,22635,25280,video
CompanyJ_3610,Euro in transition too clean MarchMadness ,42,227,1921,2148,video
CompanyJ_3611,CARSEN EDWARDS IS FEELING IT MarchMadness ,42,1420,6767,8187,video
CompanyJ_3612,40 PIECE FOR CARSEN EDWARDS MarchMadness ,41,1988,8757,10745,video
CompanyJ_3613, UVA FORCES OT MarchMadness ,28,2138,8131,10269,video
CompanyJ_3614,Oh no Carsen MarchMadness ,26,269,2605,2874,video
CompanyJ_3615,An instant classic UVA is heading to the Final Four ,52,451,2420,2871,photo
CompanyJ_3616,What a tournament from Carsen Edwards ,38,2135,12442,14577,photo
CompanyJ_3617,Carsen Edwards MarchMadness run was incredible 26 PTS W 42 PTS W 29 PTS W 42 PTS L ,83,1778,10855,12633,photo
CompanyJ_3618,After dominating the UFC for seven years Demetrious Mighty Mouse Johnson makes his ONE Championship debut Watch now on BRLive ,126,95,736,831,photo
CompanyJ_3619,Mighty Mouse secured his first knock out with the guillotine choke via brlive ,78,361,2555,2916,video
CompanyJ_3620,D Lo followed Kyrie and posted a pic with him following Nets Celtics match up They ll both be hitting FA this summer ,117,746,8288,9034,photo
CompanyJ_3621,One year ago today Zlatan made his MLS debut like THIS via LAGalaxy ,68,1422,9041,10463,video
CompanyJ_3622,Okogie stepped under Curry without contesting the shot ,55,525,4556,5081,video
CompanyJ_3623,Crossed up his defender before hitting the bigs with an up and under Tough move kid via david_leblanc4 Instagram ,113,264,2629,2893,video
CompanyJ_3624,This Dodgers fan was PRESSED that he got pressured into throwing back his HR ball until they gave him a bill via 15SOF ,119,1676,9883,11559,video
CompanyJ_3625,He got dropped so hard No 15 stood up in the bleachers via j_dadzie Instagram ,78,4344,25783,30127,video
CompanyJ_3626,Perfect cross for the Firmino finish via NBCSportsSoccer ,57,269,2113,2382,video
CompanyJ_3627,On this day in 2015 Steph buckled CP3 with one of the meanest crossovers of his career ,87,4300,22237,26537,video
CompanyJ_3628,Perfect form on the header via MillieGoodwin23 ,47,556,4221,4777,video
CompanyJ_3629,Earlier this week Michael Irvin underwent tests for possible throat cancer Today it came back that he s cancer free ,116,8943,72093,81036,photo
CompanyJ_3630,WHAT A WAY TO GET A LAST MINUTE WINNER via NBCSportsSoccer ,59,932,4463,5395,video
CompanyJ_3631,Imagine moshing with Shaq NSFW via YourEDM ,43,1122,6669,7791,video
CompanyJ_3632,Katie Lou Samuelson was automatic today 29 PTS 7 12 3PT No 2 UConn beats No 1 Louisville to advance to their 12th straight Final Four via ncaawbb ,146,649,3271,3920,video
CompanyJ_3633,Vince doesn t have time for these kids ,39,638,4901,5539,video
CompanyJ_3634,Montgomery Herro MarchMadness ,30,120,1110,1230,video
CompanyJ_3635,Doesn t get better than Carlos Santana kissing Terry Francona s bald head for good luck Via Cut4 ,97,378,3457,3835,video
CompanyJ_3636,DLo has proved himself ,23,2040,14110,16150,photo
CompanyJ_3637,TRAE YOUNG COLD BLOODED Two go ahead buckets in the last six seconds ,69,1977,9977,11954,video
CompanyJ_3638,Bryce Brown is dancing on the three point line MarchMadness ,60,335,2839,3174,video
CompanyJ_3639,LSU track team is built different via FloTrack ,47,3735,22858,26593,video
CompanyJ_3640,Coach Cal drawing up gems MarchMadness ,39,190,1726,1916,video
CompanyJ_3641,Chuma Okeke pulled up to the game from the hospital to support Auburn in the 2nd half He tore his ACL in their last matchup in the Sweet 16 ,140,749,6566,7315,video
CompanyJ_3642,Auburn comes up with two HUGE blocks to go to OT marchmadness ,62,181,1739,1920,video
CompanyJ_3643,A first for Auburn ,19,1526,7425,8951,photo
CompanyJ_3644,Zion looked bouncy in warmups MarchMadness ,43,1843,12651,14494,video
CompanyJ_3645,CHRISTIAN YELICH FOR THE WIN via fswisconsin ,45,759,4745,5504,video
CompanyJ_3646,OH MY MCQUAID MarchMadness ,27,1038,4730,5768,video
CompanyJ_3647,Zion off the dribble TOO EASY ,30,622,5841,6463,video
CompanyJ_3648,Cam RJ Duke back in control MarchMadness ,41,395,3032,3427,video
CompanyJ_3649,With loss to the Mavs OKC remains in the 8th spot with 5 games to go They d play the Warriors in the 1st round if playoffs started today ,137,609,4863,5472,photo
CompanyJ_3650,Zion almost hit his head on the glass ,38,1914,14681,16595,video
CompanyJ_3651,The rebound The 3 ball Zion is doing EVERYTHING right now MarchMadness ,71,493,3550,4043,video
CompanyJ_3652,McQuaid making up moves mid air MarchMadness ,45,1370,6947,8317,video
CompanyJ_3653,This was a made basket MarchMadness ,36,259,2294,2553,photo
CompanyJ_3654, POSTER ALERT ,14,1009,6171,7180,video
CompanyJ_3655,RJ CLUTCH MarchMadness ,23,343,2487,2830,video
CompanyJ_3656,Zion is too tough Duke up 3 with 1 33 to go MarchMadness ,57,135,1510,1645,video
CompanyJ_3657,Sparty knocks Zion and Duke out of the tourney ,47,5880,20779,26659,video
CompanyJ_3658,MSU escapes Duke after RJ Barrett s missed FT Another wild ending ,66,1573,7515,9088,video
CompanyJ_3659,The Final Four is set ,22,1038,5404,6442,photo
CompanyJ_3660,Michigan State to everyone who had Duke winning it all ,55,4560,18006,22566,video
CompanyJ_3661,Unforgettable season for Zion and RJ as they led Duke to ACC championship Elite 8 ZION Wayman Tisdale Award ACC POY amp ROY Consensus First Team All American 22 6 PPG 8 7 RPG 2 1 APG 1 8 BLK RJ Consensus First Team All American 22 7 PPG 7 6 RPG 4 3 APG ,253,1433,7103,8536,photo
CompanyJ_3662,Ice Trae called game ,21,357,2570,2927,video
CompanyJ_3663,Pop got ejected following this questionable call ,49,770,5186,5956,video
CompanyJ_3664,Tom Izzo had the MSU locker room LIVE after the win via MSU_Basketball ,71,1281,7365,8646,video
CompanyJ_3665,Xander Bogaerts and Red Sox are finalizing a 7 year 132M contract extension per JeffPassan ,91,485,2990,3475,photo
CompanyJ_3666,Bryce Harper sent this one to the via MLB ,42,1278,8259,9537,video
CompanyJ_3667,Athletes offer their support and condolences to Nipsey and his family ,70,3917,21929,25846,video
CompanyJ_3668,Jokic got tossed almost immediately after arguing a foul call ,62,300,2739,3039,video
CompanyJ_3669,Nipsey was in Anaheim yesterday cheering on Texas Tech in the Elite 8 Prayers to him and his family via JazzAmari ,114,11156,61021,72177,video
CompanyJ_3670,Oracle Arena played Nipsey KD and Draymond paid their respects via loganmmurdock ,81,8631,35361,43992,video
CompanyJ_3671,Rooney really scored from that angle via FOXSoccer ,51,2927,13932,16859,video
CompanyJ_3672,Lou Williams on Nipsey s death I haven t even been able to even digest it via AndrewGreif ,90,1413,10696,12109,video
CompanyJ_3673,Sean Taylor was one of a kind The famed No 21 would have been 36 today via NFL ,79,14490,43755,58245,photo
CompanyJ_3674,The Pope puts the Messi hype in perspective via brfootball ,59,816,6912,7728,photo
CompanyJ_3675,Nobody is safe Nothing is guaranteed GameOfZones premieres 4 11 on the B R App ,79,959,3460,4419,video
CompanyJ_3676,A sharpshooter named Ben Simons just tied this season s single game 3 point record 10 in the Spanish ACB League via ACBCOM ,123,932,7048,7980,video
CompanyJ_3677,Kap s back on the field with some talented receivers in Saquon and Offset HunchoDay ,84,2292,14414,16706,video
CompanyJ_3678,Baby Bryce is on the way via bryceharper3 ,42,279,3156,3435,photo
CompanyJ_3679,A tournament weekend for the history books Wendys ,50,84,1352,1436,link
CompanyJ_3680, OBJ Cleveland Brown ,21,3188,19676,22864,photo
CompanyJ_3681,LaMelo is heading overseas ,27,768,4494,5262,photo
CompanyJ_3682,Defenders didn t stand a chance via errainadir IG ,50,649,4599,5248,video
CompanyJ_3683,Last season s ROY gives his vote ,33,1455,9982,11437,photo
CompanyJ_3684,Still one of the best April Fools Day jokes They told Shaq we ranked him ninth on the all time centers list and he almost tore the set up via NBAonTNT ,151,15350,67216,82566,video
CompanyJ_3685,Kentucky FOR LIFE John Calipari has agreed to a lifetime deal that ensures he finishes career with the Wildcats ,112,1784,8600,10384,photo
CompanyJ_3686, _ajawilson22 ,14,513,2309,2822,photo
CompanyJ_3687, You gotta get the back Luka rolled up with the all denim fit vs Philly Via dallasmavs ,87,1152,8573,9725,video
CompanyJ_3688,LeBron will have a full length court built on the set of Space Jam 2 to train while filming MJ did the same thing as he prepared for his second three peat via joevardon ,169,2320,14624,16944,photo
CompanyJ_3689,Vanderbilt is zeroing in on G League coach and former NBA All Star Jerry Stackhouse to become their next head coach per GoodmanHoops ,133,284,1725,2009,photo
CompanyJ_3690,D Lo had the Nets bench searching for this floater ,51,1185,8678,9863,video
CompanyJ_3691,Kyrie saved it Tatum dished it Hayward finished it ,51,11574,59733,71307,video
CompanyJ_3692,Thon cleared him ,17,661,7113,7774,video
CompanyJ_3693,Kyrie had to dap up DJPaulyD mid game via NBCSCeltics ,54,750,4723,5473,video
CompanyJ_3694,D Angelo scored on Bledsoe and let him hear about it ,53,1604,11970,13574,video
CompanyJ_3695,Robinson wasn t feelin it ,26,1044,7712,8756,video
CompanyJ_3696,Giannis might not even need a jumper ,37,1119,11897,13016,video
CompanyJ_3697,Ball went out off Jarrett Allen s afro ,39,133,1442,1575,video
CompanyJ_3698,Painted TheRock with a dumbbell and it turned out unbelievable via bou_bou_design_ IG ,86,10009,47796,57805,video
CompanyJ_3699,Manu got Timmy good Classic AprilFoolsDay via shaqtin ,54,743,5383,6126,video
CompanyJ_3700,Kemba dropped 38 in the second half and finished with 47 but Charlotte still lost ,82,680,5726,6406,video
CompanyJ_3701,The dunk The swat The stare This Josh Jackson sequence ,55,2927,20309,23236,video
CompanyJ_3702, Rest in heaven D Wade Kawhi Montrezl and others honored Nipsey brkicks ,72,1431,9794,11225,photo
CompanyJ_3703,This is awesome Via kevinlove ,30,727,7516,8243,photo
CompanyJ_3704,6 4 in 6th grade via jamal_brown2025 IG ,40,1337,12128,13465,video
CompanyJ_3705,New faces Same drama The Champions Season 2 is coming soon ,59,84,740,824,photo
CompanyJ_3706,With 2 HRs in 3 games everything is going right for Harper in Philly But how well will the 330M man coexist with MLB s most intense manager ,140,47,588,635,photo
CompanyJ_3707,This time she pretended to flinch via MLB ,42,7884,55904,63788,video
CompanyJ_3708,Zion and RJ are the first freshman teammates to make the AP All American first team since Boogie and Wall ,106,2189,15341,17530,photo
CompanyJ_3709,The Champions League so far One week til the quarterfinals begin ,65,169,1438,1607,video
CompanyJ_3710,Oh really SHAQ ,15,1322,10081,11403,photo
CompanyJ_3711,Nuggets Melo gt gt gt ,22,1707,9212,10919,photo
CompanyJ_3712,Channing Frye s accepting all challengers in retirement I m rich I m a champion I m 35 and retiring and I m living a great life So if you think I suck I ll see you at LA Fitness in a year motherf ker per joevardon ,214,2415,16743,19158,photo
CompanyJ_3713,NHL All Star Seth Jones grew up around the NBA his dad played on the Wizards and Jordan gave Seth game worn shoes But he chose hockey I just loved to skate ,156,58,570,628,photo
CompanyJ_3714,Legend and young legend via brfootball ,39,896,7145,8041,photo
CompanyJ_3715,Zion RJ Ja Grant and Cassius ,29,2193,14470,16663,photo
CompanyJ_3716,80 Villarreal 4 2 Barca 90 Villarreal 4 3 Barca Messi 93 Villarreal 4 4 Barca Suárez What an ending ,100,603,4630,5233,photo
CompanyJ_3717,Kap Gucci and other stars showed out at QuavoStuntin s HUNCHODay ,65,494,1979,2473,video
CompanyJ_3718,Nats fans were pretty happy about this strikeout via MLB ,57,493,2948,3441,video
CompanyJ_3719,Russ holding it down for Nipsey tonight via okcthunder ,55,14428,62277,76705,video
CompanyJ_3720,Kuz helping Bron put his chain on ,34,557,4304,4861,video
CompanyJ_3721,Russ in a zone tonight He s got 10 assists and 7 rebounds in the first quarter ,79,1304,8343,9647,link
CompanyJ_3722,Russ is fed up with Lance ,26,2238,13110,15348,video
CompanyJ_3723,Russ was on one tonight 20 PTS 20 REBS 21 ASTS Sheesh ,54,7712,33871,41583,video
CompanyJ_3724,Russ is the first player since Wilt to record a 20 20 20 game ,62,2783,12331,15114,photo
CompanyJ_3725, Why Not Make History ,22,8242,46498,54740,photo
CompanyJ_3726,Bryce Harper hit a 458 foot bomb against his former team via MLB ,65,1393,8142,9535,video
CompanyJ_3727,The Marathon Continues ,23,4316,14424,18740,photo
CompanyJ_3728,This Bryce bat flip via MLB ,28,3021,18843,21864,video
CompanyJ_3729,Newest Raider AB loving the show in Oakland ,44,257,2884,3141,video
CompanyJ_3730,Lonzo Ball plans to sue former BBB co founder Alan Foster for allegedly conning them for more than 1 5M per TMZ ,112,1229,9131,10360,photo
CompanyJ_3731, therealjrsmith s new ink in honor of Nipsey ,45,1750,12011,13761,photo
CompanyJ_3732,20 20 20 Y all better ride for me Nipsey ,41,5626,34647,40273,photo
CompanyJ_3733,One year ago today Ronaldo scored THIS against Juventus via brfootball ,71,1323,6807,8130,video
CompanyJ_3734,No one could punk KD Russ and Harden after how hard they went at each other in practice We not calling no fouls we hacking we throwing elbows per PlayersTribune ,161,555,3876,4431,photo
CompanyJ_3735,Zion nearly broke the backboard via SLAMonline ,47,1454,8795,10249,video
CompanyJ_3736,For the first time ever Messi passes Ronaldo to become top scorer in Europe s top five leagues via brfootball ,110,307,1717,2024,photo
CompanyJ_3737, I m gonna be me whether you like it or not I don t give a f k JimmyButler gets real on the premiere of Take It There with TaylorRooks ,135,457,1964,2421,video
CompanyJ_3738,Projected No 2 pick Ja Morant will declare for the 2019 NBA draft today per ShamsCharania ,90,2764,20903,23667,photo
CompanyJ_3739,Cole Anthony and Vernon Carey are taking over NYC as the top ranked H S basketball teams play for a National Title ,115,241,1656,1897,video
CompanyJ_3740,Don t assume the Knicks or Lakers are going to win free agency Execs and scouts say the Nets and Clippers are the better destinations ,134,256,1462,1718,photo
CompanyJ_3741,First 20 20 20 since Wilt Russ did it real big last night in honor of Nipsey Hussle ,84,1600,9131,10731,video
CompanyJ_3742, 95 major trophies between them Two of Europe s wealthiest clubs Last two meetings were in the Champions League final In one week Manchester United and Barcelona face off in the UCL quarterfinals via brfootball ,211,827,4451,5278,photo
CompanyJ_3743,Tottenham s new stadium looks incredible and includes Europe s longest bar via brfootball ,90,496,3262,3758,photo
CompanyJ_3744,Drizzy was giving Tory buckets via Drake ToryLanez ,51,1157,6543,7700,video
CompanyJ_3745,Being far from home for the first time almost made JimmyButler quit basketball forever at Marquette The 76ers star opens up about that and more in the premiere of Take It There with TaylorRooks ,194,93,650,743,video
CompanyJ_3746,Manny s 1st HR as a Padre Many more to come via FOXSportsSD ,60,202,1755,1957,video
CompanyJ_3747,20 20 20 for Nipsey ,20,26647,74808,101455,video
CompanyJ_3748,DeAndre is the teammate everybody needs ,40,820,6352,7172,video
CompanyJ_3749,Kawhi was fed up ,17,2365,14766,17131,video
CompanyJ_3750,D Wade went vintage on Kyrie ,29,545,4019,4564,video
CompanyJ_3751,Beal has a new pregame routine after last night via WashWizards ,64,4777,32140,36917,video
CompanyJ_3752,Dropped and dunked on in the same sequence ,43,350,2372,2722,video
CompanyJ_3753,Reggie Jackson s step back was filthy ,38,852,3702,4554,video
CompanyJ_3754,Kyrie s footwork needs to be taught in classrooms ,50,4390,27108,31498,video
CompanyJ_3755,Pop got tossed 1 03 min into the game ,38,907,4606,5513,video
CompanyJ_3756,Felicio wyd ,12,121,1125,1246,video
CompanyJ_3757,Sixers couldn t buy a free throw and Justin Anderson was not impressed ,71,930,8052,8982,video
CompanyJ_3758, Ice Trae had himself a game against the 76ers 33 PTS 12 AST 7 REB ,67,1495,8480,9975,video
CompanyJ_3759,Cardiac Kemba dropped 21 PTS in the 4Q against the Pelicans to keep the Hornets playoff hopes alive ,100,411,2653,3064,video
CompanyJ_3760,OH MY MALIK ,12,1084,6762,7846,video
CompanyJ_3761,Pop had to ask Mike Malone questions about the game since he was ejected with 47 minutes left to go via HarrisonWind ,117,1744,10345,12089,video
CompanyJ_3762,CP3 from 3 4 of the court Everything going for the Rockets tonight ,67,1668,9642,11310,video
CompanyJ_3763,Trae making his case for ROY ,29,753,5580,6333,photo
CompanyJ_3764,Raheem Sterling paid for 550 children from his old school to watch Manchester City s FA Cup semifinal at Wembley per MailSport Incredible sterling7 ,148,268,2095,2363,photo
CompanyJ_3765,Luka from the bench via alvina23 IG ,36,7074,47122,54196,video
CompanyJ_3766,Warriors vs Lakers tonight LeBron 3 titles in his career KD 2 titles in his career MyStraightTalk ,98,1599,20907,22506,video
CompanyJ_3767,Rodgers froze out receivers who listened to coaches over him McCarthy skipped meetings for massages TyDunne talked to dozens of former players coaches and personnel about the feud that tore the Packers apart ,208,1399,4329,5728,photo
CompanyJ_3768,Aaron Rodgers hated Mike McCarthy from the moment he got hired And it only got worse from there ,96,1094,4143,5237,photo
CompanyJ_3769,From Boogie stare downs to Giannis sky alleys these guys took flight this season McDonalds ,91,390,2221,2611,video
CompanyJ_3770,Another summer of those famous Nigeria shirts Juventus nellaekroth ranks the top 10 kits for the 2019 FIFAWWC via brfootball ,125,44,308,352,video
CompanyJ_3771, Football needs to be your main thing Let that do the talking HOF Terrell Davis gives NFL draft prospect Josh Jacobs some all pro advice PFHOF19 From B R x Ford ,161,34,319,353,video
CompanyJ_3772, When is it going to become the norm instead of the exception Notre Dame HC Muffett McGraw speaks on the lack of women in leadership roles in sports and the workforce via ncaawbb ,179,258,1187,1445,video
CompanyJ_3773,Curry getting all types of questions about his eye revelation via MarkG_Medina ,79,967,6823,7790,video
CompanyJ_3774,This A s fan got played by the Red Sox fan via 15SOF ,53,117,1133,1250,video
CompanyJ_3775,Devin Booker will be shut down for Suns last three games due to ankle sprain per ShamsCharania ,95,216,2538,2754,photo
CompanyJ_3776,Greg Oden became an OSU student coach after injuries ruined his career and made him an NBA draft bust The former center on his redemption story ,144,740,4599,5339,video
CompanyJ_3777,Nipsey gets memoralized on a wall next to LeBron and Snoop Dogg via Jim_ICE ,76,2218,11677,13895,photo
CompanyJ_3778,LeBron has been unable to close deals with top players that he wants for Space Jam 2 per WindhorstESPN ,103,1250,8747,9997,photo
CompanyJ_3779,Bench celebrations have taken over the NBA this year ,53,1366,6930,8296,video
CompanyJ_3780,New Phillie Bryce Harper rings the bell for the 76ers ,54,255,2113,2368,video
CompanyJ_3781,Embiid and Bledsoe are bringing the playoff intensity ,54,2551,14670,17221,video
CompanyJ_3782,Bryce Harper Carson Wentz and Rhys Hoskins showing their support for the 76ers Truly the City of Brotherly Love ,112,918,6692,7610,video
CompanyJ_3783,JoJo gave Redick s elbow a kiss after a collision ,50,557,5942,6499,video
CompanyJ_3784,Giannis met Joel at the PEAK ,29,3457,17465,20922,video
CompanyJ_3785,100 USWNT goals for alexmorgan13 via brfootball ,48,246,1616,1862,photo
CompanyJ_3786,Alex Morgan s 100th international goal via FOXSoccer ,53,686,3997,4683,video
CompanyJ_3787,The battle of the East s elite is going down to the wire ,57,286,2329,2615,video
CompanyJ_3788,Bucks take down the 76ers and clinch home court advantage throughout the playoffs Greek Freak 45 PTS 13 REB 6 AST 5 BLK ,120,1140,6474,7614,photo
CompanyJ_3789,Steph can see clearly NOW ,26,3806,17374,21180,video
CompanyJ_3790,Greek Freak blocked Joel Embiid FOUR times tonight ,51,2697,13147,15844,video
CompanyJ_3791,Will Giannis finish the season with an MVP like Kareem did ,59,443,3477,3920,photo
CompanyJ_3792,Bet you didn t know Alex Caruso got BOUNCE ,43,1648,9252,10900,video
CompanyJ_3793,Just two of the NBA s best players chatting ,44,3804,29070,32874,video
CompanyJ_3794,Lakers completely disrespect Boogie s jumper on back to back possessions ,73,692,5253,5945,video
CompanyJ_3795,LeBron pulled up in the Nipsey shirt ,37,626,5757,6383,photo
CompanyJ_3796,This was incredible StephenCurry30 ,35,523,4853,5376,photo
CompanyJ_3797, I m telling you this movie will be better than the original Just think about it ,81,2501,20066,22567,photo
CompanyJ_3798,HOFer Kevin Greene has some wisdom for draft prospect Mack Wilson from one linebacker to another Play with your heart man PFHOF19 From B R x Ford ,146,41,271,312,video
CompanyJ_3799,Brutal via Bindella03 ,22,317,1851,2168,video
CompanyJ_3800,In his search for Lonzo s new agent LaVar is inquiring whether they have the power to pair his three sons on the same NBA team multiple agents uninterested per ChrisBHaynes ,173,337,2613,2950,photo
CompanyJ_3801,Bulls guard Walt Lemon Jr wears No 25 because he grew up in Chicago idolizing D Rose I want to be just like that guy You can see the influence on his game ,155,7065,43970,51035,video
CompanyJ_3802,Last year Donte DiVincenzo boosted his draft stock with a historic 31 points in the national championship Who will be this year s hero CaesarsPalace ,149,119,1217,1336,video
CompanyJ_3803,Jimmy s face D Wade s prayer Harden to beat GSW Best buzzer beaters from this season McDonalds ,95,927,4619,5546,video
CompanyJ_3804,Melo teaching his son the art of the jab step via lala ,55,1838,11375,13213,video
CompanyJ_3805, TheAdamsEra unveiled some from jumpman23 to commemorate the nyjets new uniforms via BRKicks ,93,218,1543,1761,photo
CompanyJ_3806,Once UConn head coach Geno Auriemma told Napheesa Collier in practice That s why you ll never play Now Collier is an All American has earned a fan in Candace Parker and is ready to lead UConnWBB to another national title ,221,116,676,792,photo
CompanyJ_3807,The detail on this Kobe tattoo via stevebutchertattoos IG ,58,2036,11813,13849,photo
CompanyJ_3808,Zion Williamson dominates to win AP Men s Player of the Year 59 of 64 votes ,76,667,4609,5276,photo
CompanyJ_3809,Steph really can make any shot via warriors ,44,688,5203,5891,video
CompanyJ_3810,UPS man smoked em then dabbed on em via brendoextendo ,54,3590,20556,24146,video
CompanyJ_3811,Courtside dimes from CP3 Ridiculous angle via watchthethrone916 IG ,67,6049,32012,38061,video
CompanyJ_3812,Kyrie s taken ankles vs every team in the league via NBA ,57,10203,35640,45843,photo
CompanyJ_3813,Mo Salah on a huge solo run for his 50th Premier League goal for Liverpool via NBCSportsSoccer ,95,1511,6045,7556,video
CompanyJ_3814,D Wade says he will try therapy to ease transition to post NBA life per Rachel__Nichols ,88,582,5395,5977,photo
CompanyJ_3815,The Clippers are the underdog nobody wants to face in the 1st round HowardBeck ,79,272,1647,1919,video
CompanyJ_3816,Kobe keeping it real ,21,3397,16307,19704,photo
CompanyJ_3817,Giannis is unstoppable ,23,3052,15966,19018,photo
CompanyJ_3818, Get you a crew that lifts you up like this via calvin_baldwin IG ,66,463,3282,3745,video
CompanyJ_3819,DeMarcus Lawrence and the Cowboys are going to have a 5 year extension worth more than 100M per RapSheet MikeGarafolo ,118,1419,5089,6508,photo
CompanyJ_3820,Russ averages a triple double for the 3rd straight season Never done before in NBA history WhyNot ,98,7803,27968,35771,photo
CompanyJ_3821,Showtime Harden ,16,335,2105,2440,video
CompanyJ_3822,D Rose joined the broadcast ,28,665,4921,5586,video
CompanyJ_3823,Dame is rocking Game of Zones inspired 5s tonight called Dame of Zones vs the Nuggets GameOfZones Season 6 drops 4 11 exclusively on the BR app ,144,158,1003,1161,photo
CompanyJ_3824,JEREMY LAMB BEATS THE RAPTORS AGAIN ,36,5839,30651,36490,video
CompanyJ_3825,Jake Bauers riding up to his at bat bumping that LilNasX via Cut4 ,66,779,4551,5330,video
CompanyJ_3826,Goodness Russ What a sequence ,30,3792,15747,19539,video
CompanyJ_3827,Don t jump with Tatum via NBA ,30,1694,10739,12433,video
CompanyJ_3828,Déjà vu ,8,315,2986,3301,photo
CompanyJ_3829,Draymond Green gave Nick Young his championship ring before the game ,69,1072,7625,8697,video
CompanyJ_3830,What a year for sabrina_i20 as she led OregonWBB to its 1st Final 4 P12 POTY NCAA record 7 triple doubles in a season Broke NCAA all time men s and women s triple double record Led Ducks to 2nd straight P12 regular season title Stats 19 9 PPG 8 2 APG 7 4 RPG ,259,267,1646,1913,photo
CompanyJ_3831,Lou pulls up from DEEP on his former team ,42,135,1797,1932,video
CompanyJ_3832,Wade or Pierce You decide D Wade 16 seasons 3 Rings 13x All Star 8 All NBA teams 2x first team 3 All Defense teams Paul Pierce 19 seasons 1 Ring 10x All Star 4 All NBA teams 0x first team 0 All Defense teams ,208,4676,22849,27525,photo
CompanyJ_3833,Bron was hyped on ACFresh21 s career night Caruso finished with 32 PTS 10 REB 5 AST ,84,556,4186,4742,video
CompanyJ_3834,Russ is writing history this season First player ever to average 3 straight seasons with a triple double First 20 20 20 game since Wilt Held longest ever streak with a triple double 11 games Why not ,199,5613,27456,33069,photo
CompanyJ_3835,Justise Winslow put KAT in a headlock after a hard foul Towns was not pleased ,78,629,5295,5924,video
CompanyJ_3836,3 goals in the last 2 games Can t stop ibra_official via LAGalaxy ,66,84,749,833,video
CompanyJ_3837,Sister Mary Jo s still got it via sistermojo12 MCHS_Baseball0 ,62,2753,15482,18235,video
CompanyJ_3838,Terrance Ferguson was in awe of Russ pass ,42,929,6662,7591,video
CompanyJ_3839,Alex Caruso dropped a career high 32 last night Where d he come from 8 PPG at Texas A amp M Scored over 25 once Undrafted Waived by OKC Summer League star Tore up the G League First Lakers two way contract ,206,2048,16201,18249,photo
CompanyJ_3840,Lewandowski chips the goalkeeper too easy via FOXSoccer ,56,386,2049,2435,photo
CompanyJ_3841,She just wanted to watch Donovan Mitchell hoop before going to bed via MitchTulane ,83,1260,8047,9307,video
CompanyJ_3842,Bayern is cooking so Gnabry brought out the Harden celebration ,63,256,1775,2031,photo
CompanyJ_3843,At its first Final Four in 35 years Virginia is ready to rewrite its March Madness legacy ,90,70,573,643,video
CompanyJ_3844,Imagine going one on one with an elephant via rene_casselly IG ,63,5706,29048,34754,video
CompanyJ_3845,Zaire not tolerating any disrespect to his dad s legacy ,56,8462,49870,58332,photo
CompanyJ_3846,vs Villarreal 90 Messi goal 93 Suarez goal vs Atleti 85 Suarez goal 86 Messi goal Late drama ,93,297,1697,1994,photo
CompanyJ_3847, I never won a championship I gotta live with that forever You guys got a chance Chuck reminding Auburn what s in front of them via MarchMadness ,145,974,6705,7679,video
CompanyJ_3848,Messi now has the most La Liga wins ever via brfootball ,56,472,2677,3149,photo
CompanyJ_3849,ᶦ ᵍᵒᵗ ᵗʰᵉ ʰᵒʳˢᵉˢ ᶦⁿ ᵗʰᵉ ᵇᵃᶜᵏ LilNasX is riding with Texas Tech today TexasTechMBB ,82,345,2501,2846,video
CompanyJ_3850,The Final Four is here Acura ,29,132,856,988,video
CompanyJ_3851,Not today MarchMadness ,23,90,839,929,video
CompanyJ_3852,Go ahead and lob it up UVA Auburn starting to warm up MarchMadness ,67,53,603,656,video
CompanyJ_3853,Express yourself MarchMadness ,30,120,1135,1255,video
CompanyJ_3854,DON T TRY DE ANDRE HUNTER MarchMadness ,39,258,2095,2353,video
CompanyJ_3855,Ty Jerome will not be denied MarchMadness ,42,140,1120,1260,video
CompanyJ_3856,WE VE GOT A GAME MarchMadness ,30,252,1498,1750,video
CompanyJ_3857,Virginia Virginia ing ,22,126,753,879,photo
CompanyJ_3858,Chuck s reaction MarchMadness ,30,362,2406,2768,video
CompanyJ_3859,FOUL MarchMadness ,18,641,3130,3771,video
CompanyJ_3860,Virginia is headed to the National Championship ,48,584,2009,2593,photo
CompanyJ_3861,KYLE GUY WINS IT AT THE LINE MarchMadness ,42,1545,7720,9265,video
CompanyJ_3862,Did the refs miss one MarchMadness ,35,3056,10427,13483,video
CompanyJ_3863,VIRGINIA LAST YEAR First No 1 seed to lose to a No 16 seed VIRGINIA THIS YEAR One game from being national champions MarchMadness ,130,516,2932,3448,photo
CompanyJ_3864,March comes at you fast ,24,13104,59235,72339,photo
CompanyJ_3865,Paul Pierce looking at the TL debate he and D Wade ,51,17946,54670,72616,video
CompanyJ_3866,Oh my MarchMadness ,19,455,2607,3062,video
CompanyJ_3867,They thought Auburn won via MasterTes ,38,900,4450,5350,video
CompanyJ_3868,Nothing weak inside MarchMadness ,33,223,1606,1829,video
CompanyJ_3869,Through tragedy and transfers Tariq Owens made it to the Final Four In his darkest moment Owens had to choose 10 or 10 million MirinFader ,138,152,900,1052,photo
CompanyJ_3870,Mooney is FEELING IT Mahomes is loving it MarchMadness ,55,672,4284,4956,video
CompanyJ_3871,Have yourself a game Mooney MarchMadness ,41,188,1464,1652,video
CompanyJ_3872,Tariq Owens gets a huge applause as he jogs back to the bench MarchMadness ,75,400,3812,4212,video
CompanyJ_3873,Better late than never Culver CLUTCH MarchMadness ,50,481,2657,3138,video
CompanyJ_3874,Mahomes is ready for a Texas Tech championship run MarchMadness ,64,1305,11002,12307,video
CompanyJ_3875,Texas Tech is headed to the National Championship MarchMadness ,63,1669,6758,8427,photo
CompanyJ_3876,What a journey for Matt Mooney Took trains buses 90 min each way in HS Played at Air Force and S D before transferring to Texas Tech Broke fibula in bike accident Lived in an off campus house with a broken couch Dropped 22 PTS in Final 4 vs MSU h t GregBishopSI ,262,1705,12335,14040,photo
CompanyJ_3877,The National Championship is Set ,33,1368,7273,8641,photo
CompanyJ_3878,Sabrina has unfinished business ,32,306,2684,2990,photo
CompanyJ_3879,19 year old Matheus Cunha showing off his FIFA like skills via FOXSoccer ,73,1237,6363,7600,photo
CompanyJ_3880,The ref just casually breaks out the Eastbay dunk via cadenreynolds_ Instagram ,79,13187,80499,93686,video
CompanyJ_3881,Made a makeshift hoop at work so they could ball via rael_cuaresma Twitter ,75,1552,12109,13661,video
CompanyJ_3882,In 2006 Becky Lynch had no interest from the WWE and stepped away from wrestling for seven years 13 years and a few Stone Cold comparisons later The Man is improbably headlining WrestleMania s first all women main event ,220,301,1569,1870,photo
CompanyJ_3883,Zion Williamson wins Naismith Player of the Year KD and AD were the only other freshman to do it ,97,2913,19138,22051,photo
CompanyJ_3884,UFC barrier breaker All time dominant athlete First woman to headline WrestleMania Ronda Rousey s been making history all her life ,131,147,820,967,video
CompanyJ_3885,16 years ago today Melo and Gerry McNamara led Syracuse to a national title as freshmen ,88,3812,15917,19729,video
CompanyJ_3886,AB with some harsh words for JuJu ,34,1104,6062,7166,photo
CompanyJ_3887,Kevin Love checked in wearing Channing Frye s college jersey via cavs ,70,3406,30349,33755,video
CompanyJ_3888, The Sandlot was released 26 years ago today CLASSIC ,53,8032,28408,36440,photo
CompanyJ_3889,AB amp JuJu at odds ,20,587,3975,4562,photo
CompanyJ_3890,He missed from THE GOAL LINE via beINSPORTSUSA ,47,815,4069,4884,video
CompanyJ_3891,Ryan Shazier continues to amaze ,32,5115,30744,35859,video
CompanyJ_3892,Richard Jefferson criticizes the Warriors for not running it back after the 2016 Finals They were like We re gonna go get our big brother ,138,5577,25539,31116,video
CompanyJ_3893,Channing Frye gets tackled by Cavs teammates and a standing ovation after checking out ,87,581,5886,6467,video
CompanyJ_3894,Steph pulled up in a We Believe Monta jersey via NBCSAuthentic ,63,1069,7380,8449,video
CompanyJ_3895,Pacers fans chanted Hide your cellphones and D Lo egged them on ,64,1334,9380,10714,video
CompanyJ_3896,Carsen Edwards will hire an agent and declare for the NBA draft per GoodmanHoops ,81,1218,9004,10222,photo
CompanyJ_3897,WrestleMania tailgating is no joke via DeionHD ,47,11383,34097,45480,video
CompanyJ_3898,The Nets clinch their first playoff appearance since 2014 2015 season ,70,4954,31842,36796,photo
CompanyJ_3899, That s crazy I don t even know what to think D Lo reacts to Nets making postseason ,84,3002,18720,21722,video
CompanyJ_3900,CJ McCollum to play limited minutes tonight vs Denver after missing last 10 games with knee injury per NBCSNorthwest ,117,102,887,989,photo
CompanyJ_3901,D Angelo Russell s storybook season continues MIP contender First All Star berth Career high PPG 21 1 Career high APG 7 0 Nets first playoffs since 2015 ,153,4019,22255,26274,photo
CompanyJ_3902, ,1,61,685,746,link
CompanyJ_3903,Baylor knocks off the reigning champs to win the NCAA title ,60,680,3322,4002,photo
CompanyJ_3904,CHLOE JACKSON GAME WINNER FOR THE NATTY WOW via ncaawbb ,56,791,3405,4196,video
CompanyJ_3905, We Believe Warriors jerseys for the last regular season game at Oracle Arena ,78,6861,32268,39129,video
CompanyJ_3906,This Austin Rivers shot gave the Rockets a new single game record with 27 3 pointers ,85,306,2345,2651,video
CompanyJ_3907,From rookie season last regular season game at Oracle Arena We Believe forever ,79,2185,11946,14131,photo
CompanyJ_3908,The Warriors reactions when they first saw the We Believe gear via warriors ,76,4842,32888,37730,video
CompanyJ_3909,Vlade received a video tribute and standing ovation for his Naismith Memorial Basketball Hall of Fame induction announcement ,125,209,1886,2095,video
CompanyJ_3910,Don t do em like that Swipa ,28,590,4958,5548,video
CompanyJ_3911, DrOfThuganomics is BACK and he showed up in throwback gear to ruin Elias concert via WWE ,90,903,3366,4269,video
CompanyJ_3912,Steve Kerr thanks Warriors fans after last regular season game at Oracle Arena ,79,410,3344,3754,video
CompanyJ_3913,Warriors hang a banner celebrating 47 seasons at Oracle Arena This banner will also hang at the Chase Center ,109,838,5877,6715,video
CompanyJ_3914,Caruso tried to end Rudy Gobert ,32,4856,33102,37958,video
CompanyJ_3915,What a week ,12,6860,23718,30578,photo
CompanyJ_3916,Hezonja denies Bron and the Lakers at MSG D Rose humbles Luka Okogie clamps Harden s step back Best blocks from this season McDonalds ,134,575,3215,3790,video
CompanyJ_3917,His daughter was visiting from Mexico to watch him play So when he scored he got to celebrate with her in the stands via USLChampionship ,137,535,3972,4507,video
CompanyJ_3918,On this day in 2003 a high school phenom shook hands with his idol after Cavs Wizards He later described meeting him as like Black Jesus walking towards me ,156,2495,22013,24508,photo
CompanyJ_3919,Antonio Brown just put up a 2015 DM from JuJu asking for advice while at USC ,77,1150,7915,9065,photo
CompanyJ_3920,Two days left Who ll take MVP Giannis 27 7 PPG 12 5 RPG 5 9 APG 60 Wins 1st in East Harden 36 1 PPG 6 6 RPG 7 6 APG 53 wins 3rd in West ,136,874,6813,7687,photo
CompanyJ_3921,Rakitic s rocket Ronaldo s volley Messi s free kick The Champions League has had some unreal goals so far ,106,664,3822,4486,video
CompanyJ_3922,Hazard dribbled through everybody via TelemundoSports ,54,1473,6161,7634,video
CompanyJ_3923,April 8 2012 Melo hits two of the most cold blooded shots of his career vs the Bulls via NBAHistory ,100,7425,31135,38560,video
CompanyJ_3924,The 04 Pistons championship squad got together to relish in their greatest memories DetroitBasketball ,102,495,3099,3594,photo
CompanyJ_3925,Baez threw his bat at the ball and scored a run via MLB ,56,975,7201,8176,video
CompanyJ_3926,Kyle Korver says we must strive for better ,43,1372,9178,10550,photo
CompanyJ_3927,Gordon Hayward recalls ALMOST toppling Duke in the 2010 National Championship game Coach K If it goes in I m gonna be killed ,125,1983,14027,16010,video
CompanyJ_3928,Shimmy Courtside Never change Steph via upclosehoops IG ,56,2935,22210,25145,video
CompanyJ_3929,ONE MORE HOUR MarchMadness ,27,308,3139,3447,photo
CompanyJ_3930,D Rose s agent says he d be open to returning to the Bulls this summer There s no doubt that in his heart Chicago will always be there via 670TheScore ,151,2125,11113,13238,photo
CompanyJ_3931,What a tourney it s been so far Acura ,38,90,649,739,video
CompanyJ_3932,Salute ,7,8658,48649,57307,photo
CompanyJ_3933,It s time MarchMadness ,23,146,1029,1175,photo
CompanyJ_3934,Don t give Jerome any space MarchMadness ,41,156,1124,1280,video
CompanyJ_3935,Guy got the step back on MarchMadness ,38,361,2562,2923,video
CompanyJ_3936,Nothing easy MarchMadness ,26,122,872,994,video
CompanyJ_3937,Texas Tech is COMING ALIVE MarchMadness ,40,264,1877,2141,video
CompanyJ_3938,Mahomes is feeling this 12 2 Texas Tech run MarchMadness ,57,448,4675,5123,video
CompanyJ_3939,Jerome before half COLD MarchMadness ,37,177,1213,1390,video
CompanyJ_3940,Hunter is FEELING IT MarchMadness ,34,98,886,984,video
CompanyJ_3941,Zion watching the National Championship MarchMadness ,53,1213,8797,10010,photo
CompanyJ_3942,Jerome and Guy always on the same page MarchMadness ,52,129,981,1110,video
CompanyJ_3943,Security guard wasn t feeling it MarchMadness ,46,3406,23174,26580,video
CompanyJ_3944,All heart from Hunter MarchMadness ,35,128,909,1037,video
CompanyJ_3945,Texas Tech isn t going away MarchMadness ,41,418,2262,2680,video
CompanyJ_3946,CLUTCH MarchMadness ,20,123,834,957,video
CompanyJ_3947,THIS GAME MarchMadness ,23,1078,4211,5289,photo
CompanyJ_3948,Texas Tech not backing down MarchMadness ,41,477,2184,2661,video
CompanyJ_3949,CLUTCH MarchMadness ,20,821,3340,4161,video
CompanyJ_3950,OT GIVE US MORE MADNESS ,24,1158,5181,6339,photo
CompanyJ_3951,Another big time shot from Mooney MarchMadness ,47,104,837,941,video
CompanyJ_3952,During this review MarchMadness ,32,214,1892,2106,photo
CompanyJ_3953,Upset by a 16 seed to national champs UVA wins its first title in men s program history ,88,2200,10220,12420,photo
CompanyJ_3954,CELEBRATION TIME FOR UVA MarchMadness ,38,825,2903,3728,video
CompanyJ_3955, I got a poster of Rocky on the steps and I told them I just want a chance at the title fight one day Coach Bennett reflects on UVA s 1st title MarchMadness ,157,549,3764,4313,video
CompanyJ_3956,Kyle Guy wins Most Outstanding Player for the FinalFour ,56,871,5262,6133,photo
CompanyJ_3957,What a difference a year makes ,31,846,7090,7936,photo
CompanyJ_3958,All class from Chris Beard and Texas Tech MarchMadness ,55,835,5340,6175,video
CompanyJ_3959,It s that time One Shining Moment to close out MarchMadness ,60,1113,3531,4644,video
CompanyJ_3960,Virginia DENIED Texas Tech s hopes for a title in OT cocacola ,62,196,2014,2210,video
CompanyJ_3961,D Wade s last regular season game in Miami tonight OneLastDance ,64,12738,58487,71225,photo
CompanyJ_3962,Eight teams left The Champions League is BACK Follow brfootball for the best from the quarterfinals amp more ,109,354,2592,2946,photo
CompanyJ_3963,Potential first round playoff preview tonight Who would you rather have on your team for a Game 7 MyStraightTalk ,113,385,2805,3190,status
CompanyJ_3964,Miami is his house OneLastDance ,32,4924,23881,28805,video
CompanyJ_3965,Just in time for the Champions League Ronaldo s back from injury ,65,450,4175,4625,photo
CompanyJ_3966,DLo left a photo shoot to do this From BR x HUGOBOSS ,53,1700,7876,9576,video
CompanyJ_3967,Giannis doesn t need the bright lights ,39,2548,20772,23320,photo
CompanyJ_3968,Previously on GameOfZones THREAD Season 6 premieres Thursday at 5pm ET exclusively on the B R app ,98,61,259,320,link
CompanyJ_3969,UCL quarterfinal ready Tottenham vs Man City Liverpool vs Porto 3pm on brlive via brfootball ,93,76,476,552,photo
CompanyJ_3970,It s unlikely that KD Kawhi or Klay sign with the Lakers per billoram LA will be second or third option for those stars ,120,900,4530,5430,photo
CompanyJ_3971,Wade is leaving a L3GACY in Miami OneLastDance ,47,3590,15622,19212,photo
CompanyJ_3972,Serge Ibaka s cooking show has had Raptors players eating everything from lamb brains to bull testicles And it s brought the team closer together ,146,246,2057,2303,photo
CompanyJ_3973,D Wade to Bron off glass Trae turning defenders around Russ getting fancy on the break Best assists of the year mcdonalds ,122,426,2415,2841,video
CompanyJ_3974, In the UCL quarterfinals 2pts behind 1st in the league FA Cup finalists Won the League Cup Man City are coming for the quadruple via brfootball ,145,79,633,712,photo
CompanyJ_3975,You can grab a limited edition DwyaneWade jersey or bomber and more NOW ,72,386,2329,2715,photo
CompanyJ_3976,Aguero DENIED ,14,469,4041,4510,video
CompanyJ_3977,Fernandinho with the elbow drop ,32,187,1668,1855,video
CompanyJ_3978,D Wade arrives in an all red suit for his last regular season game in Miami OneLastDance via NBA ,97,8193,44332,52525,video
CompanyJ_3979,SON PUTS TOTTENHAM AHEAD ,25,595,3774,4369,video
CompanyJ_3980,Liverpool 2 0 Porto Porto just couldn t hurt them via brfootball ,65,143,920,1063,video
CompanyJ_3981,Son Heung min s last 12 months 20 goals 8 assists for club amp country Scored vs Germany Mexico in World Cup Won 2018 Asian Games to get military exemption in South Korea Scored winners vs Newcastle West Ham Scored winner in UCL quarterfinal 1st leg vs Man City ,262,337,2278,2615,photo
CompanyJ_3982,Steph is one of a kind ,23,611,4243,4854,photo
CompanyJ_3983,2019 Final Four Best moments Wendys ,36,58,942,1000,link
CompanyJ_3984,Hero s welcome for Dirk via dallasmavs ,39,1278,8173,9451,video
CompanyJ_3985,Congrats on retirement dwyanewade OneLastDance ,47,12029,63155,75184,photo
CompanyJ_3986,One Last Start ,15,3475,20361,23836,photo
CompanyJ_3987,Goosebumps OneLastDance ,24,10806,30435,41241,video
CompanyJ_3988,What a moment Zaire Wade recreates D Wade s famous From Robbins Illinois commercial ,84,4088,20630,24718,video
CompanyJ_3989,D Wade wasted no time getting his first bucket OneLastDance ,60,3100,14294,17394,video
CompanyJ_3990, You did us proud BarackObama has a special message for D Wade via MiamiHEAT ,77,8255,33885,42140,video
CompanyJ_3991,Not the first time we ve seen this in Wade County 8 points for the Flash already OneLastDance ,94,576,4118,4694,video
CompanyJ_3992, OneLastDance ,14,6515,24137,30652,photo
CompanyJ_3993,Boogie s back in NOLA ,22,1144,6144,7288,video
CompanyJ_3994,Steph tweaked his right ankle and heads to the locker room ,59,225,1714,1939,video
CompanyJ_3995,Dirk is EATING First 10 points for the Mavs ,44,1139,5718,6857,video
CompanyJ_3996,D Wade and Dirk both going off on the same night ,49,7580,33961,41541,photo
CompanyJ_3997,Breaking Magic Johnson has stepped down from President of Basketball Ops of the Lakers ,87,4640,13288,17928,photo
CompanyJ_3998, I m the president now ,23,5813,24314,30127,photo
CompanyJ_3999,The Magic Era is over ,22,811,4041,4852,photo
CompanyJ_4000,Lakers coaching staff fully expected to be fired after their final game per wojespn ,84,2226,7861,10087,photo
CompanyJ_4001, Magic quit AD trade fiasco LeBron got hurt Lonzo got hurt Missed playoffs Clippers made playoffs D Lo Randle Brook balling Two more wins than last year Most disappointing Lakers season ever ,191,4894,20418,25312,photo
CompanyJ_4002,Magic said I m out ,19,4311,18846,23157,video
CompanyJ_4003,Magic walking into Staples Center ,34,1182,5059,6241,video
CompanyJ_4004,WADE GOING OFF ,15,2734,15116,17850,video
CompanyJ_4005,Heat fans really started a Paul Pierce sucks chant in Dwyane Wade s last home game ,83,13803,58174,71977,video
CompanyJ_4006,30 piece in his final regular season game in Miami Aint that just like D Wade ,78,6739,30475,37214,photo
CompanyJ_4007,Dirk jumpers never get old ,27,651,4967,5618,video
CompanyJ_4008, That was tragic let s try it again One last trip for D Wade ,61,14795,65890,80685,video
CompanyJ_4009,Dirk with his first 30 point performance since 2016 Legend ,59,5749,27825,33574,video
CompanyJ_4010,A bunch of legends pulled up for Dirk ,38,1938,9155,11093,video
CompanyJ_4011, Enjoy the rest of your life Chuck showing lots of love to Dirk ,64,2189,11904,14093,video
CompanyJ_4012,Dirk officially announces he is retiring ,41,17937,65039,82976,photo
CompanyJ_4013,What a career for Swish41 ,26,13023,48798,61821,video
CompanyJ_4014,Dirk closes the door on his storybook career with the Mavericks ,64,15367,60373,75740,video
CompanyJ_4015,Jamal Crawford almost stole the show in Dirk s final home game ,63,1379,8619,9998,photo
CompanyJ_4016,PG COLD ,8,10825,47724,58549,video
CompanyJ_4017,Dirk and D Wade put on one last show for their home crowds ,59,4070,19726,23796,photo
CompanyJ_4018,Meanwhile in LA ,16,346,2875,3221,video
CompanyJ_4019,OKAY CARUSO ,12,447,3818,4265,video
CompanyJ_4020,HOW COULD YOU BE SO HARKLESS ,29,1266,8120,9386,video
CompanyJ_4021,Jeanie Buss granted Magic permission to fire Luke Walton at the end of the season due to Walton s unwillingness to bulk up his coaching staff per ChrisBHaynes ,159,749,3083,3832,photo
CompanyJ_4022,Harden became the 5th player in NBA history to average 35 PPG in a season last night ,85,1636,8246,9882,photo
CompanyJ_4023,Last night Magic steps down as Lakers president D Wade drops 30 in final home game Dirk announces retirement also drops 30 Jamal Crawford becomes oldest player to drop 50 points Paul George game winner Lakers lose at the buzzer Just another night in the NBA ,258,2474,12464,14938,photo
CompanyJ_4024,A storybook ending for Flash via DwyaneWade ,44,1912,11960,13872,photo
CompanyJ_4025,What a view of PG s game winner via reeseOKC ,45,2198,13928,16126,video
CompanyJ_4026,The Champions League today is BIG Ajax vs Juventus Manchester United vs Barcelona 3pm brlive ,93,363,1947,2310,photo
CompanyJ_4027,Legend of the game Top 10 plays of dwyanewade s unbelievable career ,68,3428,10769,14197,video
CompanyJ_4028,It s fresh faces vs past champions at this year s Masters CallawayGolf ,71,12,110,122,video
CompanyJ_4029,21 seasons Legend You ll be missed swish41 ,43,2834,18517,21351,photo
CompanyJ_4030, If we never get it done we never get it done Dame_Lillard says he can live without a ring if it means he hasn t sold himself out NEW Take It There with TaylorRooks ,165,217,1026,1243,video
CompanyJ_4031,The battle for another Champions League title continues Ronaldo s ready via brfootball ,87,400,2257,2657,photo
CompanyJ_4032,RJ Barrett declares for the 2019 NBA draft 18 19 22 6 PTS 7 6 REB 4 3 AST NBADraftWass projects him as a Top 3 pick ,116,808,5119,5927,photo
CompanyJ_4033,The last time Manchester United faced Barcelona the 2011 Champions League final It was one of Messi s best ever performances via brfootball ,140,273,1561,1834,video
CompanyJ_4034,LeBron stands behind Jeanie Buss and Lakers organization despite Magic s resignation per ramonashelburne ,105,337,2770,3107,photo
CompanyJ_4035,One of the best parts of D Wade s OneLastDance All the jersey swaps ,68,1482,9040,10522,video
CompanyJ_4036,The stats speak for themselves Dirk goes out as one of the best ever ,69,1085,4582,5667,video
CompanyJ_4037,Ronaldo is unstoppable in the Champions League knockout rounds via brfootball ,78,74,435,509,video
CompanyJ_4038,JR s secret stuff Space Jam 2 trailer gets the NBA2K remix via Shady00018 ,74,6212,23081,29293,video
CompanyJ_4039,19 year old Knicks rookie Kevin Knox is a teenager in a grown man s world he s overwhelmed in the NBA and can t even grow facial hair But he says he and the Knicks will only get better ,185,207,1502,1709,photo
CompanyJ_4040,D Wade knew ,12,653,5639,6292,video
CompanyJ_4041,Manchester United vs Barcelona Pogba vs Messi This one is big ,62,227,1702,1929,photo
CompanyJ_4042, I got it in dad D Wade 2 year old s form is on point via anthonyantoniazzi IG ,79,1107,8961,10068,video
CompanyJ_4043,Spieth almost holes out after skipping it across the pond via TheMasters ,73,11644,61274,72918,video
CompanyJ_4044,Messi cross to Suarez header forces an own goal to take the lead ,65,201,1270,1471,video
CompanyJ_4045,Messi with a bloody nose and eye after a collision with Smalling ,65,469,2991,3460,video
CompanyJ_4046,WHO ELSE BUT RONALDO ,21,2232,9367,11599,video
CompanyJ_4047,Ajax equalize just 30 seconds into the second half ,51,284,1979,2263,video
CompanyJ_4048,Dame says Shump and Lonzo can rap but other players can run into a problem that makes their bars corny NEW Take It There with TaylorRooks ,138,155,866,1021,video
CompanyJ_4049,April 10 2007 Ronaldo s first UCL goal April 10 2019 Ronaldo s 125th UCL goal 12 years to the day via brfootball ,113,422,1976,2398,photo
CompanyJ_4050,Costa burned him twice ,23,404,2766,3170,video
CompanyJ_4051,3 OneLastDance ,15,1775,9582,11357,photo
CompanyJ_4052,Marcus Smart has suffered a torn oblique and could be out for the first 2 rounds of the playoffs per wojespn ,109,437,2483,2920,photo
CompanyJ_4053,The Las Vegas Aces have selected Jackie Young with the No 1 pick in the WNBADraft 2018 2019 14 3 PTS 7 0 REB 5 2 AST ,117,373,1939,2312,photo
CompanyJ_4054,Farewell Swish ,15,2948,17622,20570,photo
CompanyJ_4055,Bron Melo and CP3 in the house to watch OneLastDance via NBATV ,63,3554,14793,18347,video
CompanyJ_4056, ,1,681,5026,5707,photo
CompanyJ_4057,Dirk moved to tears after the Spurs gave him a tribute video ,61,23978,105482,129460,video
CompanyJ_4058,D Wade fans gotta be exhausted ,31,2421,11722,14143,video
CompanyJ_4059, He s given so much to this game Bron reflects on his friend DwyaneWade s career ,81,1378,6518,7896,video
CompanyJ_4060,Derrick Jones Jr comes in to CLEAN UP ,38,334,2690,3024,video
CompanyJ_4061,Trae too smooth going between the legs ,39,362,2734,3096,video
CompanyJ_4062,No 4 overall pick Katie Lou Samuelson s favorite player is Larry Bird Bird surprised her with a special message right after she got drafted via WNBA ,149,1020,8525,9545,video
CompanyJ_4063,D WADE WITH THE TRIPLE DOUBLE IN HIS LAST GAME OneLastDance ,60,13620,61892,75512,video
CompanyJ_4064,Wade really got a triple double in his last game Legend OneLastDance ,69,1821,9367,11188,photo
CompanyJ_4065,Jimmy making paper airplanes on the bench ,42,368,3462,3830,video
CompanyJ_4066,Melo s ready to check in ,25,10311,51832,62143,video
CompanyJ_4067,Goodbye D Wade ,15,1564,4609,6173,video
CompanyJ_4068,Fans are chanting Paul Pierce sucks during D Wade s final this time in Brooklyn ,80,5207,32102,37309,video
CompanyJ_4069,For the last time Dwyane Wade checks out of the game Thank you Flash OneLastDance ,82,6954,26921,33875,video
CompanyJ_4070,Bron had to video bomb D Wade one last time OneLastDance ,57,4911,21407,26318,video
CompanyJ_4071,The two legends had to show out in their last games Wade 25 PTS 11 REB 10 AST Dirk 20 PTS 10 REB ,97,2667,11792,14459,photo
CompanyJ_4072,With Nets victory the Atlantic rivalry is set D Lo vs Simmons in the first round ,81,750,5573,6323,photo
CompanyJ_4073,Cheers to 16 years via NBA ,27,9926,51941,61867,photo
CompanyJ_4074,Another historic season for Russ Westbrook notched his 138th triple double to end the regular season tying Magic Johnson for second all time ,141,1472,8577,10049,photo
CompanyJ_4075,Playoff seeding on the line Jamal Murray delivers ,50,444,3528,3972,video
CompanyJ_4076,Thunder win Nuggets win Trail Blazers wins Rockets fall to No 4 OKC will face Portland in first round ,102,1801,9890,11691,photo
CompanyJ_4077,P L A Y O F F S West 1 Warriors vs 8 Clips 2 Nuggets vs 7 Spurs 3 Blazers vs 6 Thunder 4 Rockets vs 5 Jazz East 1 Bucks vs 8 Pistons 2 Raps vs 7 Magic 3 Sixers vs 6 Nets 4 Celtics vs 5 Pacers ,192,8922,29394,38316,photo
CompanyJ_4078,NBA regular season don t read this NBA Playoffs hello ,54,319,3787,4106,photo
CompanyJ_4079,Your NBA stat leaders ,22,1692,8843,10535,photo
CompanyJ_4080,1M Follow brfootball for the best in ,37,16,385,401,photo
CompanyJ_4081,Luka becomes the 5th rookie ever to join the 20 5 5 club ,57,1410,9161,10571,photo
CompanyJ_4082,Went to the grocery store to hit the Kobe fadeaway against strangers via iamgeraldhuston ,89,13861,57258,71119,video
CompanyJ_4083,Giannis keeps on building his MVP resume ,41,2368,15413,17781,photo
CompanyJ_4084,Tiger is on the tee Is this the year TheMasters ,48,227,1922,2149,photo
CompanyJ_4085,Opening day of 2K League and there s already beef brewing via BRGaming ,71,1355,7147,8502,video
CompanyJ_4086,These kids were so excited to be next to Ronaldo ,49,2727,26066,28793,video
CompanyJ_4087,Strange swing Super slow Analytics obsessed Bryson DeChambeau has controversially become the No 6 golfer in the world Meet the weirdest golfer at the Masters ,158,29,337,366,photo
CompanyJ_4088,Squad love for Dirk via dallasmavs ,35,1054,10278,11332,photo
CompanyJ_4089,This robot was programmed to pull up like Steph via B_LEAGUE ,61,7478,34501,41979,video
CompanyJ_4090,The secret to slowing down Giannis could be a zone defense but some NBA teams view the scheme as not macho and shying away from competition ,140,84,875,959,photo
CompanyJ_4091,From Boogie s tossed shoe to Pop s ejection in 63 seconds techs were truly wild this year ,90,676,4759,5435,video
CompanyJ_4092,Pat Bev giving tips on how to put the clamps on Harden Jazz Rockets tips off Sunday ,84,2169,18471,20640,video
CompanyJ_4093,5pm ET GameOfZones ,19,195,1492,1687,photo
CompanyJ_4094,Tiger is your themasters co leader after this ridiculous shot set up a birdie via CBSSports ,92,841,4674,5515,video
CompanyJ_4095,The passing leading to Arsenal s opening goal was too smooth ,61,404,2590,2994,video
CompanyJ_4096,Nipsey Hussle loved basketball and community so they built a court with a mural to honor him via nbcbayarea ,108,16723,74225,90948,video
CompanyJ_4097,19 year old Joao Felix s reaction to completing his first career hat trick ,75,593,4086,4679,video
CompanyJ_4098, GAME OF ZONES SEASON 6 PREMIERE Watch exclusively in the B R App The Jimmy Butler T Wolves practice footage is finally revealed StateFarm ,139,413,1777,2190,video
CompanyJ_4099,Hazard cut through two defenders like it was nothing ,53,389,3073,3462,video
CompanyJ_4100,The NBA might have a new block king and his name is Jarrett Allen ,66,2963,15737,18700,video
CompanyJ_4101,Cam Reddish has declared for the NBA draft ,43,1846,16154,18000,photo
CompanyJ_4102,Hawks Mavericks swapped picks on draft night landing Trae in Atlanta and Luka in Dallas The trade proved to be a win for both teams ,132,909,9051,9960,photo
CompanyJ_4103,Bryson DeChambeau with the shot of the day in Augusta via TheMasters ,69,242,1770,2012,video
CompanyJ_4104,DeChambeau and Koepka share the lead after Day 1 at Augusta Tiger sits tied for 11th at 2 themasters ,101,51,564,615,photo
CompanyJ_4105,D Rose broke down the moment he found out he was traded to the Knicks via Stadium ,82,12641,48180,60821,video
CompanyJ_4106,ACUÑA GONE via Braves ,22,671,4269,4940,video
CompanyJ_4107,ONE DAY UNTIL PLAYOFFS ,23,5606,27908,33514,photo
CompanyJ_4108,Giannis is the basketball dream EARLY Sold trinkets on the street Shared shoes with brother Didn t own a suit before the draft Sent so much money home he couldn t afford a cab and ran to the Bucks arena 2019 Most wins in the league MVP ,236,18050,95300,113350,photo
CompanyJ_4109,Goodnight via BRLive ,21,258,1607,1865,video
CompanyJ_4110,Beyonce s dad got a bucket vs Kobe on a Destiny s Child music video set via MathewKnowles ,90,700,5629,6329,video
CompanyJ_4111, GAME OF ZONES SEASON 6 PREMIERE Jimmy Butler turned T Wolves practice into a bloodbath GameOfZones StateFarm ,110,2265,6855,9120,video
CompanyJ_4112,The inaugural class of students at LeBron s I Promise School have posted extraordinary results so far 90 percent met or exceeded growth goals in reading and math per EricaLG ,174,6610,27276,33886,photo
CompanyJ_4113,Six years today Kobe tore his Achilles then limped to the line and knocked down two free throws Mamba was different ,116,9976,46760,56736,photo
CompanyJ_4114,Tobias Harris has become a star so why has he played for five teams in eight seasons That s business That s not personal I wouldn t say teams were giving up on me ,163,217,2471,2688,photo
CompanyJ_4115,Kyrie CP3 DeAndre and others around the league are shifting toward plant based diets It s working ,98,813,4864,5677,video
CompanyJ_4116,Whole series of Russ vs Dame should be fun ,43,13684,56065,69749,video
CompanyJ_4117,This disrespect on this goal Carlos Andres Ferreyra de Cipolletti TV YouTube ,77,7817,31440,39257,video
CompanyJ_4118,Lonzo nearly had unauthorized ankle surgery in February pushed by estranged partner Alan Foster Lakers told him they could void his contract per ShamsCharania ,159,925,4280,5205,photo
CompanyJ_4119,Is Tobias underrated ,21,245,2772,3017,photo
CompanyJ_4120,BREAKING Lakers Luke Walton mutually agree to part ways per ShamsCharania ,74,3247,12044,15291,photo
CompanyJ_4121,Ty Lue is a strong frontrunner for the Lakers job per wojespn ,62,1525,8971,10496,photo
CompanyJ_4122,Former Cavs GM David Griffin will become next President of Basketball Operations with the Pelicans per wojespn ,111,363,2070,2433,photo
CompanyJ_4123,Steph isn t sweating Pat Bev s antics in Round 1 Historically speaking it hasn t worked via 957thegame ,103,899,5664,6563,video
CompanyJ_4124,With Russ and PG clicking on all cylinders OKC could find their way out their first round for the first time since KD left ,123,390,2443,2833,video
CompanyJ_4125,Anything is possible in LA B R x beatsbydre ,44,634,3017,3651,video
CompanyJ_4126,The security guard almost took out Tiger via CBSSports ,55,1205,6234,7439,link
CompanyJ_4127,Chicago native JabariParker and SHOTheChi star Jacob Latimore surprise deserving students with some heat on a new episode of Sneaker Shock Their reactions were perfect via brkicks From B R x SHOTheChi ,201,23,132,155,video
CompanyJ_4128,Tiger creeping up on 1st place after his second birdie IN A ROW Via TheMasters ,79,1048,6745,7793,video
CompanyJ_4129,Tiger has missed 6 4 ft putts today last one would ve been a birdie ,68,143,1704,1847,photo
CompanyJ_4130,All bets on Tiger this weekend via br_betting ,46,244,1846,2090,photo
CompanyJ_4131,Why d he cross up the teacher like that via noahkautz4 Instagram ,65,9862,51843,61705,video
CompanyJ_4132,Chicago native JabariParker and SHOTheChi star Jacob Latimore surprise deserving students with some heat on a new episode of Sneaker Shock Their reactions were perfect via brkicks From B R x SHOTheChi ,201,60,314,374,video
CompanyJ_4133,Coach ate dog food to hype his squad after the W via NeumannMLAX ,65,597,3745,4342,video
CompanyJ_4134,Most outstanding players in college hoops Zion Williamson and Sabrina Ionescu win the Wooden Award ,99,1013,9432,10445,photo
CompanyJ_4135,If the stars of the NBA playoffs celebrated like the stars of the UCL via brfootball ,85,1619,9418,11037,photo
CompanyJ_4136, NBA PLAYOFFS ARE HERE ,23,9145,29362,38507,video
CompanyJ_4137,Kawhi doesn t need to change anything to prepare It s the same game You just put playoffs in front of it per ekoreen ,117,577,4939,5516,photo
CompanyJ_4138,76ers Nets split their 4 game series in the regular season This first round matchup should be interesting ,106,484,4138,4622,video
CompanyJ_4139,Three years ago today Warriors 73rd win most all time Kobe drops 60 in epic finale One of the wildest basketball days ever ,123,3644,24110,27754,photo
CompanyJ_4140,KD has no regrets about joining Golden State I came here knowing for a fact that every media member every fan was going to call me every name in the book But I wanted to be a part of this so bad I didn t give a f k via MrMichaelLee ,232,1899,10403,12302,photo
CompanyJ_4141,Alvin Kamara is a machine via doctor_reef ,42,21121,102226,123347,video
CompanyJ_4142,The Endgame in the East begins today ,37,1889,9202,11091,photo
CompanyJ_4143,D Lo and the Nets have come a long way chocolate_milk ,54,1122,5460,6582,video
CompanyJ_4144,Joel Embiid is available to play in Game 1 against Brooklyn per ShamsCharania ,78,317,2434,2751,photo
CompanyJ_4145,Kings GM Vlade Divac is offering Luke Walton the coaching job confidence on both sides a deal can be reached soon per wojespn ,126,356,2392,2748,photo
CompanyJ_4146,Jimmy Buckets isn t going down quietly via sixers ,50,665,4842,5507,video
CompanyJ_4147,D Wade and his daughter via wearejayla IG ,42,8793,65770,74563,video
CompanyJ_4148,Luke Walton agrees to terms with Kings to become next head coach per sam_amick ,79,1214,5492,6706,photo
CompanyJ_4149,Philly is shook ,16,1123,6202,7325,photo
CompanyJ_4150,D Lo and the Nets steal Game 1 in Philly ,41,5352,28029,33381,photo
CompanyJ_4151,D Lo waved JJ Redick off the court after fouling him out ,57,1250,9239,10489,video
CompanyJ_4152,D Lo 26 PTS and Caris LeVert 23 PTS were serving buckets in Philly ,67,1141,7080,8221,video
CompanyJ_4153, Tiger is tied for the lead at 11 in Augusta TheMasters ,56,1078,5418,6496,photo
CompanyJ_4154,Embiid says Amir Johnson was using his phone to check on his daughter who is extremely sick via BenGolliver ,108,1316,7377,8693,video
CompanyJ_4155,The year is 2019 and DJ Augustin is cooking Magic have an 8 point lead over the Raptors at the half 19 PTS and 3 ASTS for the vet ,130,423,3064,3487,photo
CompanyJ_4156,Will anyone knock the Warriors off the Western throne ,54,1210,6642,7852,photo
CompanyJ_4157,Ben Simmons has a message for Sixers fans ,42,766,5001,5767,photo
CompanyJ_4158, Please dont let Kawhi check the box score ,43,1487,8343,9830,photo
CompanyJ_4159, What they saying about me ,27,1564,8005,9569,photo
CompanyJ_4160,KAWHI CLUTCH ,13,380,2218,2598,photo
CompanyJ_4161,D J AUGUSTIN CALLED GAME MAGIC LEAD RAPTORS 1 0 ,48,5339,24681,30020,video
CompanyJ_4162,Kawhi calling a team meeting after taking the L to the Magic ,61,2692,12922,15614,video
CompanyJ_4163,D J Augustin is showing his clutch gene in the playoffs It s 2019 ,66,650,5816,6466,photo
CompanyJ_4164,Steph cooking early via warriors ,33,573,4562,5135,video
CompanyJ_4165,Steph had em jumping with the hesi via NBA ,43,1281,10280,11561,video
CompanyJ_4166,23 PTS 10 REBS 6 ASTS Steph s officially on triple double watch via warriors ,77,502,3763,4265,video
CompanyJ_4167,Stephen Curry Absolute cheat code ,34,1313,8321,9634,photo
CompanyJ_4168,Steph passes Ray Allen for most made threes in playoff history with 386 A lot of splashes for Curry 3 via warriors ,115,1103,5556,6659,video
CompanyJ_4169,KD and Pat Bev have been going at it all game They ve both been ejected ,72,523,4092,4615,photo
CompanyJ_4170,Steph Curry was unguardable against the Clippers 38 PTS 15 REB 7 AST Gatorade ,78,1453,7194,8647,video
CompanyJ_4171,Playoff intensity ,18,3318,19938,23256,photo
CompanyJ_4172,OH MY WHAT via NBA ,19,7593,41519,49112,video
CompanyJ_4173,Sheesh ,7,1227,7316,8543,photo
CompanyJ_4174,This Derrick White dunk is insane Gatorade ,43,1483,8225,9708,video
CompanyJ_4175,More history for Pop ,21,3390,18567,21957,photo
CompanyJ_4176,Blake Griffin sets the record straight on his relationship with Chris Paul his infamous punch and why it s been easy for him to leave L A behind for Detroit He is by no means Hollywood ,185,410,2447,2857,photo
CompanyJ_4177,DeCHAMBEAU HOLE IN ONE via TheMasters ,38,1284,8846,10130,video
CompanyJ_4178,Who ends up on the Iron Throne DeAndre Hopkins Von Miller and other NFL stars predict the ending of GameOfThrones ,114,193,885,1078,video
CompanyJ_4179,This own goal is BRUTAL via MNUFC ,34,381,2440,2821,video
CompanyJ_4180, Y all better stop playin with me D Lo was talking late in Game 1 yesterday ,76,3930,26523,30453,video
CompanyJ_4181,A birdie puts Tiger one shot back via CBSSports ,48,623,4522,5145,video
CompanyJ_4182,Brutal final minute for Denver in a one possession game Murray airball Jokic turnover Murray miss Murray turnover ,114,455,3530,3985,video
CompanyJ_4183,The Mountain from Game of Thrones and the reigning World s Strongest Man admits he s used steroids When you want to be the best you do whatever it takes via E60 ,161,527,2988,3515,photo
CompanyJ_4184,Tiger RIDICULOUS TheMasters via CBSSports ,42,1710,10184,11894,video
CompanyJ_4185,Dame is ready for the Thunder When Russ see me and when I see him it s two dogs fighting per jwquick ,101,2653,15401,18054,video
CompanyJ_4186,When Dwane Casey met Blake Griffin he was practicing ball handling against seven defenders I knew he was a great athlete His basketball IQ is what struck me ,157,1105,8834,9939,video
CompanyJ_4187,Dame won t stop proving himself even after superstardom in Portland adidasHoops ,80,654,3479,4133,video
CompanyJ_4188,An absolute ROCKET from Mo Salah via NBCSportsSoccer ,53,4888,18260,23148,video
CompanyJ_4189,TIGER IS TIED FOR THE LEAD via CBSSports ,41,1408,7552,8960,video
CompanyJ_4190,Aaron Judge is for the kids Smacks a HR to right then plays catch with the fan who caught it Via MLB ,101,1484,11706,13190,video
CompanyJ_4191,In Boston this is the moment where legacies are built B R x beatsbydre ,71,350,1638,1988,video
CompanyJ_4192,Kyrie has the smoothest handles in the league ,46,1791,10964,12755,video
CompanyJ_4193,Liverpool beat Chelsea 2 0 to go top of the league five years after losing 2 0 to Chelsea to lose the league title via brfootball ,130,344,1653,1997,photo
CompanyJ_4194,TIGER LEADS THREE HOLES LEFT TheMasters ,40,1411,6891,8302,photo
CompanyJ_4195,TIGER WOODS Via CBSSports ,26,6796,34547,41343,video
CompanyJ_4196,Everybody is here for Tiger ,28,3724,21495,25219,photo
CompanyJ_4197,Tiger wins the 2019 Masters the 15th major championship of his career ,70,42531,131066,173597,photo
CompanyJ_4198,Unreal ,7,3589,17855,21444,photo
CompanyJ_4199,Tiger with his family via CBSSports ,36,6965,48136,55101,video
CompanyJ_4200,The shot The win via CBSSports ,31,6526,30107,36633,video
CompanyJ_4201,One of the greatest comebacks in sports history 2008 Wins US Open on torn ACL 2010 Neck injury 2011 Sprained MCL Achilles 2012 Achilles injury 2014 Back surgery 2015 Back surgery 2017 Back surgery 2019 Wins Masters first major since 2008 ,238,37304,153675,190979,photo
CompanyJ_4202,Tiger just made a fan a MILLY ,30,4886,37752,42638,link
CompanyJ_4203, It fits via TheMasters ,24,1793,10581,12374,video
CompanyJ_4204,1997 First Masters 2019 Fifth Masters ,38,4244,24007,28251,photo
CompanyJ_4205,Bronny took over in the CLUTCH TheWarmup madehoops ,51,1366,7390,8756,video
CompanyJ_4206,Kyrie not phased by the low scoring effort That s where the gritty individuals make their mark Via NBATV ,105,533,4318,4851,video
CompanyJ_4207,PSG really lost 5 1 to Lille ,29,388,3024,3412,video
CompanyJ_4208,DAME TIME via trailblazers ,27,577,3253,3830,video
CompanyJ_4209,Lillard pulling up from ANYWHERE via NBA ,41,4205,28590,32795,video
CompanyJ_4210,20 PTS 18 REBS Enes Kanter seems to like playing his former team ,65,558,4702,5260,photo
CompanyJ_4211,When you play the Dame of Thrones you win or you lose There is no middle ground Blazers take Game 1 against OKC ,112,721,3588,4309,photo
CompanyJ_4212,This is the Blazers first playoff win since 2016 ,49,1152,11792,12944,photo
CompanyJ_4213,Dame Time started at home 30 PTS 4 REBS 4 ASTS 3 STLS Blazers take a 1 0 lead over OKC ,87,731,4707,5438,video
CompanyJ_4214,PG said four days ago he couldn t even lift his shoulder hadn t shot a basketball since the Houston game He still finished with 26 PTS 10 REBs ,143,834,6518,7352,photo
CompanyJ_4215,Giannis is too much for the Pistons ,36,946,7512,8458,video
CompanyJ_4216, Next question Russ wasn t feeling it after OKC s game one loss via BenGolliver ,80,1482,8494,9976,video
CompanyJ_4217,GIANNIS ,8,1129,7043,8172,video
CompanyJ_4218,Is this finally Houston s year B R x beatsbydre ,48,672,2765,3437,video
CompanyJ_4219,GIANNIS SHEESH ,15,2743,14772,17515,video
CompanyJ_4220,Pistons ,8,690,3931,4621,photo
CompanyJ_4221,Winter is here GameOfThrones ,29,362,2137,2499,photo
CompanyJ_4222,The Greek Freak in 23 minutes 24 PTS 17 REBS 4 ASTS Light work ,63,994,8468,9462,photo
CompanyJ_4223,Harden s step back is cash year round ,38,498,3451,3949,video
CompanyJ_4224,CP3 getting crafty ,19,430,3810,4240,video
CompanyJ_4225,Beard in his bag He s got 17 PTS 4 REBS 7 ASTS at halftime ,59,276,2329,2605,video
CompanyJ_4226,What is going on in Houston ,28,3572,16554,20126,video
CompanyJ_4227,Harden heating up ,18,242,1866,2108,video
CompanyJ_4228,Rubio was tip toeing around Harden ,35,961,7668,8629,video
CompanyJ_4229,Easy work for Houston Rockets take a 1 0 lead over the Jazz 122 90 Harden 29 PTS 8 REBS 10 ASTS ,96,643,3823,4466,photo
CompanyJ_4230,Giannis and Harden bringing their MVP form into the playoffs Giannis 24 PTS in 23 mins Bucks win by 35 Harden 29 PTS in 33 mins Rockets win by 32 ,146,996,8975,9971,photo
CompanyJ_4231,72 years ago today Jackie Robinson breaks the MLB color barrier when he steps on Ebbets Field for the Brooklyn Dodgers ,119,11451,44213,55664,photo
CompanyJ_4232,Anthony Borges dream was playing for FCBarcelona But after the Parkland shooting he didn t know if he would ever walk again His incredible story from surviving five gunshot wounds to finally getting to Camp Nou via brfootball ,226,1604,4253,5857,video
CompanyJ_4233,Pulled him down by his shorts gotta be a red card via arat_gym brfootball ,74,464,3847,4311,video
CompanyJ_4234,Russell Wilson won t commit long term to the Seahawks if a deal is not done by tonight per peter_king ,102,1561,7554,9115,photo
CompanyJ_4235, Tupac Barkley saquon explains how close he was to being named after the legendary rapper New Take It There with TaylorRooks drops Wednesday ,141,271,1570,1841,video
CompanyJ_4236,Maliq Carr just overpowers the DB via hudl ,43,441,3345,3786,video
CompanyJ_4237,Yasiel Puig could ve been a Dodger for life but his lack of effort got him booted to the Reds If he even halfway gave a s t he would still be with the Dodgers ,159,168,1374,1542,photo
CompanyJ_4238,Same kid dunked on em in back to back possessions via donovan_sanor alex16652587 ,81,1559,8699,10258,video
CompanyJ_4239,Rondo ,6,2083,15119,17202,photo
CompanyJ_4240,10 years ago today Cristiano scored a ROCKET in the UCL from almost 40 yards out It won him his first Puskas award via brfootball ,130,1106,6033,7139,video
CompanyJ_4241,Last night Charles challenged LeBron to come on Inside the NBA since he s not in the playoffs LBJ says he might take Chuck up on the offer ,139,524,4209,4733,photo
CompanyJ_4242,Spencer the Golden Retriever has been supporting Boston Marathon runners the last four years ,93,519,3255,3774,video
CompanyJ_4243,The Boston Marathon came down to a one block SPRINT via wbz ,60,983,7418,8401,video
CompanyJ_4244,LeBron during the playoffs ZeroDadThirty via HoHighlights ,58,4470,16298,20768,video
CompanyJ_4245,Joao Felix scored and then ran straight to celebrate with his brother who was on the sidelines as a ball boy via SLBenfica ,123,1271,7387,8658,video
CompanyJ_4246, I m f king unstoppable Giannis was letting everyone know ,58,5302,37409,42711,video
CompanyJ_4247,DeAndre Hunter has declared for the 2019 NBA Draft after dropping 27 PTS in the National Title Game ,100,475,4250,4725,photo
CompanyJ_4248,The Champions Season 2 is coming 4 29 brfootball ,49,158,1285,1443,photo
CompanyJ_4249,Painted KingJames while dribbling via bou_bou_design_ IG ,57,12004,50426,62430,video
CompanyJ_4250,Zion Williamson is declaring for the 2019 NBA draft ,52,4000,21863,25863,photo
CompanyJ_4251,KD and Pat Bev before tip off ,30,1109,6309,7418,video
CompanyJ_4252, There was a bridge CP3 can make a bounce pass from anywhere StateFarm ,71,148,968,1116,video
CompanyJ_4253,Throwing down with Alex Ovechkin is NOT a great idea via NBCSCapitals ,70,9071,31497,40568,video
CompanyJ_4254,Ben Simmons heard the boos He s got 7 points and 3 rebounds in the first 5 minutes of Game 2 ,93,292,2429,2721,photo
CompanyJ_4255,D Lo and the Nets are starting to heat up ,42,255,2164,2419,video
CompanyJ_4256,THE BOBAN GAME The big man s got 8 points already ,50,197,2245,2442,video
CompanyJ_4257,D Lo was making Embiid work for it ,35,1157,9838,10995,video
CompanyJ_4258,AI and Mutombo know Boban is a cheat code ,42,506,4846,5352,video
CompanyJ_4259,This marine ran the Boston Marathon to honor his fellow soldiers who didn t make it back from Afghanistan He crawled to the finish line RESPECT via dana_gio6 ,158,6657,47864,54521,video
CompanyJ_4260,OUCH Flagrant 1 for Embiid ,27,1756,12368,14124,video
CompanyJ_4261,That s cold Channing_Frye ,26,579,5838,6417,photo
CompanyJ_4262,Shoutout to the guy who gave Doc his 2K back after he dropped it on the street via LAClippers ,94,1516,11353,12869,video
CompanyJ_4263,Philly just dropped 51 in the 3rd ,34,562,4057,4619,photo
CompanyJ_4264,Harlan was hyped for the frosty ,32,1447,9744,11191,video
CompanyJ_4265,Ben Simmons triple double helps the 76ers tie the series ,57,407,2272,2679,photo
CompanyJ_4266,MMA future for JoelEmbiid ,26,358,2267,2625,video
CompanyJ_4267,Boogie heads to the locker room after an apparent leg injury Hope the big fella is okay ,88,655,4123,4778,video
CompanyJ_4268,Embiid apologized for his flagrant on Allen and Ben couldn t believe it via NBCSPhilly ,87,1311,8427,9738,video
CompanyJ_4269,Steph heatin up ,16,563,3528,4091,video
CompanyJ_4270,Pat Bev continues to bring the same energy ,43,474,4511,4985,video
CompanyJ_4271,Shaq via alexismorgan ,22,11595,41436,53031,video
CompanyJ_4272,There s significant concern that Boogie has suffered a torn left quad MRI will be done tomorrow per wojespn ,108,429,1934,2363,photo
CompanyJ_4273,Draymond waves goodbye to Pat Bev ,34,303,2427,2730,video
CompanyJ_4274,STEPH ,6,197,1401,1598,photo
CompanyJ_4275,CLIPPERS LEAD THIS GAME IS WILD ,32,690,3927,4617,photo
CompanyJ_4276,SHAMET BIG TIME ,16,1926,10120,12046,video
CompanyJ_4277,Warriors really blew a 31 point lead Man ,41,6316,27255,33571,photo
CompanyJ_4278,Familiar lead for the Warriors ,31,5233,23248,28481,photo
CompanyJ_4279,36 points 11 assists Lou Will is a certified bucket getter ,59,2898,22110,25008,photo
CompanyJ_4280,Russell Wilson becomes NFL s highest paid player after agreeing to 4 year 140M extension with 65M signing bonus per AdamSchefter ,129,2531,11961,14492,photo
CompanyJ_4281, ,1,10168,54636,64804,photo
CompanyJ_4282,Cold blooded shot ends a Long Night for the Dubs StateFarm ,59,422,3560,3982,video
CompanyJ_4283,Happy birthday to a legend kaj33 All time points leader 38 387 Record 6x MVP Record 19x All Star 6x NBA Champion 2x Finals MVP One of the greatest to play the game ,164,3179,18054,21233,photo
CompanyJ_4284,Ronaldo has scored 24 goals in the Champions League quarterfinals The next closest scorer only has 10 via brfootball ,117,589,3357,3946,video
CompanyJ_4285,This squad made the biggest playoff comeback ever Gallo Career was in doubt Shamet Tobias trade piece Green Undrafted overseas Lou Will Traded 2x in two years Trezl G League 5x trade throw in Pat Bev Grinded overseas before NBA chance LAC s got heart ,251,2986,22578,25564,photo
CompanyJ_4286,Shaq s 15 year old son Shaqir has a smooth game and is throwing down with ease ,79,433,3347,3780,video
CompanyJ_4287,Breanna Stewart has suffered a torn Achilles while playing overseas The WNBA champion was coming off an MVP season Prayers up for a speedy recovery ,148,1289,8248,9537,photo
CompanyJ_4288,Lost first leg at home vs PSG 2 0 Won second leg away 3 1 Advanced on away goals Don t count Manchester United out ,115,126,866,992,video
CompanyJ_4289,Pat Bev won t let up ,21,1973,15162,17135,photo
CompanyJ_4290,Ronaldo in the Champions League quarterfinals Has advanced to semifinals every time 11 11 Top scorer with 24 goals next closest has 10 Scored in last 6 appearances 2 hat tricks April 2016 and April 2017 via brfootball ,218,357,1745,2102,photo
CompanyJ_4291,Les Miles is taking on one of the worst programs in the country making less money after acting gigs for two years What s he doing at Kansas ,140,102,789,891,photo
CompanyJ_4292,On this day in 2000 the Patriots drafted TomBrady in the sixth round 199th overall Then he told Robert Kraft it was the best decision the team ever made via NFL ,161,791,3869,4660,photo
CompanyJ_4293,Messi rolls up rocking the Vegeta hat ,38,1951,12321,14272,video
CompanyJ_4294,Messi has arrived via brfootball ,33,481,2244,2725,video
CompanyJ_4295,Two goals in 4 minutes for Messi ,33,1986,7933,9919,video
CompanyJ_4296,Ronaldo now has TWENTY FIVE goals in the Champions League quarterfinals in only 22 games ,89,482,3159,3641,video
CompanyJ_4297,The best ,9,480,3154,3634,photo
CompanyJ_4298,Messi burned Phil Jones ,24,351,2132,2483,video
CompanyJ_4299,Coutinho with a STUNNER ,24,1345,6717,8062,video
CompanyJ_4300,DE LIGT PUTS AJAX AHEAD VS JUVENTUS ,36,315,1856,2171,video
CompanyJ_4301,Barcelona banish the quarterfinal ghosts and advance to the Champions League semis for the first time since 2015 ,113,292,1282,1574,photo
CompanyJ_4302,Patriots 10 year veteran Demaryius Thomas agree to a deal per FieldYates ,73,1019,4580,5599,photo
CompanyJ_4303,WHAT A WIN Ajax knocks Ronaldo and Juventus out of the Champions League via brfootball ,87,1030,3900,4930,photo
CompanyJ_4304,It takes more than one ,23,6820,28031,34851,photo
CompanyJ_4305,Ajax s Matthijs de Ligt is for real Only 19 years old First defender to win Golden Boy 2018 Youngest ever captain in a UCL knockout Youngest Ajax player to reach 100 games Scored winner to knock out Juventus ,208,1827,9303,11130,photo
CompanyJ_4306,Ajax in the Champions League this season Knocked out reigning champs Real Madrid Knocked out Ronaldo and Juventus Watch out via brfootball ,139,403,2177,2580,photo
CompanyJ_4307,10 year old went between the legs on the fastbreak via nba_tychaun ,67,520,3422,3942,video
CompanyJ_4308,ter Stegen with an incredible save ,35,137,1121,1258,video
CompanyJ_4309,The way Jimmy forced his way to the Sixers was wild Rewatch the last GameOfZones Next episode drops Thursday at 5ET StateFarm ,126,331,1513,1844,video
CompanyJ_4310,UCL heartbreak ,15,242,2366,2608,photo
CompanyJ_4311,After Game 1 Blazers and McCollum don t have to prove anything to Jennifer ,75,107,1056,1163,video
CompanyJ_4312,Keenan Allen on the KEYS Amazing cover of Daniel Caesar and H E R s song Best Part via Keenan13Allen ,101,274,1989,2263,link
CompanyJ_4313, DwyaneWade gives one final thank you to WadeCounty ,52,1527,9132,10659,video
CompanyJ_4314,The HoHighlights show is LIVE Look forward to special guest ZO2_ coming up soon ,80,12,98,110,link
CompanyJ_4315, This is gonna be awkward Lonzo only had Lakers shoes at the draft and wasn t ready to be drafted by anyone else via HoHighlights ,130,437,3751,4188,video
CompanyJ_4316,Lonzo wants to be in Space Jam 2 via HoHighlights ,50,256,1980,2236,video
CompanyJ_4317,Magic have 15 bench points All from former Raptor Terrence Ross ,64,177,2053,2230,video
CompanyJ_4318, Bust down my Swiss watch I m throwed off I just joined the big league Lonzo ZO2_ really appreciated 1future shouting him out on Crushed Up via HoHighlights ,157,168,1204,1372,video
CompanyJ_4319,Lonzo swears his team lost to LeBron s team 21 7 in their first 5 on 5 scrimmage Bron had all 21 via HoHighlights ,114,2197,11110,13307,video
CompanyJ_4320,Kawhi is dominant tonight 27 points on 11 13 shooting ,54,504,4157,4661,video
CompanyJ_4321,34 points 14 18 FG after 3 quarters Kawhi is feelin it Sheesh ,62,481,4186,4667,photo
CompanyJ_4322,Leonard and Lowry combine for 59 points to tie up series against the Magic 1 1 going to Orlando for game three ,111,236,2017,2253,photo
CompanyJ_4323,Bron let his teammates know the King had arrived ,49,4192,26981,31173,photo
CompanyJ_4324,Murray Runner Cash Nuggets lead ,32,87,879,966,video
CompanyJ_4325,CJ dances by Paul George NHTSAgov ,34,176,1297,1473,video
CompanyJ_4326,PUT THE TEAM ON YOUR BACK JAMAL 21 in the fourth for Murray ,60,2381,12187,14568,video
CompanyJ_4327,That s tough Dame ,18,752,5261,6013,video
CompanyJ_4328,Things are getting physical between Dame and Russ ,50,1823,13529,15352,video
CompanyJ_4329,3 J at the halftime buzzer Things are getting good in Portland ,63,325,2436,2761,video
CompanyJ_4330,Russ going all out in the playoffs ,35,199,1727,1926,video
CompanyJ_4331, TALK YOUR TALK DAME ,21,4960,28205,33165,video
CompanyJ_4332, Dame Time at the buzzer ,25,3406,17338,20744,video
CompanyJ_4333,Made threes for the series Damian Lillard 9 OKC 9 ,50,2163,13497,15660,photo
CompanyJ_4334,Steven Adams absolute unit ,27,889,8318,9207,video
CompanyJ_4335, ,1,1162,7404,8566,photo
CompanyJ_4336,Ajax s passing is mesmerizing via brfootball ,45,1648,12233,13881,video
CompanyJ_4337,Dame Time is ruling the Blazers OKC series so far Game 2 29 PTS 4 RBS 6 AST 3 STL Game 1 30 PTS 4 RBS 4 AST 3 STL ,114,1558,11820,13378,photo
CompanyJ_4338,Don t sleep on Toronto B R x beatsbydre ,40,129,1017,1146,video
CompanyJ_4339,Retirement Wade chugging wine on the golf course via DwyaneWade ,64,12611,89745,102356,video
CompanyJ_4340,Ronaldo out Real Madrid out The throne is up for grabs Follow brfootball for the best of the Champions League ,110,428,3453,3881,photo
CompanyJ_4341, Don t blame this on Eli Mind boggling that people think G Men should ve drafted a QB over me Saquon says stop hating on the Giants situation on a new Take It There with TaylorRooks ,182,368,1471,1839,video
CompanyJ_4342,Mo Salah is the cover of TIME s 100 Most Influential People ,60,886,5440,6326,photo
CompanyJ_4343,Steven Adams says Dame has to talk to his big man about the hard screen It might ve hurt but it s not my problem really ,120,805,7885,8690,video
CompanyJ_4344,Magic had no answer for Kawhi Jamal Murray was money down the stretch Dame Time has been 24 7 Catch up on last night s action ControlTheGame WellsFargo ,152,120,937,1057,video
CompanyJ_4345,Elijah Holyfield ran 4 78 and 4 8 40 yard dashes and is the 132nd best overall draft prospect It ll be an uphill battle to get drafted but like his dad Evander he s a fighter ,175,109,995,1104,photo
CompanyJ_4346,NBA Dance Cam pushed new boundaries this season via 15sof ,58,672,3886,4558,video
CompanyJ_4347,Porto s 21 year old Eder Militao is on course to be one of Europe s best defenders via brfootball ,98,131,1275,1406,video
CompanyJ_4348,MAN CITY 3 2 TOTTENHAM ,23,1144,5558,6702,photo
CompanyJ_4349,Sterling Son Son again Silva Sterling again IN 21 MINUTES ,58,727,3927,4654,video
CompanyJ_4350,What A First Half ,18,278,2208,2486,photo
CompanyJ_4351,Laid him out ,13,132,1167,1299,video
CompanyJ_4352,De Bruyne s run Aguero s finish Incredible ,43,170,1171,1341,video
CompanyJ_4353,This might be the goal that wins the tie for Tottenham ,55,86,706,792,video
CompanyJ_4354,Raheem Sterling almost had the winner at the death BUT IT WAS RULED OFFSIDE ,76,505,2763,3268,photo
CompanyJ_4355,The Champions League final four via brfootball ,47,902,3683,4585,photo
CompanyJ_4356,WHAT AN ENDING Video review rules no goal for Sterling via brfootball ,70,891,4414,5305,video
CompanyJ_4357, Winner in the 1st leg 2 of Tottenham s 3 goals in the 2nd Son was incredible vs Manchester City ,97,239,1903,2142,photo
CompanyJ_4358,Man City We re going to the semi final VAR ,43,418,2498,2916,photo
CompanyJ_4359,The curse is real via brfootball ,33,473,2789,3262,photo
CompanyJ_4360, ,1,1956,14028,15984,photo
CompanyJ_4361,Gronk used the Lombardi Trophy as a baseball bat and left a dent in it That retirement life is different via Patriots ,118,11740,50550,62290,video
CompanyJ_4362,Historic pay day timeless fit via DangeRussWilson ,50,456,5156,5612,photo
CompanyJ_4363,Stop that Kyrie ,16,2057,13450,15507,video
CompanyJ_4364,Uncle Drew cooked the Pacers for 18 PTS in the 1st half ,56,369,2131,2500,video
CompanyJ_4365, OneLastDance isn t over yet D Wade took time to sign autographs for every Miami Heat employee via dwyanewade IG ,113,1016,6979,7995,video
CompanyJ_4366,Giannis YAMS it on Thon ,24,2429,12571,15000,video
CompanyJ_4367, Playoff Tatum ,15,379,2658,3037,video
CompanyJ_4368,Uncle Drew is in that zone 14 0 run for the Celtics ,52,667,3764,4431,video
CompanyJ_4369,Tatum hits a three to give Boston the lead assists to extend it and dunks to seal it Celtics up 2 0 vs Pacers ,110,839,3549,4388,video
CompanyJ_4370,CLUTCH KYRIE ,13,1615,7642,9257,video
CompanyJ_4371,Giannis getting a bucket in all types of ways ,46,369,2993,3362,video
CompanyJ_4372,Harden would ve had one of the most disrespectful shots in NBA history if he made this ,87,7511,38084,45595,video
CompanyJ_4373,The Curse continues ,20,2253,13296,15549,photo
CompanyJ_4374,Zion changed the gender reveal game forever Baby gonna be a starter for Duke in 2037 via DukeMBB ,97,2291,15888,18179,video
CompanyJ_4375,Giannis won t leave Thon Maker alone tonight ,45,740,4886,5626,video
CompanyJ_4376,WOW HARDEN ,11,2158,11301,13459,video
CompanyJ_4377,Even down 20 Rubio isn t backing down from Harden ,50,351,4266,4617,video
CompanyJ_4378,Deuce ready to speak up for his dad Tatum via chrisgrenham ,59,397,4087,4484,video
CompanyJ_4379,Harden cooks up a triple double and powers the Rockets to a 2 0 lead ,69,1262,7056,8318,video
CompanyJ_4380,Both led their teams to big playoff wins Who s MVP ,51,280,3977,4257,photo
CompanyJ_4381,4 Sterling 7 10 Son 11 B Silva 21 Sterling 59 Aguero 73 Llorente VAR Goal stands 93 Sterling VAR No goal Tottenham win on away goals Instant Champions League classic via brfootball ,181,329,2863,3192,photo
CompanyJ_4382,8 year old has handles via sportychik23 IG ,43,4484,29738,34222,video
CompanyJ_4383,Harden says his journey is for Nipsey via NBATV ,48,4588,21285,25873,video
CompanyJ_4384,They re hooping on the airport tarmac via ryan_strobel47 ,57,4586,27712,32298,video
CompanyJ_4385,Tiger gets the MJ co sign ,26,2776,22352,25128,photo
CompanyJ_4386,KD has been doing his homework on this series via anthonyVslater ,65,759,5038,5797,video
CompanyJ_4387,12 years ago today Messi scored what was voted best Barcelona goal EVER via FCBarcelona ,88,2852,15574,18426,video
CompanyJ_4388,Tyree Jackson is one of the most intriguing NFL draft prospects Ran a 4 59 second 40 at 6 7 249 pounds Learned to throw by watching Tom Brady YouTube videos Has a hose for an arm But is he NFL ready ,199,343,2337,2680,photo
CompanyJ_4389, Let s f king go Brady s watching KyrieIrving via tombrady ,59,663,6372,7035,video
CompanyJ_4390,They drove 36 hours to the WRONG CITY via alvaroslb1994 IG ,59,511,3157,3668,video
CompanyJ_4391,Game 1 Nets Game 2 Sixers Game 3 ,33,204,2097,2301,video
CompanyJ_4392,Lacazette from 30 yards out for Arsenal WOW ,44,577,3427,4004,video
CompanyJ_4393, The Suns trade for the wrong Brooks CJ writes a letter to Jennifer Dame drops some bars on the Dubs New GameOfZones StateFarm ,127,2244,7307,9551,video
CompanyJ_4394,The disrespect has reached a new level via APOOCH ,50,7400,30303,37703,photo
CompanyJ_4395,The attitude of the Bay is second to none B R x beatsbydre ,59,263,1401,1664,video
CompanyJ_4396,David Luiz found his twin on the opposing team via DavidLuiz_4 ,63,1026,6657,7683,photo
CompanyJ_4397,That Philly energy B R x beatsbydre ,36,228,1079,1307,video
CompanyJ_4398,Do the Giants need to draft a QB ,33,167,1396,1563,photo
CompanyJ_4399,D Lo s number 1 fan in the building for Game 3 ,47,1281,13281,14562,photo
CompanyJ_4400,Jarrett Allen too strong Barclays is LIVE early ,48,365,3032,3397,video
CompanyJ_4401,Shabazz got way too hyped on Allen s dunk Just ask Rondae via shaqtin ,70,318,2186,2504,video
CompanyJ_4402,GO AHEAD CARIS ,15,231,2147,2378,video
CompanyJ_4403,Caris opened the 2Q scoring 14 STRAIGHT points ,47,396,2560,2956,video
CompanyJ_4404,Caris is locked in on and off the court ,40,183,2222,2405,video
CompanyJ_4405,SIMMONS STAREDOWN ,18,570,3290,3860,video
CompanyJ_4406,What an incredible proposal idea via DChrisman91 ,49,3053,18399,21452,video
CompanyJ_4407,Steph making the logo look like the 3PT line via PaoloUggetti ,62,479,3272,3751,video
CompanyJ_4408,Ref holds back Greg Monroe ,27,102,960,1062,video
CompanyJ_4409,Dudley had no chance ,21,223,2564,2787,video
CompanyJ_4410,Simmons reaction after Dudley s airball ,40,953,5678,6631,video
CompanyJ_4411, Talented enough to take a 31 point lead careless enough to blow it HowardBeck breaks down the Warriors rollercoaster start to the playoffs ahead of Game 3 ,156,56,463,519,video
CompanyJ_4412,Dudley complained to the refs Ben Simmons just smirked ,55,436,3219,3655,video
CompanyJ_4413, Who let it rip ,16,3078,16308,19386,video
CompanyJ_4414,Express yourself Ben ,21,731,4993,5724,video
CompanyJ_4415, Just average ,14,1342,7190,8532,photo
CompanyJ_4416,A playoff career high for Ben Simmons He heard the chatter ,59,2798,10646,13444,photo
CompanyJ_4417,Early foul trouble for KD Pat Bev is here for it ,49,276,2451,2727,video
CompanyJ_4418,KD playing no games Starts off a perfect 5 5 from the floor ,60,425,2954,3379,video
CompanyJ_4419,Steph and KD outscored the Clippers in the 1Q ,46,458,2738,3196,video
CompanyJ_4420,Simmons is over the Jared Dudley drama I don t really have energy for it man via SNYtv ,87,414,2784,3198,video
CompanyJ_4421,KD called the ISO and Pat Bev got hit with the foul immediately ,64,539,5306,5845,video
CompanyJ_4422,KD cannot be stopped and Pat Bev looks defeated ,48,1213,8035,9248,video
CompanyJ_4423,You can t do that Beverley ,27,272,3264,3536,video
CompanyJ_4424,Warriors up 31 midway through the 3Q ,37,412,3921,4333,photo
CompanyJ_4425,Pat Bev got his way in Game 2 Game 3 KD silenced Pat Bev with 38 PTS on 14 23 shooting ,87,407,3302,3709,photo
CompanyJ_4426,Wednesday I m Kevin Durant You know who I am Thursday 38 PTS 60 FG 30 MIN ,74,4791,27019,31810,video
CompanyJ_4427,Gilbert Arenas says he is the GOAT because he made 62M while only playing 17 games I wasn t gonna complain via FairGameonFS1 ,125,4897,31543,36440,photo
CompanyJ_4428,Happy birthday to hoops icon Candace Parker WNBA champ 2x MVP Finals MVP 5x All Star Rookie of the Year 2x NCAA champ 2x Olympic gold ,134,1278,7466,8744,photo
CompanyJ_4429,Wonder how LaVar is gonna feel about this via RockRollG ,56,656,5083,5739,photo
CompanyJ_4430,On this day in 2010 LeBron HAMMERED one of his meanest dunks ever over James Johnson ,85,8013,36535,44548,video
CompanyJ_4431,Russ and Dame s beef goes way beyond this year s playoffs ,58,2359,12560,14919,video
CompanyJ_4432,Jalen Hurd abruptly switched from RB to WR Scouts weigh in on why that makes him the perfect chess piece in the NFL draft ,122,130,1034,1164,photo
CompanyJ_4433,Chauncey Billups and Wolves will meet in the near future to discuss the President of Basketball Ops role per ShamsCharania JonKrawczynski ,138,274,1967,2241,photo
CompanyJ_4434,This beauty from Messi won UCL Goal of the Week ,48,404,3256,3660,video
CompanyJ_4435,KD vs Pat Bev Russ vs Dame and critical Game 3s and 4s Ready for more NBA playoffs this weekend trboxing ,105,93,833,926,video
CompanyJ_4436,T Ross half court buzzer beater like it s nothing Magic down 3 at the half via NBA ,83,522,4232,4754,video
CompanyJ_4437,Unbothered ,11,537,4338,4875,photo
CompanyJ_4438,Kyrie chasedown block via NBA ,30,2750,19674,22424,video
CompanyJ_4439,Ending of Raptors Magic was wild Orlando almost completes comeback misses huge opportunity ,91,246,1937,2183,video
CompanyJ_4440,Pascal s improvement continues in the postseason ,49,219,2163,2382,photo
CompanyJ_4441,Russ drops it off to Steven Adams for the via NBA ,50,206,2441,2647,video
CompanyJ_4442,Kyrie is at his best in the 4Q Uncle Drew took over late and led the Celtics to a 3 0 series lead ,98,1181,6015,7196,video
CompanyJ_4443,W E S T B R K Russ denies Dame at the rim and let s him know about it after via okcthunder ,91,3210,14828,18038,video
CompanyJ_4444,2nd fan of the night to win 20K in OKC via NBA ,47,525,5382,5907,video
CompanyJ_4445,25 for Dame in the 3rd You know what time it is in the 4th ,59,1007,5582,6589,photo
CompanyJ_4446,Brodie took it to Dame in Game 3 ,33,2159,9035,11194,video
CompanyJ_4447,,0,1711,9195,10906,photo
CompanyJ_4448,PG really threw down a reverse double pump dunk with time expiring ,67,5812,32798,38610,video
CompanyJ_4449,Dennis Schröder was trying to get in Dame s head all game ,58,1070,6942,8012,video
CompanyJ_4450,Dame thought it was funny that Schroder trolled him via NBAonTNT ,65,1664,10046,11710,video
CompanyJ_4451,Russ continues to give this reporter the silent treatment during postgame interviews via NBCSNorthwest ,103,1027,5488,6515,video
CompanyJ_4452,Russ took over at home in Game 3 33 PTS 11 AST 5 RBS ,53,460,4462,4922,photo
CompanyJ_4453,Three days after Tottenham knocked them out of the UCL Man City gets their revenge in a 1 0 win to go 1st in the Premier League ,128,73,625,698,photo
CompanyJ_4454,Jordan set the playoff scoring record at 23 33 years ago today he dropped 63 on the Celtics without shooting a three via NBAHistory ,132,4155,17861,22016,video
CompanyJ_4455,This whiteboard DwyaneWade mural is unbelievable via jcoreyartist IG ,69,17089,71705,88794,video
CompanyJ_4456,Tobi and Bobi s bromance could bring any team s chemistry to the next level ,76,1567,12416,13983,video
CompanyJ_4457,Louis Hedley has been getting tatted up since he was 15 and even owned a tattoo parlor in Bali Now at 25 the 6 4 233 pound Aussie will be punting at the University of Miami with dreams of the NFL ,196,312,1739,2051,photo
CompanyJ_4458,We need mics on Russ and Dame for this battle ,46,19642,81925,101567,video
CompanyJ_4459,How does Giannis taking off from the FT line fire up the Bucks Brook Splash Mountain Lopez gives an inside look at his team in his first Playoff Diary From B R x WellsFargo ,173,81,760,841,video
CompanyJ_4460,Manchester United Real Madrid Juventus Ronaldo wins his third different league title via brfootball ,100,1046,3976,5022,photo
CompanyJ_4461,Behind the scenes of D Lo s first playoff home game with a surprise visit from his buddy KAT ,93,784,4896,5680,video
CompanyJ_4462,Chucks says we need more matchups like Russ Dame I wanna see some more spice via NBAonTNT ,90,2006,11942,13948,video
CompanyJ_4463,Zlatan keeps flexing his karate skills in game via UnivisionSports ,67,125,1069,1194,photo
CompanyJ_4464,LeVert on Embiid Dudley steal off Simmons Nets coming in hot ,61,1180,7032,8212,video
CompanyJ_4465,Boban didn t even flinch D Lo still finished ,45,432,4797,5229,video
CompanyJ_4466,Too big Too strong Too Boban ,29,500,4060,4560,video
CompanyJ_4467,BEN VS DUDLEY IS GETTING GOOD ,30,3964,23348,27312,video
CompanyJ_4468,WHATS GOING ON ,15,495,3572,4067,photo
CompanyJ_4469,Jared Dudley vs EVERYBODY ,26,10987,47699,58686,video
CompanyJ_4470,Jared Dudley and Jimmy Butler ejected for the melee Embiid gets a Flagrant 1 ,77,2482,11028,13510,video
CompanyJ_4471,Philly s locked in Embiid delivering kung fu close outs Still not enough to slow down Dinwiddie s fire ,103,219,1640,1859,video
CompanyJ_4472,Coach went DOWN ,16,2136,9616,11752,video
CompanyJ_4473,Fro caught the lob over Embiid ,31,691,4881,5572,video
CompanyJ_4474,THIS GAME ,10,906,6493,7399,video
CompanyJ_4475,The Process delivers 31 PTS 16 REB 7 AST 6 BLK Sixers take a 3 1 lead on Brooklyn ,82,1466,6482,7948,photo
CompanyJ_4476,Embiid going off during and after the game ,43,475,3143,3618,photo
CompanyJ_4477,Embiid and the Sixers want all the smoke ,41,475,3829,4304,photo
CompanyJ_4478, ,1,505,4917,5422,photo
CompanyJ_4479,This Derrick White story The Spurs guard went to D II Colorado Springs for three years on a partial scholarship Once he got his NBA deal one of his first moves was paying off student loans ,189,1018,6738,7756,video
CompanyJ_4480,GOODNESS JAMAL ,15,635,3919,4554,video
CompanyJ_4481,DeMar pulled it way back ,25,1319,10284,11603,video
CompanyJ_4482,DeMar CHUCKED the ball at the ref and got ejected after getting called for a charge ,84,2683,14691,17374,video
CompanyJ_4483,Giannis euro steps are too smooth via Bucks ,44,319,3209,3528,video
CompanyJ_4484,The Bucks assistant made sure no one cleared the bench ,55,7494,46921,54415,video
CompanyJ_4485,Jazz are getting into it with Harden ,37,411,4179,4590,photo
CompanyJ_4486,HALF MAN HALF SPIDA via utahjazz ,33,673,4997,5670,video
CompanyJ_4487,Oh my this behind the back on Harden via utahjazz ,50,1670,12766,14436,video
CompanyJ_4488,Harden is now 0 14 with 8 PTS late in the 3Q ,45,575,3565,4140,photo
CompanyJ_4489,Harden came up CLUTCH despite a rough shooting night Rockets take 3 0 series lead ,82,1027,6105,7132,video
CompanyJ_4490,When you go 3 20 but still get the W ,37,5806,30993,36799,video
CompanyJ_4491,Rockets prevailed despite Harden s historically poor shooting night ,68,560,3353,3913,photo
CompanyJ_4492,Harden had no idea he started Game 3 shooting 0 for 15 His reaction to finding out ,83,2350,16199,18549,video
CompanyJ_4493,Dad instincts kicked in during the Sixers Nets fight ,53,4179,40017,44196,video
CompanyJ_4494,Dirk took out a full page ad thanking fans in Dallas via SportsDayDFW ,70,2291,13848,16139,photo
CompanyJ_4495,Jimmy Butler tells the 76ers equipment manager to GTFO his seat before every game NFSW via jimmybutler YouTube thebobbyshaw33 Reddit ,133,16747,94030,110777,video
CompanyJ_4496,After his media session Kyle Korver called everyone back to say this about Donovan Mitchell Wow via JakeKUTV ,109,19345,104022,123367,video
CompanyJ_4497,Dame vs Russ It s supposed to be SPICY ,39,1909,8279,10188,video
CompanyJ_4498,Kyrie has the highest playoff winning percentage in NBA history 76 4 Min 50 games H T NBA Countdown ,100,6945,38097,45042,photo
CompanyJ_4499,An animator made this flip book for Tiger Woods Master s win via TheFlippist ,77,1959,11304,13263,video
CompanyJ_4500,Myles Turner with a BODY via Pacers ,36,3591,15630,19221,video
CompanyJ_4501,Uncle Drew iso Unfair via celtics ,34,4413,23052,27465,video
CompanyJ_4502,How did Kyrie make this pass via Celtics ,41,1463,9044,10507,video
CompanyJ_4503,The sweep is COMPLETE Seven Boston players score in double figures as Celtics beat Pacers 110 106 ,98,1598,6831,8429,photo
CompanyJ_4504,Ankles are not safe around Kyrie nhtsagov ,42,579,3417,3996,video
CompanyJ_4505,KLAY GOT THE HOT HAND 17 PTS in the 1st 3 threes ,49,347,2782,3129,photo
CompanyJ_4506,Mbappe Hat trick ,17,239,2319,2558,photo
CompanyJ_4507,Shai pulled out the Rondo fake via LAClippers ,46,426,3406,3832,video
CompanyJ_4508,Shai s 25 PTS is the most by a Clippers rookie in the playoffs in franchise history ,84,633,5774,6407,photo
CompanyJ_4509,Klay could not be stopped in Game 4 32 PTS 6 9 from 3PT Warriors take 3 1 series lead ,86,535,3352,3887,video
CompanyJ_4510,Klay ,5,1087,8961,10048,video
CompanyJ_4511,Shaq went all out tonight via NBAonTNT ,39,1035,5961,6996,video
CompanyJ_4512,Ciara getting Russ right for Easter via DangeRussWilson ,56,1038,6810,7848,video
CompanyJ_4513,Klay said he jumped in the ocean to get right for Game 4 via NBATV ,67,670,5397,6067,video
CompanyJ_4514,Kawhi brought out the and slam on the break ,44,394,4000,4394,video
CompanyJ_4515,Terrence Ross AGAIN at the buzzer ,34,239,2142,2381,video
CompanyJ_4516,Kawhi making it happen on both ends ,36,279,2531,2810,video
CompanyJ_4517,The Klaw did it all in Game 4 34 PTS 6 REBS 2 STLS 2 BLKS Raptors run away with the W to take 3 1 series lead ,110,447,3004,3451,video
CompanyJ_4518,Dame vs Russ Part 4 ,20,3263,21163,24426,photo
CompanyJ_4519,Russ stares down the Portland bench after pulling up in front of Dame ,70,544,3919,4463,video
CompanyJ_4520,Raymond Felton is READY ,24,378,2945,3323,video
CompanyJ_4521,RUSS AND OKC ARE FEELIN IT ,27,1213,8924,10137,video
CompanyJ_4522,Can t try to take Shaq down without at least 3 people via NBAonTNT ,67,1074,6922,7996,video
CompanyJ_4523,Dame Dolla is heating up ,25,1434,8751,10185,video
CompanyJ_4524,Dame dropped 15 PTS in the 3Q ,30,630,4249,4879,video
CompanyJ_4525,M C C L L U M ,14,1055,9574,10629,video
CompanyJ_4526,Game 4 Blazers take the W over the Thunder Dame 24 PTS 8 AST CJ 27 PTS 5 3PM 3 1 lead for Portland ,99,1084,6231,7315,photo
CompanyJ_4527, You don t just become the 3rd seed luckily especially two times in a row Dame talks overcoming adversity and injuries up 3 1 on Thunder via NBATV ,147,1901,14125,16026,video
CompanyJ_4528,No more Next question for Russ Now it s Not sure via bengolliver ,65,622,4904,5526,video
CompanyJ_4529,Dame chanting MVP at Russ during the 2015 All Star Game How times change ,73,1563,15115,16678,video
CompanyJ_4530,PAOK fans celebrate winning the Greek league for the first time since 1985 via shumansko ,89,420,2316,2736,video
CompanyJ_4531,Now that s teamwork via rene_casselly IG ,41,5515,33605,39120,video
CompanyJ_4532,Muhammad Ali portrait made out of broken glass and crystals via missvllison ,76,465,3912,4377,photo
CompanyJ_4533, You have to enjoy the moment Ibra_official takes time right before a game to give a young fan some advice via AdamSerrano ,123,946,6579,7525,video
CompanyJ_4534,Happy 33rd birthday to Beast Mode himself MoneyLynch Super Bowl champion 5x Pro Bowl 2013 amp 2014 rushing TD leader via nflthrowback ,134,3834,18081,21915,video
CompanyJ_4535,15 years ago today Pat Tillman was killed on patrol in Afghanistan ,67,1919,13234,15153,photo
CompanyJ_4536,Montez Sweat overcame getting kicked out of school and an unexpected health scare to make NFL combine history NFL execs weigh in on the elite prospect s future ,160,65,506,571,photo
CompanyJ_4537,She s got the hesi down at 7 years old via teamkennard88 IG ,60,3394,16873,20267,video
CompanyJ_4538, Celtics SWEEP the Pacers back to Indy Klay amp KD put on a show in LA for GSW The Klaw dominated in Orlando Dame and the Blazers hold OKC under 100 PTS AGAIN Catch up on yesterday s action ControlTheGame WellsFargo ,216,110,918,1028,video
CompanyJ_4539,THE DISRESPECT via gimnasiaoficial ,35,1549,7256,8805,video
CompanyJ_4540,Filthy footwork from Hazard on the assist via NBCSportsSoccer ,62,402,2641,3043,video
CompanyJ_4541,Cassius Stanley is officially a Duke Blue Devil ,48,3335,15626,18961,photo
CompanyJ_4542,Cassius Stanley is gonna look good in Cameron Indoor Stadium next season ,73,1180,5696,6876,video
CompanyJ_4543,Mbappe hitting Usain Bolt speeds in game via brfootball ,56,973,5819,6792,photo
CompanyJ_4544,3 year old goes yard dog fetches it via ryanmercier93 IG ,57,397,3685,4082,video
CompanyJ_4545,New Champions season same dysfunctional house Season 2 drops April 29th ,72,75,529,604,video
CompanyJ_4546,Duke s 2019 class is looking stacked No 4 recruit Vernon Carey Jr No 8 recruit Matthew Hurt No 23 recruit Wendell Moore No 29 recruit Cassius Stanley No 32 recruit Boogie Ellis ,177,3770,15767,19537,photo
CompanyJ_4547, JHarden13 can dribble himself out of any problem StateFarm ,60,201,1096,1297,video
CompanyJ_4548,That was nasty Blake ,21,331,3148,3479,video
CompanyJ_4549,BLAKE ,6,502,4027,4529,video
CompanyJ_4550,OH MY GIANNIS ,14,1190,6975,8165,video
CompanyJ_4551,Giannis on Thon Maker SHEESH MetroByTMobile ,44,402,2283,2685,video
CompanyJ_4552,Former SportsNet LA host Kelli Tennant files lawsuit saying Luke Walton sexually assaulted her in May 2017 per TMZ ,115,886,2840,3726,photo
CompanyJ_4553,Giannis went MJ on the double pump and Drummond was baffled ,60,4321,21602,25923,video
CompanyJ_4554,Blake joined in with the crowd on refs you suck chant ,54,4272,33039,37311,video
CompanyJ_4555,Blake got in his Dirk bag on this fadeaway ,43,933,11168,12101,video
CompanyJ_4556,Bryce was fed up via SNYtv ,27,387,3117,3504,video
CompanyJ_4557,Giannis drops 41 amp leads the Bucks to their first playoff series win since 2001 ,82,1657,11337,12994,photo
CompanyJ_4558,Giannis becomes 1st Bucks player since Michael Redd to drop 40 PTS in a playoff game ,85,408,2885,3293,video
CompanyJ_4559,The Pistons playoff woes continue todaysmilitary ,49,147,1018,1165,video
CompanyJ_4560,Blake Griffin played the majority of the series injured Tonight he checked out to a standing ovation with Pistons legend Ben Wallace in attendance ,147,2163,17769,19932,video
CompanyJ_4561,Harden step back on Spida Tough ,32,527,4192,4719,video
CompanyJ_4562,Crowder is FEELING IT ,22,217,2254,2471,video
CompanyJ_4563,Giannis reflects on what it means to win his 1st playoff series with the Bucks via NBATV ,89,422,3607,4029,video
CompanyJ_4564,That s cold Harden ,19,754,6098,6852,video
CompanyJ_4565,Suns have fired head coach Igor Kokoskov per wojespn ,53,242,1411,1653,photo
CompanyJ_4566,SPIDA AND THE JAZZ HAVE COME ALIVE ,35,342,2580,2922,video
CompanyJ_4567,SPIDA GOT UP ,13,671,4274,4945,video
CompanyJ_4568,Into the Spida Verse Donovan Mitchell drops 31 to keep Utah s season alive ,75,1238,10301,11539,photo
CompanyJ_4569,The Rockets couldn t figure out how to sweep in Utah ,53,7817,41407,49224,video
CompanyJ_4570,Donovan Mitchell took over the 4Q and outscored the Rockets 19 12 to avoid a series sweep ,90,622,3572,4194,video
CompanyJ_4571, Forget me Jae Crowder played his ass off via NBAonTNT ,55,1871,15670,17541,video
CompanyJ_4572,Things are getting wild on the TNT set via NBAonTNT ,52,6029,31764,37793,video
CompanyJ_4573,Cole Anthony the no 1 PG in the class of 2019 is a North Carolina commit ,73,9750,39783,49533,photo
CompanyJ_4574,Cole Anthony was a walking triple double at Oak Hill He ll be looking to do more of the same at UNC ,100,1085,6130,7215,video
CompanyJ_4575,Four teams left One week from today the Champions League battle continues via brfootball ,89,186,1394,1580,photo
CompanyJ_4576,26 years ago today Shaq tore down the entire backboard as a rookie MONSTER ,75,17073,75464,92537,video
CompanyJ_4577,Bucks haven t made it out of the first round since 2001 That year they lost to Iverson s 76ers in an epic 7 game Conference Finals ,131,514,4484,4998,photo
CompanyJ_4578,Two years ago today Messi scored his 500th Barcelona goal It won that El Clasico and he followed it with one of the most iconic celebrations ever via beINSPORTSUSA ,164,2883,10395,13278,video
CompanyJ_4579,David Sills committed to USC at 13 years old the youngest QB recruit in history Now he s projected to be a middle round pick at the NFL Draft as a WR ,150,2022,13950,15972,video
CompanyJ_4580, GridironHeights NFL Draft Special Kyler Bosa and D K are looking for jobs on career day ,89,883,3647,4530,video
CompanyJ_4581,Raheem Sterling is fighting for the future via brfootball ,58,899,5535,6434,photo
CompanyJ_4582,Scouts are split on what RB Josh Jacobs will bring to the NFL Is he really a violent runner similar to Marshawn Lynch or will his lack of usage in college hurt him ,164,42,456,498,photo
CompanyJ_4583,Had Kanye slipping via FrencHMonTanA ,37,1422,8137,9559,video
CompanyJ_4584,Shane Long just scored the fastest goal EVER in the Premier League 7 seconds via NBCSportsSoccer ,97,639,3940,4579,video
CompanyJ_4585,What was it like to be in Chris Davis 0 for 54 slump Players like former teammate Manny Machado weigh in on the struggle and how good it feels to finally get a hit so good that Davis wanted to keep the ball ,207,27,230,257,photo
CompanyJ_4586,Twins came up clutch with the assist via M_Ryan02 ,50,514,4140,4654,video
CompanyJ_4587,Blake shook hands with every media member after his last press conference of the season via local4news ,103,3593,36804,40397,video
CompanyJ_4588,HoFer Dwight Stephenson preaches to draft prospect Jawaan Taylor about nimble footwork when being effective at the line From Ford X B R ,136,142,511,653,video
CompanyJ_4589,The Blazers tried to recruit Boogie but he just talked trash and signed with the Warriors Rewatch the last GameOfZones Next episode drops EARLY Thursday at 12 ET StateFarm ,172,260,1281,1541,video
CompanyJ_4590,Embiid ready to roll in Game 5 ,31,130,1090,1220,video
CompanyJ_4591,Jared Dudley s reception from the Philly crowd via APOOCH ,58,197,1344,1541,video
CompanyJ_4592,,0,1637,9752,11389,photo
CompanyJ_4593,Simmons puts the cap on a strong quarter with this ,51,244,1504,1748,video
CompanyJ_4594,Sixers are up big on the Nets and Embiid is talking that talk ,62,296,2093,2389,video
CompanyJ_4595,Only one hand free for Kawhi No problem ,40,532,4378,4910,video
CompanyJ_4596,Raps move on Raptors beat the Magic 115 96 to advance to the second round Kawhi 27 PTS 7 REBS ,94,330,2827,3157,photo
CompanyJ_4597,Drake trying to end his curse ,30,490,4901,5391,photo
CompanyJ_4598,Sixers advance Embiid amp Simmons get the last laugh ,53,3520,15251,18771,video
CompanyJ_4599,Raptors vs Sixers in the second round Kawhi has never lost a game to Philly He s 13 0 against the 76ers h t joshschuhmann ,122,922,5264,6186,photo
CompanyJ_4600,PG doesn t wanna go home early ,31,289,2179,2468,video
CompanyJ_4601,BRODIE SAID NO ,15,413,2839,3252,video
CompanyJ_4602,Dame Time started early tonight 1Q 19 PTS 3 4 3PT ,50,485,3650,4135,video
CompanyJ_4603,Dame has 27 points in the first 17 minutes SHEESH ,50,1488,9677,11165,photo
CompanyJ_4604,Dame Ridiculous ,16,763,4520,5283,video
CompanyJ_4605,DAME IS GOING OFF 34 PTS 6 9 3PM Blazers lead 61 60 at the half ,64,863,4578,5441,photo
CompanyJ_4606,Dame picks up where he left off in the first half 37 for 0 ,59,743,4627,5370,video
CompanyJ_4607,DAME TIME IN PORTLAND 42 POINTS ,32,1824,9409,11233,video
CompanyJ_4608,DAME STILL HOT ,15,429,3431,3860,video
CompanyJ_4609,OH MY DAME FOR THE WIN ,23,3101,12302,15403,photo
CompanyJ_4610,It s Lillard s Time Dame drops 50 as Portland ends OKC s season ,64,4741,20211,24952,photo
CompanyJ_4611,DAME FOR THE WIN ,17,81133,202796,283929,video
CompanyJ_4612,Different series Same Dame You already know what time it is ,60,11742,46513,58255,video
CompanyJ_4613, Talk your talk Dame_Lillard ,29,3498,15735,19233,photo
CompanyJ_4614,Dame waved goodbye to OKC ,26,11561,51133,62694,video
CompanyJ_4615,EndDame via DuaneBrown76 ,25,10289,44734,55023,video
CompanyJ_4616,Dame knew the shot was going in when it left his hands via NBATV ,65,1274,8538,9812,video
CompanyJ_4617,Mic drop ,9,13747,63612,77359,video
CompanyJ_4618,Marshawn Lynch is not planning to play football again per AdamSchefter ,71,707,4068,4775,photo
CompanyJ_4619,Dame over ,10,2117,16979,19096,photo
CompanyJ_4620,Ed Reed became a defensive legend training the mind before body teaching prospect DeAndre Baker how to be a student of the game at DB From Ford X B R ,150,165,861,1026,video
CompanyJ_4621,Enes Kanter thanked the Knicks for waiving him because now he s in the second round via BenGolliver ,100,1264,10746,12010,video
CompanyJ_4622,The Egyptian King and Queen Daenerys MoSalah x Emilia Clarke ,61,363,3871,4234,photo
CompanyJ_4623,Clippers look to save their season against the Warriors tonight Who s the better defender Patrick Beverley or Draymond MyStraightTalk ,134,1047,11487,12534,status
CompanyJ_4624,Parris Campbell is as talented as any receiver prospect but HOF WR Paul Warfield teaches small tricks that separate the greats From Ford X B R ,143,70,441,511,video
CompanyJ_4625,Tough ,6,1478,16138,17616,photo
CompanyJ_4626,Everybody watching Dame_Lillard ,32,1034,6868,7902,photo
CompanyJ_4627,Rudy Gobert still thinks about the players selected before him when he fell to 27th in the Anthony Bennett draft The Jazz star opened up about the chip he plays with on a new Take It There with TaylorRooks ,206,92,505,597,video
CompanyJ_4628,3 star QB 2nd round pick as a RB David Montgomery is looking to become the 1st Iowa St player drafted in five years ,116,303,1788,2091,video
CompanyJ_4629, ,1,5460,35727,41187,photo
CompanyJ_4630,Dusan Tadic s season for Ajax has been unreal via brfootball ,61,365,3115,3480,photo
CompanyJ_4631,They don t call him Logo Lillard for nothing ,45,2452,15581,18033,video
CompanyJ_4632, Down 3 0 heading into the 3rd Scored 4 goals in 4 minutes Won 5 4 in OT The Sharks Game 7 comeback was EPIC via NHL ,117,863,4702,5565,video
CompanyJ_4633, via Dame_Lillard ,18,5652,26950,32602,photo
CompanyJ_4634, ,1,4538,27304,31842,photo
CompanyJ_4635,15 years ago today Eli Manning forced his way out of San Diego After selecting him with the No 1 pick the Chargers traded Eli to the Giants for No 4 pick Philip Rivers and three additional picks Ben Roethlisberger ended up sliding to pick No 11 ,245,334,2112,2446,photo
CompanyJ_4636, Marta is probably the best player that we ve ever seen The USWNT s mPinoe gives her Mount Rushmore of women s soccer via brfootball ,133,375,2421,2796,video
CompanyJ_4637, Dame_Lillard said this two weeks ago on Take It There with TaylorRooks ,72,562,3156,3718,video
CompanyJ_4638,LEROY SANE 2 0 to Manchester City via NBCSportsSoccer ,54,195,1155,1350,video
CompanyJ_4639,They ran a quick play action after that BOMB via ChrisBurke02 ,62,705,4792,5497,video
CompanyJ_4640,Stephen Jackson and Darius Miles balled out with the young stars at IversonClassic practice in shades ,102,494,2664,3158,video
CompanyJ_4641,The end of an era New GameOfZones drops EARLY Thursday at 12pm ET ,66,87,936,1023,photo
CompanyJ_4642,Dame s series clinching shot meant a lot more than just beating OKC for the Trail Blazers HowardBeck warns don t underestimate them ,132,130,1223,1353,video
CompanyJ_4643,What s the Rockets mindset heading into Game 5 How has Donovan Mitchell impressed Kenneth Faried dishes in his first playoff diary From B R x WellsFargo ,153,31,334,365,video
CompanyJ_4644,Only thing different about the swing is the batting gloves ,59,1724,14498,16222,photo
CompanyJ_4645,Can Donovan Mitchell keep Utah s season alive against Houston Jazz vs Rockets Game 5 next on NBAonTNT ,102,95,1009,1104,video
CompanyJ_4646,Harden missed a wide open dunk ,31,397,3912,4309,video
CompanyJ_4647,CP3 is here to advance ,23,184,1580,1764,video
CompanyJ_4648,Rockets move on Houston beats Utah 100 93 Harden 26 PTS 6 REBS 6 ASTS 3 STLS 4 BLKS ,84,716,3159,3875,photo
CompanyJ_4649,CP3 wasn t feeling it ,22,3597,30234,33831,video
CompanyJ_4650,YOU CAN T SEE BEV ,18,552,5092,5644,video
CompanyJ_4651,Capela wants the Warriors CP3 via NBATV ,40,2439,13778,16217,video
CompanyJ_4652,Pat Bev draws a charge with one shoe on Draymond gets a tech This game is WILD ,79,759,5853,6612,video
CompanyJ_4653, MVP Dubs heating up KD getting love ,37,157,1336,1493,video
CompanyJ_4654,KEVIN DUR4NT ,13,338,2322,2660,video
CompanyJ_4655,Trezz with the CLUTCH block ,28,681,4063,4744,video
CompanyJ_4656,KD gives the Warriors the lead Lou Will answers right back Sixth Man of the Century ,84,2023,11947,13970,video
CompanyJ_4657,6 MAN LIKE Lou Will drops 33 and 10 to keep the Clippers alive Wow ,67,2989,20948,23937,photo
CompanyJ_4658,Scary Hours ,12,812,6332,7144,photo
CompanyJ_4659,IT S DRAFT DAY ,15,418,2606,3024,photo
CompanyJ_4660,Lou s night ,12,380,5628,6008,photo
CompanyJ_4661,Tim Duncan turns 43 today with one of game s most untouchable resumes 2x MVP 5x champion 3x Finals MVP 15x All NBA 15x All Defense Titles in three decades 1 158 total career wins 50 wins in 18 seasons ,201,10244,47194,57438,photo
CompanyJ_4662,MLB draftee NFL QB Kyler Murray isn t the first QB prospect to turn down the Show for the League ,97,466,4062,4528,photo
CompanyJ_4663,Famous for his title celebrations and an Academic Heisman winner Clemson s Christian Wilkins might be the most interesting man in the 2019 NFL Draft ,149,280,2087,2367,video
CompanyJ_4664,245 lbs in EACH HAND via larrywheels IG ,40,6385,36221,42606,video
CompanyJ_4665, Gods plan Kyle Lowry loses it when the Raptors trade DeMar GameOfZones StateFarm ,82,4191,12694,16885,video
CompanyJ_4666,Pepper Redmond Ashton Dulin DeAndre Hopkins Davante Adams and Christian McCaffrey have to decide Prospect or made up ,117,213,1144,1357,video
CompanyJ_4667,RUDE via FOXFOOTBALL ,21,572,3343,3915,video
CompanyJ_4668, imanshumpert was gassed after training like boxing champ Canelo Alvarez In partnership with DAZN_USA X B R ,108,216,1216,1432,video
CompanyJ_4669,Rockets will travel to the Bay Area on Friday to make sure they adjust to PT in preparation for a potential Game 1 vs Warriors per espn_macmahon ,145,382,2558,2940,photo
CompanyJ_4670,Draymond wanted the music blasting for his workout and Steve Kerr wanted it turned down for the media Draymond won via anthonyVslater ,134,779,4907,5686,video
CompanyJ_4671,18 years ago Mike Vick became the first black QB to get drafted No 1 overall Broke the mold NFLDraft ,101,9607,37617,47224,photo
CompanyJ_4672,Harrell is ready for Game 6 ,28,754,6053,6807,photo
CompanyJ_4673,Patrick Mahomes is the newest cover athlete for Madden 20 ,58,6573,30398,36971,photo
CompanyJ_4674,From tunnel shots to taking naps pregame rituals power players confidence through the playoffs From B R x StitchFix ,116,64,459,523,video
CompanyJ_4675,Nick Bosa has been around the league for as long as he can remember Now it s his turn to walk across the stage wearing a suit that reminds him of his roots From B R x mbyMstrahan JCPenney ,188,121,872,993,video
CompanyJ_4676, KCTV5 News releases disturbing 11 minute recording where Tyreek Hill told fiancee You need to be terrified of me too b h ,122,682,1989,2671,photo
CompanyJ_4677,Josh Allen credits the birth of his son as the inspiration that tailored him for this moment on draft day and he s wearing a suit that holds a special place in his heart From B R x mbyMstrahan JCPenney ,202,69,452,521,video
CompanyJ_4678,Every single pick in the 1st round AdamLefkoe nfldraftscout and ConnorJRogers are breaking it all down LIVE ,108,95,260,355,link
CompanyJ_4679,NFL Draft is HERE The Arizona Cardinals are on the clock NFLDraft ,66,240,1455,1695,photo
CompanyJ_4680,Kyler Murray goes No 1 overall to the Arizona Cardinals ,56,3504,14139,17643,video
CompanyJ_4681,Cardinals new QB depth chart ,29,896,3958,4854,photo
CompanyJ_4682,Baker amp Kyler make history for the University of Oklahoma ,60,1108,5379,6487,photo
CompanyJ_4683,Kyler becomes the first athlete to be a first round pick in both the MLB amp NFL ,81,5915,29774,35689,photo
CompanyJ_4684,49ers select Nick Bosa No 2 overall ,36,493,1813,2306,video
CompanyJ_4685,Bosa Brothers ,14,586,2600,3186,photo
CompanyJ_4686,The first Bama player is off the board Jets will select Quinnen Williams No 3 overall ,86,487,2319,2806,video
CompanyJ_4687,Raiders used the No 4 pick to draft Clelin Ferrell ,51,699,3328,4027,photo
CompanyJ_4688,Oakland is CONFUSED ,20,2872,11194,14066,photo
CompanyJ_4689,New Raiders DE Clelin Ferrell is the highest drafted Clemson player since Sammy Watkins No 4 ,93,266,1263,1529,video
CompanyJ_4690,A Tiger is headed to Tampa Buccaneers select Devin White No 5 overall ,70,353,1283,1636,video
CompanyJ_4691,Eli Manning replacement Giants select Daniel Jones No 6 overall ,64,388,1846,2234,video
CompanyJ_4692,Giants fans can t believe it ,29,3222,10883,14105,photo
CompanyJ_4693,Jacksonville picks up a MEAN edge rusher Jaguars draft Josh Allen No 7 overall ,79,534,2601,3135,video
CompanyJ_4694,More ammo for Matthew Stafford Lions draft T J Hockenson No 8 overall ,70,260,1297,1557,video
CompanyJ_4695,NFL draft No 7 overall pick 2018 Josh Allen 2019 Josh Allen ,60,945,6067,7012,photo
CompanyJ_4696,Buffalo looking to shore up their D Line Bills select Ed Oliver No 9 overall ,77,234,1002,1236,video
CompanyJ_4697,Celtics confirm the passing of NBA legend John Havlicek RIP 13x All Star 8x champion Finals MVP HOF ,100,6167,28888,35055,photo
CompanyJ_4698,Broncos have agreed to trade the No 10 pick to the Steelers ,60,340,2220,2560,photo
CompanyJ_4699,Joe Budden s reaction to the Giants drafting Daniel Jones via Cyn_Santana ,74,5673,17092,22765,video
CompanyJ_4700,Za Darius Smith Preston Smith Adrian Amos Packers add Rashan Gary to a new and improved defense ,96,190,919,1109,video
CompanyJ_4701,Dwayne Haskins laughed when the Giants took Daniel Jones over him via NBCSRedskins ,83,11584,52656,64240,video
CompanyJ_4702,Rashan Gary s draft reaction was priceless via thecheckdown ,60,1525,10736,12261,video
CompanyJ_4703,MetLife crowd lost it when the Giants took Jones via BigBlueVCR ,64,1972,5842,7814,video
CompanyJ_4704,Dwayne Haskins goes No 15 overall to the Washington Redskins ,61,3216,15120,18336,photo
CompanyJ_4705,Giants passed on Haskins He laughed Now he s in the division ,61,3258,22370,25628,photo
CompanyJ_4706,NY is making more waves Giants select Dexter Lawrence No 17 overall ,68,210,1006,1216,video
CompanyJ_4707,Oh boy ,7,1483,6341,7824,video
CompanyJ_4708,Goodell was NOT READY for Christian Wilkins via NFL ,52,2171,15320,17491,photo
CompanyJ_4709,Two TEs in the first round From the same school T J Hockenson No 8 and Noah Fant No 20 make history ,100,865,5310,6175,photo
CompanyJ_4710,Seahawks trade the No 21 pick to the Packers per AdamSchefter ,62,102,910,1012,photo
CompanyJ_4711,Dwayne Haskins has a chip on his shoulder ,42,1186,6892,8078,photo
CompanyJ_4712,Gruden finds his Marshawn replacement Raiders select Josh Jacobs No 24 overall ,79,628,3023,3651,video
CompanyJ_4713,Lamar Jackson throwing to HOLLYWOOD Ravens select Marquise Brown No 25 overall ,79,1280,5728,7008,video
CompanyJ_4714,Hollywood was full of emotion after getting selected via thecheckdown ,70,1260,7779,9039,video
CompanyJ_4715,QB to score Pass rusher to stop opponents QBs from scoring Redskins select Montez Sweat No 26 overall ,102,201,1028,1229,video
CompanyJ_4716,Josh Jacobs is living out his dream Homeless in middle school Unknown before Bama interest Got buzz by posting his own highlights Slept on dorm floor because he was so used to it First RB drafted in 2019 ,204,9455,49942,59397,photo
CompanyJ_4717,Josh Allen had quite a few messages on both of his phones after getting drafted via thecheckdown ,97,192,1954,2146,video
CompanyJ_4718,The TNT crew played jeopardy and it s HILARIOUS via NBAonTNT ,61,2291,13395,15686,video
CompanyJ_4719,With the LAST pick of the first round the Patriots select N Keal Harry ,71,981,3584,4565,video
CompanyJ_4720,The future of the Giants ,25,263,2227,2490,photo
CompanyJ_4721,Unbelievable via chris_sampy IG ,32,5143,33429,38572,video
CompanyJ_4722,Chiefs announce they ve suspended Tyreek Hill from all team activities ,71,1412,6148,7560,photo
CompanyJ_4723,Rams fresh off Super Bowl Russ riding career high TDs Jimmy G comeback Kyler to the Cards NFC West this year ,109,814,5878,6692,photo
CompanyJ_4724, With my hands James Harrison Von Miller JuJu and other stars discuss how they d beat Thanos AvengersEndgame ,109,316,2239,2555,video
CompanyJ_4725,Dame s not entertaining PG s bad shot comments If anything it was bad defense maybe he should ve just bodied up via PullUpPod ,126,2378,13399,15777,photo
CompanyJ_4726,Kyle Korver is considering retirement after 16 seasons in the league I think I still love playing basketball it s been a long few years per ryanwmcdonald ,154,492,4586,5078,photo
CompanyJ_4727,Clelin Ferrell s reaction to getting drafted fourth overall Wow via Raiders ,76,1603,9467,11070,video
CompanyJ_4728,Neymar has been banned three games of next season s Champions League after insulting officials on Instagram ,108,228,1985,2213,video
CompanyJ_4729,Chuck TOOK OFF via NBAonTNT ,28,2181,13637,15818,video
CompanyJ_4730,From tunnel shots to taking naps pregame rituals power players confidence through the playoffs From B R x stitchfixmen ,119,69,659,728,video
CompanyJ_4731,So casual via LivCookefs ,25,737,4465,5202,video
CompanyJ_4732,People who can t keep score via HoHighlights ,45,2039,7854,9893,video
CompanyJ_4733,Every NFL fan last night this is too accurate via ScooterMagruder ,66,4012,15537,19549,video
CompanyJ_4734, MO SALAH First Premier League player to 20 goals this season Via NBCSportsSoccer ,82,172,1170,1342,video
CompanyJ_4735, KOBE but not in the traditional way via kctrickshotz Instagram ,64,1156,8318,9474,video
CompanyJ_4736,Westbrook got real about improving his game NSFW via TheGreat_Nate ,67,3818,16525,20343,video
CompanyJ_4737,Went around his back MID 360 via lifestylehooper Instagram ,59,6713,30359,37072,video
CompanyJ_4738, Guess what they re going to ship your ass home somewhere else and you gon cry and be their problem Steve Smith went OFF on Josh Rosen ,135,663,4849,5512,photo
CompanyJ_4739,Rounds 2 and 3 are where teams are built AdamLefkoe nfldraftscout and ConnorJRogers are back breaking down every single pick Watch LIVE ,136,24,118,142,link
CompanyJ_4740,Mayor of Flavortown gives his pitch ,36,733,5352,6085,photo
CompanyJ_4741,Niners get Jimmy G a weapon San Francisco selects South Carolina WR Deebo Samuel ,81,519,2369,2888,video
CompanyJ_4742,Vlad Jr first major league at bat walks up to Lil Nas X via BlueJays ,69,1986,9662,11648,video
CompanyJ_4743,Broncos go back to back Mizzou QB Drew Lock lands in Denver ,60,210,1373,1583,video
CompanyJ_4744,The moment Deebo Samuel got drafted by the 49ers is what it s all about ,72,5318,29084,34402,video
CompanyJ_4745,Quinnen Williams sneezes Quinnen Williams Bless you via thecheckdown ,69,4659,26022,30681,video
CompanyJ_4746,Curry making logo shots look fundamental via NBA ,49,1023,6996,8019,video
CompanyJ_4747,Josh Rosen has been traded to Miami per AdamSchefter ,53,1375,5789,7164,photo
CompanyJ_4748,Russell Wilson gets a BIG new target Ole Miss WR DK Metcalf is the newest Seahawk ,82,1130,6064,7194,video
CompanyJ_4749,Reminder D K Metcalf is an absolute FORCE ,42,502,3558,4060,video
CompanyJ_4750,Seahawks WR Doug Baldwin may not be able to play again due to multiple injuries per AdamSchefter ,97,729,3285,4014,photo
CompanyJ_4751,Hit No 1 for Vlad Jr Many more to come via BlueJays ,52,599,3347,3946,video
CompanyJ_4752,New Seahawks WR DK Metcalf breaks down after receiving draft call What a moment via Seahawks ,93,5331,26153,31484,video
CompanyJ_4753,KD s turnaround is unguardable via NBA ,39,2111,11932,14043,video
CompanyJ_4754,38 after two quarters Career high for any half Too easy for KD ,63,1565,7121,8686,photo
CompanyJ_4755,KD s 38 PTS vs Clippers tied Chuck for highest scoring 1st half in an NBA Playoff game ,87,359,2655,3014,photo
CompanyJ_4756,KD has a playoff career high 4 6 PTS and counting Warriors on the brink of eliminating the Clippers via NBA ,108,275,2157,2432,video
CompanyJ_4757,Tim Anderson Bat flip LET S GO HOME via NBCSWhiteSox ,53,728,3321,4049,video
CompanyJ_4758,Kevin Durant has 50 POINTS via warriors ,40,649,3518,4167,video
CompanyJ_4759,A scout convinced DK Metcalf to show up to meet with the Seahawks staff with no shirt so Pete Carroll got pissed and took his off too via Seahawks ,147,6683,42231,48914,video
CompanyJ_4760,KD drops 50 and ends the Clippers season ,41,1814,7427,9241,photo
CompanyJ_4761,Playoff KD sent the Clippers home with a historic Game 6 performance ,69,444,2230,2674,video
CompanyJ_4762,Standing ovation for Lou Williams and Pat Bev as Clippers close out a memorable season ,87,825,6467,7292,video
CompanyJ_4763,KD says I m nice after getting a 50 piece on the Clippers ,58,1557,9094,10651,video
CompanyJ_4764,Legendary Clippers broadcaster Ralph Lawler signs off for one last time ,72,637,4647,5284,video
CompanyJ_4765, Since we left I ve been screaming that a team needs to go there KD is fully on board to bring the Sonics back via NBAonTNT ,124,3003,18898,21901,video
CompanyJ_4766,Draymond made sure to show love to Montrezl after the game ,59,2181,15474,17655,video
CompanyJ_4767, I promise we tried he proved exactly who people think he is Lou Williams and Pat Bev talk how difficult it was guarding KD via alextorres_11 ,142,4023,20002,24025,video
CompanyJ_4768,Flipped over the fence AND STILL CAUGHT IT via NGUBaseball ,59,602,3505,4107,video
CompanyJ_4769,Proud dad Vlad Guerrero watching Vladdy Jr get his first hit via MLB ,69,1965,21728,23693,video
CompanyJ_4770,DAY 3 sticktofootball hosts nfldraftscout ConnorJRogers amp mello are breaking down the 4th and 5th rounds of the draft LIVE ,125,30,161,191,link
CompanyJ_4771,Eight years ago today Messi tore through Real Madrid s defense in the Champions League semifinals via brfootball ,113,454,2879,3333,video
CompanyJ_4772, I m Kevin Durant You know who I am Since then 38 PTS 14 23 FG 33 PTS 12 21 FG 45 PTS 14 26 FG 50 PTS 15 26 FG ,111,10720,47557,58277,photo
CompanyJ_4773,Sparks have acquired All Star Chiney Ogwumike for a 2020 first round pick per wojespn Chiney reuintes with her sister 2016 MVP Nneka Ogwumike ,142,257,1323,1580,photo
CompanyJ_4774,Hunter Renfrow s football journey continues Two star recruit Unranked nationally One FBS offer Clemson walk on 2x NCAA champ Title game hero Burlsworth Trophy top walk on 5th round pick Raiders ,194,1094,5797,6891,photo
CompanyJ_4775,Inter Milan fans trolled Juventus for their loss to Ajax in the Champions League ,81,1499,6849,8348,photo
CompanyJ_4776,HE S BACK neymarjr with a slick chip for his first goal since his injury in January via beINSPORTSUSA ,102,459,2929,3388,photo
CompanyJ_4777,Kawhi s gonna be ready for Ben this series ,43,1256,8418,9674,video
CompanyJ_4778,Ronaldo scores his 600th club goal via brfootball ,50,654,3083,3737,photo
CompanyJ_4779, 7x All Star 3x All WNBA 2x Rookie of the Year 2016 MVP Ogwumike sisters are about to be a problem in LA What you think Candace_Parker ,135,353,1577,1930,photo
CompanyJ_4780,Messi becomes the first Barcelona player to win 10 La Liga titles via brfootball ,81,1822,8144,9966,photo
CompanyJ_4781,Security thought he was slick Via MLB ,38,178,1921,2099,video
CompanyJ_4782,It s been 10 years since Messi and Ronaldo were league champions in the same season Messi with Barcelona and CR7 with Manchester United in 2009 via brfootball ,159,938,5887,6825,photo
CompanyJ_4783,Messi lifts the La Liga trophy for the first time as Barcelona captain via FCBarcelona_cat ,91,3345,17028,20373,video
CompanyJ_4784,James gang in the house to watch Bronny and the Strive for Greatness squad ,75,594,4077,4671,video
CompanyJ_4785,Who s the best bet to win the East BR_Betting ,46,77,649,726,video
CompanyJ_4786,Rams drafted Last Chance U star Dakota Allen Texas Tech LB in the seventh round ,80,9311,46654,55965,photo
CompanyJ_4787,All went undrafted Adam Thielen Phillip Lindsay Doug Baldwin Chris Harris Jr Antonio Gates James Harrison Jason Peters Michael Bennett Wes Welker Kurt Warner Tony Romo Adam Vinatieri Warren Moon John Randle The ride doesn t end today ,234,5035,26921,31956,photo
CompanyJ_4788, You reach I teach Kawhi Leonard ,33,922,8881,9803,video
CompanyJ_4789,Playoff Kawhi is something else 15 PTS on 7 8 and he s just getting started ,76,490,3065,3555,video
CompanyJ_4790,OH MY EMBIID ,13,460,3173,3633,video
CompanyJ_4791,Kawhi hit a nasty combo in transition and Drake said he can t guard you ,72,4680,29522,34202,video
CompanyJ_4792,Kawhi dropped 27 PTS in the 1st half That s the most he s scored in any half in the playoffs ,93,411,2618,3029,video
CompanyJ_4793,Kawhi Siakam ,13,546,2930,3476,video
CompanyJ_4794, Get them the f k outta here Drake is done with the Sixers ,59,2195,14402,16597,video
CompanyJ_4795,Kawhi is running a clinic in Game 1 41 PTS and counting ,56,669,4481,5150,video
CompanyJ_4796,Kawhi checks out with a playoff career high 45 PTS ,51,1345,11834,13179,video
CompanyJ_4797,Kawhi drops 45 and the Raptors take a 1 0 lead ,47,484,2878,3362,photo
CompanyJ_4798,Kawhi s postgame interview got cut short and he was okay with it ,65,6580,45571,52151,video
CompanyJ_4799,Raptors franchise record for points in a playoff game Vince Carter 50 Kawhi Leonard 45 Both against the 76ers ,110,649,4201,4850,photo
CompanyJ_4800,Kawhi made a big statement in Game 1 ,37,372,2425,2797,video
CompanyJ_4801,Jokic had a strong 1st half start to Game 7 15 PTS 9 REB 2 BLK ,63,138,1322,1460,video
CompanyJ_4802,Murray doing all he can to keep the Nuggets on top ,51,255,2477,2732,video
CompanyJ_4803,Jokic dimes one to bring Denver s lead back to 8 ,49,67,890,957,video
CompanyJ_4804,Nuggets win a pivotal Game 7 and move on to the 2nd round ,58,692,3172,3864,photo
CompanyJ_4805,JAMAL MURRAY GAME 7 DAGGER ,27,840,5355,6195,video
CompanyJ_4806,The showdown we all been waiting for ,37,8405,29651,38056,video
CompanyJ_4807, Celtics catching fire Giannis in MVP form KD as locked in as ever Rockets coming for revenge We re in for a great day of basketball ,133,4452,19457,23909,photo
CompanyJ_4808,Playing BEHIND James Harden sounds crazy but he was down 8 3 PPG against the Jazz Did they provide the blueprint for neutralizing him ,134,122,1126,1248,photo
CompanyJ_4809,Messi and his kids after winning the title yesterday via LaLigaEN ,66,571,5149,5720,video
CompanyJ_4810,Don t Jump pjwheeler04 ,23,552,3455,4007,video
CompanyJ_4811,Officer broke out a clean stepback via brandon_mg77 anthonyramuno IG ,69,17092,102072,119164,video
CompanyJ_4812,Uncle Drew cooking early This arc is wild via Celtics ,54,1390,9424,10814,video
CompanyJ_4813,Look at him now ,16,4045,23611,27656,photo
CompanyJ_4814,Horford now with 5 blocks Giannis is just 3 14 via Celtics ,59,1845,9427,11272,video
CompanyJ_4815,Jaylen Brown snuck one over Giannis via celtics ,48,846,4847,5693,video
CompanyJ_4816,Celtics dominate in Game 1 112 90 Horford 20 PTS 11 REB 3 BLK Giannis 7 21 FG ,78,1360,5924,7284,photo
CompanyJ_4817,Lot of basketball left but via Wells15Kevin ,44,248,1536,1784,video
CompanyJ_4818,Will the Rockets figure out how to stop the Warriors this time ,63,429,2992,3421,photo
CompanyJ_4819,15 straight Barely touched iron Klay is ridiculous via NBCSWarriors ,68,1653,11413,13066,video
CompanyJ_4820,COLD ,5,9762,39908,49670,photo
CompanyJ_4821,All KD needs is a split second via warriors ,44,290,2304,2594,video
CompanyJ_4822, I really don t worry about shots I could get my shot any time I want Everyone in the building knows that Kyrie letting em know after Game 1 ,141,1562,9704,11266,photo
CompanyJ_4823,Harden stepback Absurd via HoustonRockets ,42,894,5434,6328,video
CompanyJ_4824, ,1,7820,32574,40394,photo
CompanyJ_4825,STEPH DAGGER ,13,935,4789,5724,photo
CompanyJ_4826,Steph called Game 1 ,20,2682,11670,14352,video
CompanyJ_4827,Rough ending for the Rockets ,29,553,3246,3799,video
CompanyJ_4828,The dagger The shimmy ,22,1449,10227,11676,photo
CompanyJ_4829, ,1,1338,6595,7933,photo
CompanyJ_4830,Draymond s response to Harden s comments on refs I ve been fouled by James Harden on a James 3 pointer before I ain t trying to hear that ,138,1372,7073,8445,video
CompanyJ_4831,Kyrie lookin like Kobe in Game 1 ,33,6629,36401,43030,video
CompanyJ_4832, GameofThrones ,15,3127,11854,14981,photo
CompanyJ_4833,Arya Stark forever clutch GameofThrones ,40,15379,57459,72838,photo
CompanyJ_4834,Portland and Denver both made history to make it to the WC semifinals Dame dropped 50 and hit his 2nd series winning game winner Nuggets advanced past the 1st round for first time in 10 yrs ,190,237,2603,2840,photo
CompanyJ_4835,Layup Free throw Three Half court shot All in 24 seconds And with 25K on the line via tamiuathletics ,101,1044,8797,9841,video
CompanyJ_4836,Charlotte faces a brutal choice this summer Let Kemba walk or hand out a crippling deal that could end up like John Wall s ,123,323,2033,2356,photo
CompanyJ_4837, I was trying to get out of the game Individual stuff is not big for me Kawhi tied his career high in Game 1 45 PTS but didn t even want to ,140,621,4910,5531,video
CompanyJ_4838, ,1,1053,6332,7385,video
CompanyJ_4839,BACKHEEL GOAL TobinHeath via NWSL ,34,124,1206,1330,photo
CompanyJ_4840,KD s last five playoff games 40 2 PPG 54 5 FG Easy money ,57,2384,14789,17173,video
CompanyJ_4841,Messi has scored 24 goals vs English teams On Wednesday he ll look to add Liverpool to his list of victims via brfootball ,122,208,1554,1762,video
CompanyJ_4842,Arya had other plans ,21,412,3741,4153,photo
CompanyJ_4843,Defender had no chance of blocking the reverse via Cdyches2 ,60,1620,8035,9655,video
CompanyJ_4844,Rockets believe officiating in 18 WC Finals cost them a shot at an NBA Championship In a report sent to NBA Houston cites 81 potential missed and non calls in Game 7 per ZachLowe_NBA amp Rachel__Nichols ,203,1104,4723,5827,photo
CompanyJ_4845,Steve Kerr opened his media session by flopping and calling a foul on a reporter via anthonyVslater ,100,2153,10581,12734,video
CompanyJ_4846,God Shammgod turns 43 today Created one of the coldest moves in basketball history ,83,5361,26964,32325,video
CompanyJ_4847,This is wild via cgrhandpainted Instagram ,42,4776,25691,30467,video
CompanyJ_4848,What happens when Ronaldo realizes he s getting older The Champions S2 Premiere ,80,419,1653,2072,video
CompanyJ_4849, Next question Steph putting a stop to the fair chance conversation via 957thegame ,83,323,2266,2589,video
CompanyJ_4850,Scottie Pippen says he definitely sees the comparison between KD and Jordan When they catch the ball in their sweet spot you re at their mercy via Rachel__Nichols The Jump ,172,1415,10108,11523,photo
CompanyJ_4851, Anything y all wanna grab is on me JabrillPeppers opened up a tab for the entire adidasoriginals store in NYC ,111,320,1856,2176,video
CompanyJ_4852, My mom has always put everyone before herself amp sacrificed things unimaginable DeAndre Hopkins mom Sabrina Greenlee is visually impaired after being assaulted with boiling chemicals in 2002 She will be the subject of a new film per Variety ,243,357,2584,2941,photo
CompanyJ_4853,Fastest 100M dash in high school history clocks in at 9 98 seconds via fastuniversity1 ,87,3104,20428,23532,video
CompanyJ_4854,A wing defender is the only thing standing in JHarden13 and CP3 s way of getting to the rim StateFarm ,102,94,576,670,video
CompanyJ_4855,Spicy P already going at Embiid ,32,1937,15762,17699,video
CompanyJ_4856,Jimmy Buckets ,14,547,4047,4594,video
CompanyJ_4857,Nick Nurse always has that look on his face ,44,131,1523,1654,photo
CompanyJ_4858,Kawhi caught in the 3Q ,23,254,2313,2567,video
CompanyJ_4859,Kawhi bringing Raptors back and Drake is HYPED ,47,336,2893,3229,video
CompanyJ_4860,JIMMY CLUTCH ,13,335,2467,2802,video
CompanyJ_4861,THIS GAME ,10,202,1564,1766,photo
CompanyJ_4862,Sixers win Series tied Jimmy 30 PTS 11 REB 5 AST ,49,497,3208,3705,photo
CompanyJ_4863,Embiid with the nasty dagger ,29,509,3445,3954,video
CompanyJ_4864,Dame hit Jokic with a dirty step back ,38,5026,35614,40640,video
CompanyJ_4865,Sixers put an end to their woes in Toronto ,43,165,1688,1853,photo
CompanyJ_4866, This was James Butler That was the adult in the gym A stud Brett Brown was in awe of Jimmy Butler s Game 2 performance ,120,137,1189,1326,video
CompanyJ_4867,Dame s pull up ,15,341,3557,3898,video
CompanyJ_4868, My name isn t James It s literally Jimmy Butler responds to Brett Brown calling him James ,91,977,7579,8556,video
CompanyJ_4869, If you ve had the sh s before you d know how it feels Embiid s interviews are undefeated ,90,621,4244,4865,video
CompanyJ_4870,UP UNDER AND ,13,3303,20107,23410,video
CompanyJ_4871,What a night for The Joker 37 PTS 9 REBS 6 ASTS 3 STLS 2 BLKS ,62,922,6870,7792,video
CompanyJ_4872,Tottenham vs Ajax Barca vs Liverpool All eyes on the Champions League battles via brfootball ,93,244,1612,1856,photo
CompanyJ_4873,13 years ago today Kobe forced OT then hit the winner vs Phoenix VINTAGE ,73,6555,28841,35396,video
CompanyJ_4874,A dream Champions League season for AFCAjax via brfootball ,59,121,1072,1193,photo
CompanyJ_4875,Jamaal Charles is signing a one day contract to retire with the Chiefs per 610SportsKC 11 years 4x Pro Bowler 7 563 rushing yards 2 593 receiving yards 5 4 YPC 4th all time 310 catches 64 total TDs via nflthrowback ,215,7590,37960,45550,video
CompanyJ_4876,Chet Holmgren is only a HS sophomore and he s already 7 0 getting buckets effortlessly ,87,1054,8742,9796,video
CompanyJ_4877,Fair trade via andrewsimoncelli88 IG ,37,643,8272,8915,video
CompanyJ_4878,Jokic s feel for the game is special ,37,197,2445,2642,photo
CompanyJ_4879,Mahomes can hoop Mookie can run routes and Baker can rip moonshots ,67,284,2320,2604,video
CompanyJ_4880,Ajax has the youngest squad in the Champions League semifinals by far via brfootball ,85,374,3615,3989,photo
CompanyJ_4881,No 1 2020 recruit RJ Hampton reclassifies to 2019 and will be eligible for the 2020 NBA Draft per slamonline via ,113,861,4928,5789,video
CompanyJ_4882,Two days after playing for UMass in the NCAA championship Cale Makar made his NHL playoff debut and scored Meet the NHL s newest X factor ,138,117,859,976,photo
CompanyJ_4883,Vince Carter says I m coming back for his 22nd season via ringer WingingItPod ,78,7939,53974,61913,photo
CompanyJ_4884,De Ligt is already a top defender at only 19 Neres speed devastates defenses Front to back Ajax is stacked via brfootball ,122,332,2379,2711,video
CompanyJ_4885,Dad hustled for the out and little man wasn t having it via drake_grillo_miniathlete IG ,88,11099,56520,67619,video
CompanyJ_4886,He really jumped over the catcher mid slide to home plate via ECCrusaders zach_sanidad IG ,90,13115,57467,70582,video
CompanyJ_4887,He only wished to meet saquon Now they re gonna have a whole day together via Giants ,85,2271,13282,15553,video
CompanyJ_4888,Tyson Fury is 6 9 Ridiculous movement via Tyson_Fury ,53,886,6118,7004,video
CompanyJ_4889,Ajax tore Tottenham s defense apart for their opening goal ,59,467,3707,4174,video
CompanyJ_4890,On this day in 1992 Shawn Kemp demolished Alton Lister THE DISRESPECT ,70,3070,14287,17357,video
CompanyJ_4891,Ajax are halfway to their first Champions League final in 23 years via brfootball ,82,356,3272,3628,photo
CompanyJ_4892,This backward nutmeg is filthy ,31,556,4655,5211,video
CompanyJ_4893,Mavericks intend to go after Kemba Walker and Khris Middleton in free agency per TheSteinLine ,94,3256,17579,20835,photo
CompanyJ_4894,Cody Bellinger s historic April has the Dodgers looking dangerous ,66,190,1033,1223,video
CompanyJ_4895,Kyle Lowry s best friend is sacrificed as the Raptors attempt to reach the Finals Rewatch the last GameOfZones New episode drops Thursday at 5pm ET StateFarm ,158,283,1281,1564,video
CompanyJ_4896,GIANNIS GETTING ANGRY ,22,1081,8660,9741,video
CompanyJ_4897,That was tough Middleton s heating up with 15 PTS ,50,233,2274,2507,video
CompanyJ_4898,Kyrie starting to heat up ,26,343,2814,3157,video
CompanyJ_4899,A former DII hooper thought he could take on WNBA player and daughter of Dee Brown Lexie Brown She gave him BUCKETS via thehoopstate ,133,11035,47063,58098,video
CompanyJ_4900,Okay Jaylen ,12,259,2047,2306,video
CompanyJ_4901,Giannis hit the Steph shimmy ,29,1773,12076,13849,video
CompanyJ_4902,Giannis and the Bucks get even Greek Freak 29 PTS 10 REBS 4 ASTS 2 STLS ,72,616,4077,4693,photo
CompanyJ_4903,Steph heads to the locker room with an apparent hand injury ,60,562,3660,4222,video
CompanyJ_4904,We have a series ,17,341,3426,3767,photo
CompanyJ_4905,Curry still draining 3s with a dislocated finger Sheesh ,56,1871,13024,14895,video
CompanyJ_4906,D Antoni says Harden was bleeding from the eye He s back in the game ,69,290,2480,2770,video
CompanyJ_4907,Harden s eyes Ouch ,19,2034,13081,15115,photo
CompanyJ_4908,Curry couldn t believe it ,26,117,1434,1551,video
CompanyJ_4909,Steph s reaction ,17,364,2947,3311,video
CompanyJ_4910,Whatever works _ ツ _ ,21,457,4112,4569,video
CompanyJ_4911,Harden appears to be having a hard time with the lights ,56,309,3084,3393,video
CompanyJ_4912,CP3 s reaction to the Rockets getting a foul ,45,3237,24016,27253,video
CompanyJ_4913,NO VISION NO PROBLEM ,21,387,3760,4147,photo
CompanyJ_4914,Harden is in his bag ,21,215,1870,2085,video
CompanyJ_4915,Klay out here playing safety ,29,586,4506,5092,video
CompanyJ_4916,KD and CP3 having a chat ,25,237,2335,2572,video
CompanyJ_4917, ,1,921,5342,6263,video
CompanyJ_4918,Look at the security guard ,27,1688,12851,14539,video
CompanyJ_4919,Chuck got Shaq so heated via NBAonTNT ,38,18775,71191,89966,video
CompanyJ_4920,Barcelona vs Liverpool UCL semifinal This will be good brfootball with the best Champions League coverage ,106,476,3567,4043,photo
CompanyJ_4921,Arya Stark inspiring celebrations NotToday via armywp_mlax IG ,62,2070,15298,17368,video
CompanyJ_4922,Last night was the first time all 5 Warriors starters scored 15 PTS in a postseason game since 70 71 per mercnews Dray 15 KD 29 Steph 20 Iggy 16 Klay 21 Clicking at the right time ,180,447,3477,3924,photo
CompanyJ_4923,On this day in 2005 Messi s very first goal for Barcelona 14 years later he has 598 via FCBarcelona ,100,2184,11484,13668,video
CompanyJ_4924, Bucks came back strong to tie the series at 1 1 Warriors close out in the clutch to take a 2 0 series lead What a night in the NBA MetroByTMobile ,147,132,1029,1161,video
CompanyJ_4925, Was just crying I felt like the Champions League is over and the World Cup is over MoSalah on his UCL final injury being a one season wonder facing Messi and more via brfootball ,179,209,1537,1746,video
CompanyJ_4926,Perfect time for little man to work on his moves via samahdd IG ,64,277,2483,2760,video
CompanyJ_4927, ,1,573,4329,4902,photo
CompanyJ_4928,The last time Messi was in the UCL semifinals he left Boateng for dead ,71,2029,11870,13899,video
CompanyJ_4929,Suarez and Coutinho face Liverpool for the first time since joining Barcelona via brfootball ,93,459,4543,5002,photo
CompanyJ_4930,21 years ago today Spike Lee released He Got Game Kobe didn t audition because he wanted to train all summer Spike asked Ray Allen to audition after watching him at MSG in 97 It was scripted for Denzel to lose 11 0 but he scored because he refused to get zipped ,262,3651,16295,19946,photo
CompanyJ_4931,Jamaal Charles will officially retire as a Chief What an incredible career jcharles25 ,86,423,3719,4142,link
CompanyJ_4932,Suarez puts Barcelona up against his former club via brfootball ,64,139,1223,1362,photo
CompanyJ_4933,Perfect pass for the Suarez finish ,35,555,3000,3555,video
CompanyJ_4934,Can t touch Messi ,18,794,5397,6191,video
CompanyJ_4935,Messi has now scored against every single English team he s ever faced via brfootball ,86,3308,13120,16428,photo
CompanyJ_4936,600 Barcelona goals for Messi SIX HUNDRED ,42,1899,8348,10247,video
CompanyJ_4937,MESSI UNREAL FREE KICK ,23,16399,63402,79801,video
CompanyJ_4938,Barcelona are one game from the Champions League final via brfootball ,70,444,2324,2768,photo
CompanyJ_4939,Makes free kicks look easy ,27,1570,8925,10495,photo
CompanyJ_4940,Messi s free kick gets better with every angle via brfootball ,62,5318,21185,26503,video
CompanyJ_4941,Messi was playing like himself today ,37,706,5636,6342,photo
CompanyJ_4942,A group of MSG shareholders filed a civil suit against James Dolan for spending too much time with his band per MarcHogan ,122,176,1322,1498,photo
CompanyJ_4943,OKAY BEASLEY ,13,300,2793,3093,video
CompanyJ_4944,N U T M E G ,12,1484,10611,12095,video
CompanyJ_4945,Torrey Craig comes back to the game with a mask after sustaining a nose injury Grinding it out for the playoffs ,112,360,3526,3886,video
CompanyJ_4946,Gary Harris comes to Torrey Craig s defense after Enes Kanter knocks him down Double technical called on Harris and Kanter ,123,267,2153,2420,video
CompanyJ_4947,76ers assistant Monty Williams is gaining real momentum to become the Suns head coach job is his if he wants it per TheSteinLine ,129,208,1865,2073,photo
CompanyJ_4948,Former No 1 overall NBA draft pick Greg Oden was drafted to play in the Big 3 ,78,710,7918,8628,photo
CompanyJ_4949,Messi really is the free kick master via brfootball ,52,830,5398,6228,video
CompanyJ_4950,Dodgers fan dropped his fries AND his pizza going for foul balls but at least got one via 15SOF ,96,437,3605,4042,link
CompanyJ_4951,MELO New GameOfZones drops at 5 p m ET ,39,187,1945,2132,photo
CompanyJ_4952,Shump does have the height weight and reach advantage In partnership with DAZN_USA X B R ,89,48,584,632,video
CompanyJ_4953,5 years ago today Dame hit his first playoff game winner Sent the Rockets home in Game 6 Cold Blooded ,102,1893,11005,12898,video
CompanyJ_4954,Four days after Ronaldo scored his 600th club goal Messi scored his The greats via brfootball ,94,801,6398,7199,photo
CompanyJ_4955,Bronny James was too smooth in his EYBL debut ,46,3877,24003,27880,video
CompanyJ_4956,On the field a generational talent Off the field a poet with aspirations of being a paleontologist and dreams of fighting Deontay Wilder Get to know Myles Garrett ,163,153,1514,1667,photo
CompanyJ_4957,2 years ago today IT dropped 53 points in the playoffs on his late sister Chyna s 23rd birthday All heart via NBATV ,116,11475,59137,70612,video
CompanyJ_4958,The USWNT s full World Cup squad is here via brfootball ,56,325,1811,2136,photo
CompanyJ_4959,Defensive tackle turned wrestler turned top paid actor Happy birthday to the man of many crafts TheRock ,104,4350,29974,34324,photo
CompanyJ_4960,Knee slide didn t go as planned via brlive ,43,900,5987,6887,video
CompanyJ_4961, See the bigger picture Live in the gym Be quick but don t be in a hurry Baron Davis and Mtn Dew s Rising Stars offer advice to the 2019 NBA Draft class via TNT MountainDew ,173,37,379,416,video
CompanyJ_4962,D Angelo Russell reportedly cited at airport after police found marijuana hidden in container that was made to look like an Arizona Iced Tea can per USATODAY ,158,5923,28488,34411,photo
CompanyJ_4963,Paul Richardson s mom breaks down when he surprises her with a new car via prichiejr ,85,794,7245,8039,video
CompanyJ_4964,Melo s time in Houston turns into a nightmare GameOfZones StateFarm ,68,1779,5507,7286,video
CompanyJ_4965,Layup packages are getting out of hand via lifestylehooper IG ,62,5859,29904,35763,video
CompanyJ_4966,Kawhi is averaging 40 PPG this series heading into Game 3 Will the Raptors regain home court advantage ,103,409,4501,4910,photo
CompanyJ_4967,Embiid REJECTS Kawhi via sixers ,32,339,2558,2897,video
CompanyJ_4968,Ben Simmons appears to elbow Kyle Lowry below the belt ,55,549,3883,4432,photo
CompanyJ_4969,JIMMY GOT UP via sixers ,24,557,3552,4109,video
CompanyJ_4970,Jamaal Charles knows he and Patrick Mahomes would ve been an All Legend fantasy team via Chiefs ,96,866,8164,9030,video
CompanyJ_4971,You thought this game was over Kawhi went off for 14 PTS in the 3Q has 31 PTS and counting ,91,196,1623,1819,photo
CompanyJ_4972,JoJo seals his FIFTH block of the night via sixers ,51,200,1721,1921,video
CompanyJ_4973,Sixers going off and AI is LOVING IT via sixers ,48,1392,8011,9403,video
CompanyJ_4974,EMBIID REALLY HIT THE WINDMILL via sixers ,42,3472,19912,23384,video
CompanyJ_4975,2 1 Philly Joel Embiid dominates at home 76ers win by 21 ,57,652,3996,4648,photo
CompanyJ_4976,Embiid exploded for 33 points 10 rebounds and 5 blocks tonight ,63,381,2633,3014,photo
CompanyJ_4977,Both sides are doing whatever it takes to gain an advantage ,60,550,3588,4138,video
CompanyJ_4978,Jimmy Butler kept yelling at Joel Embiid to shoot the ball via NBA ,67,4249,28319,32568,video
CompanyJ_4979,Mood in Philly ,15,886,7386,8272,photo
CompanyJ_4980, Chemistry is overrated When you have great basketball players it s easy Embiid feeling confident about his team ,113,464,4300,4764,video
CompanyJ_4981,One year ago today LeBronto was born King was in a ZONE ,56,12914,54428,67342,video
CompanyJ_4982,Kyle Lowry 12 PPG says he has to step up for Kawhi this series He s doing everything he can possibly do offensively and defensively to f king win games and myself I m not helping him enough via TimBontemps ,206,657,4507,5164,photo
CompanyJ_4983,After scoring two goals in the first leg Messi is Champions League Player of the Week via brfootball ,101,221,2172,2393,photo
CompanyJ_4984,Officer got a bucket and broke out The Silencer via la_verdad_yai IG ,69,3419,27086,30505,video
CompanyJ_4985,This weightlifter with cerebral palsy has inspired pro athletes lifting twice his weight and training non stop ,111,1951,11849,13800,video
CompanyJ_4986,Sixers assistant Monty Williams is signing a five year deal to become Suns head coach per ShamsCharania ,104,460,2978,3438,photo
CompanyJ_4987,Eight years ago today D Rose won his historic MVP Youngest ever 22 25 0 PPG 7 7 AST Most wins in the league Joined MJ as only Bull to win it Only player to win besides LeBron from 2009 2013 ,190,12163,48224,60387,video
CompanyJ_4988,Coach taught the whole team how to change a tire That s real via coachgross73 ,78,2853,16950,19803,video
CompanyJ_4989,Lakers are proceeding toward an offer to Lue and don t plan to introduce new coaches into their search process per wojespn and ramonashelburne ,143,318,1888,2206,link
CompanyJ_4990,2020 s No 1 QB recruit can throw a football 85 yards AND has a 95 mph fastball DJ Uiagalelei s generational arm talent could take him to the NFL MLB or both ,157,322,2035,2357,photo
CompanyJ_4991,16 year old Myshaun Dozier has no radius bones in his arms due to a genetic disorder He put in work to make the JV team Via GordonVoit wandtvnews ,146,1038,7469,8507,video
CompanyJ_4992,Pro tip Never play ball in slides or in the sand via hilariojr11_ Instagram ,76,566,4843,5409,video
CompanyJ_4993,12 years ago today the We Believe Warriors did the impossible against Dallas 3rd time a No 8 upset a No 1 1200 series underdogs Dallas was 67 15 with MVP Dirk via NBATV ,169,2407,14131,16538,video
CompanyJ_4994,Ronaldo hit the 100th header of his career Sheesh via brfootball ,65,804,5759,6563,photo
CompanyJ_4995,This type of volleyball is a different level of difficult via sbyrne23 Instagram ,81,1144,6848,7992,video
CompanyJ_4996,Some Warriors aren t buying that Harden s eye is extremely hurt per ChrisBHaynes They were talking about some of the shots he was shooting during the game then he gets to the free throw line and he s squinting like he can t see it ,231,518,2992,3510,photo
CompanyJ_4997,Cubs Kyle Hendricks threw an 81 pitch shutout against the Cardinals First 81 pitch shutout since 2012 Fewest pitches in a Cubs shutout since 2001 No pitch was over 89 MPH h t darenw That s efficiency ,200,333,2036,2369,photo
CompanyJ_4998,Giannis block and dunk electrified the arena Brook dishes on how the Bucks turned the tables in Game 2 From B R x WellsFargo ,125,47,427,474,video
CompanyJ_4999,Things getting heated between Canelo and Danny Jacobs ahead of their fight tomorrow via GoldenBoyBoxing ,104,1196,4635,5831,video
CompanyJ_5000,Kyrie knows what he s talking about ,36,2066,14373,16439,photo
CompanyJ_5001,Uncle Drew and michaelb4jordan pregame via NBCSCeltics ,55,709,6478,7187,video
CompanyJ_5002,How to split a double team By Kyrie Irving via celtics ,55,1559,9181,10740,video
CompanyJ_5003,Leave Giannis alone Jaylen via NBA ,35,3639,20387,24026,video
CompanyJ_5004,Run it ,7,801,5558,6359,photo
CompanyJ_5005,Manny vs Kershaw Machado takes his former teammate DEEP for his sixth homer this season via FoxSportsSD ,104,344,2066,2410,video
CompanyJ_5006,Celtics look on as the Bucks take a 2 1 series lead ,52,577,3864,4441,photo
CompanyJ_5007,Despite going down 2 1 Kyrie stays proving he has the best handles in the league NHTSAgov ,90,243,1502,1745,video
CompanyJ_5008,Murray trying to put Aminu in the blender via nuggets ,54,261,1849,2110,video
CompanyJ_5009,OKAY THEN DAME via NBA ,23,1087,9892,10979,video
CompanyJ_5010,TEAM IS ON MOE S BACK ,22,82,836,918,photo
CompanyJ_5011,3 J ,4,218,1391,1609,photo
CompanyJ_5012,CJ McCollum and the C is for clutch via NBA ,44,310,2690,3000,video
CompanyJ_5013,,0,648,5818,6466,photo
CompanyJ_5014,TRIPLE OVERTIME ,16,1137,5645,6782,photo
CompanyJ_5015,GOING WILD ,11,958,6053,7011,photo
CompanyJ_5016,Only the second 4OT playoff game in NBA history ,48,2870,13887,16757,photo
CompanyJ_5017,RODNEY HOOD FOR THE LEAD ,25,667,3510,4177,photo
CompanyJ_5018,RODNEY HOOD STEALS GAME 3 IN 4OT PORTLAND GOES UP 2 1 ,54,5299,28943,34242,video
CompanyJ_5019, ,1,1008,5957,6965,photo
CompanyJ_5020, That s what I m built for ,27,771,5684,6455,photo
CompanyJ_5021,CJ took over in crunch time McCollum finished with a game high 41 PTS in 4OT ,77,357,2317,2674,video
CompanyJ_5022,Instant classic ,16,499,5122,5621,photo
CompanyJ_5023,CJ had the best breakdown of Rodney Hood s game winner ,55,813,6722,7535,video
CompanyJ_5024,Jokic says he used to be maybe a little bit chubby but he s in really good shape Big man played 65 minutes tonight ,115,337,3637,3974,video
CompanyJ_5025,Rodney Hood CLUTCH via lindsniewski ,36,878,7740,8618,video
CompanyJ_5026,Rodney Hood channeled his inner Dame Time in 4OT ,49,501,6636,7137,photo
CompanyJ_5027,Happy birthday to James Harrison Went from undrafted to one of the baddest dudes in the NFL 2x champ 2008 DPOTY 5x Pro Bowler Super Bowl hero 2x First Team All Pro Steelers all time sack leader ,194,2355,21677,24032,photo
CompanyJ_5028,What a run and finish from Pulisic via FOXSoccer ,49,805,6059,6864,photo
CompanyJ_5029,Forget the refs Forget the injuries The Rockets are their own biggest problem right now says HowardBeck ,104,272,1631,1903,video
CompanyJ_5030,Derby day br_betting ,21,60,610,670,photo
CompanyJ_5031,18 months ago there were fears Ryan Shazier might never walk again Last night he danced at his wedding via Love_Ola_9 ,118,17115,90681,107796,video
CompanyJ_5032,10 years ago today LeBron won his first MVP 28 4 PPG 7 6 REB 7 2 AST Won three of next four MVPs Got award at St Vincent St Mary Donated car to local charity Kobe finished 2nd Wade 3rd ,185,1710,7893,9603,photo
CompanyJ_5033,Painted Floyd Mayweather using boxing gloves via bou_bou_design_ IG ,68,2450,12113,14563,video
CompanyJ_5034,Steve Kerr corrected a reporter about how many straight threes the Rockets missed last year 27 but who s counting via YoungNBA ,127,513,3964,4477,video
CompanyJ_5035,Mo Salah stretchered off after a head injury Hope he s okay ,60,300,1969,2269,photo
CompanyJ_5036,WHAT A WIN FOR LIVERPOOL ,25,215,1574,1789,photo
CompanyJ_5037,The Premier League winner will be decided on the final day via brfootball ,74,225,1318,1543,photo
CompanyJ_5038,Jaylen Brown s really got his own dunk reel against Giannis this year ,70,2022,9212,11234,video
CompanyJ_5039,MAXIMUM SECURITY For the seventh straight year the favorite wins the Kentucky Derby via NBCSports ,98,389,2610,2999,video
CompanyJ_5040,WHAT JUST HAPPENED KentuckyDerby ,33,821,3687,4508,photo
CompanyJ_5041,Country House has won the 145th Kentucky Derby after Maximum Security was disqualified For the first time in Kentucky Derby history the horse that crossed the finish line first has been DQ d ,191,798,3111,3909,photo
CompanyJ_5042, Maximum Security wins the 145th Kentucky Derby ,48,742,3880,4622,photo
CompanyJ_5043,Churchill Downs the moment Maximum Security got DQ d Wild via br_betting ,73,517,2277,2794,video
CompanyJ_5044,You know who he is Nobody can stop KD this postseason ,54,379,2300,2679,video
CompanyJ_5045,GREAT WALL OF CAPELA via HoustonRockets ,40,2808,13263,16071,video
CompanyJ_5046,The main event is in the building Canelo DanielJacobsTKO CaneloJacobs ,70,241,1123,1364,photo
CompanyJ_5047,Capela denied Iggy ,19,886,6254,7140,photo
CompanyJ_5048,Harden and CP3 are cookin via NBA ,34,432,3713,4145,video
CompanyJ_5049,LeBron and Lonzo look back on the night Magic stepped down NSFW TheShopHBO via uninterrupted ,93,4663,20292,24955,video
CompanyJ_5050,Another game another OT ,24,687,4003,4690,photo
CompanyJ_5051,The Beard drops 41 in Game 3 to keep the Rockets alive in the series ,69,1743,8291,10034,photo
CompanyJ_5052,Harden dagger Steph missed layup Rockets take Game 3 ,53,2938,12996,15934,video
CompanyJ_5053,Time to fight DanielJacobsTKO Canelo ,37,216,1156,1372,photo
CompanyJ_5054,Things getting heated at the end of round 5 in CaneloJacobs ,60,115,901,1016,photo
CompanyJ_5055,GGG in the crowd for CaneloJacobs ,34,524,4204,4728,photo
CompanyJ_5056,Steph says missed dunk was not my finest moment via shaqtin ,60,1615,12353,13968,video
CompanyJ_5057,Canelo Alvarez wins by unanimous decision over Daniel Jacobs in middleweight title unification bout CaneloJacobs ,113,2703,5646,8349,photo
CompanyJ_5058,Canelo running out of room for all of his belts ,48,5131,22633,27764,photo
CompanyJ_5059,Wasn t the main event but VergilOrtiz FOLDED his opponent tonight CaneloJacobs via DAZN_USA ,92,915,3168,4083,video
CompanyJ_5060, You look crazy We love you though CP3 clowns Harden about his red eye via NBAonTNT ,84,924,7864,8788,video
CompanyJ_5061,James Harden with the ice cold dagger to put the Warriors away StateFarm ,73,2469,12917,15386,video
CompanyJ_5062,Steph in the 4th quarter and OT last night 0 points 0 6 FG ,59,2020,12914,14934,photo
CompanyJ_5063,Bron wanted to see if Zion could really play coming out of high school Now he loves his energy TheShopHBO via HBO ,114,1406,8436,9842,video
CompanyJ_5064,Dray was on an obstacle course avoiding the Rockets cheerleaders via shaqtin ,77,1522,11338,12860,video
CompanyJ_5065,Waved him up before the KO blow via BellatorMMA ,48,911,5243,6154,video
CompanyJ_5066,Chelsea will officially be back in the Champions League next season via brfootball ,83,448,2955,3403,photo
CompanyJ_5067,POSTER via _iamcj3 Instagram ,29,3819,20813,24632,video
CompanyJ_5068,DJ Uiagalelei 2020 s No 1 QB announces commitment to Clemson ,61,571,3727,4298,photo
CompanyJ_5069,Embiid on one end Simmons on the other via sixers ,50,253,2000,2253,video
CompanyJ_5070,How d you get that to fall JimmyButler via sixers ,50,570,4209,4779,video
CompanyJ_5071,KAWHI IS COOKING 39 points ,27,710,4970,5680,photo
CompanyJ_5072,Kawhi Cold via Raptors ,23,1190,6941,8131,video
CompanyJ_5073,Kawhi drops 39 in Game 4 to even the series at 2 2 ,51,1053,7514,8567,photo
CompanyJ_5074,Kawhi completely took over Game 4 39 PTS 14 REB 5 AST 13 20 FG 5 7 3PT ,71,1175,6081,7256,video
CompanyJ_5075,HOW JAMAL ,10,1396,8375,9771,video
CompanyJ_5076,Murray got Kanter ,18,1755,11560,13315,video
CompanyJ_5077,Nurk in the house for Game 4 Blazers big man out here cheering on his teammates after suffering a leg injury back in March ,123,216,2740,2956,video
CompanyJ_5078,Seth Curry making it happen for the Blazers in Game 4 ,54,261,2567,2828,video
CompanyJ_5079,SETH CURRY GOING OFF ,21,1990,14354,16344,video
CompanyJ_5080,SETH 16 at the half ,20,443,3363,3806,video
CompanyJ_5081,That was cold CJMcCollum ,25,344,2955,3299,video
CompanyJ_5082,Dame time ,10,313,2886,3199,video
CompanyJ_5083,This series gt gt ,18,550,5647,6197,video
CompanyJ_5084,SERIES TIED Denver takes down Portland 116 112 Murray 34 PTS 5 REB 4 AST Jokic 21 PTS 12 REB 11 AST ,100,605,3885,4490,photo
CompanyJ_5085,The Joker recorded his 4th triple double of the playoffs in Game 4 21 PTS 12 REB 11 AST W ,90,241,1818,2059,video
CompanyJ_5086,Jokic broke the mic ,20,3147,20763,23910,video
CompanyJ_5087,Mohamed Salah will not play in Liverpool s Champions League semifinal second leg vs Barcelona due to injury ,108,134,1218,1352,photo
CompanyJ_5088,A lot on the line this week ,28,1464,6747,8211,photo
CompanyJ_5089,Warriors are preparing for possibly seismic change this summer when KD and Klay become free agents per wojespn ,111,1667,11351,13018,photo
CompanyJ_5090,Warriors Rockets Game 4 tonight Has KD been the best player in the playoffs so far MyStraightTalk ,98,926,8172,9098,status
CompanyJ_5091,Strength and balance are next level via christopher_joyce18 IG ,63,5679,28902,34581,video
CompanyJ_5092,Fans told Eden Hazard Stay at Chelsea and he shook his head via shazyrinor ,75,2143,10827,12970,video
CompanyJ_5093, We wasn t supposed to be here You made us believe Five years ago today KD called his mom the real MVP ,103,3209,16429,19638,video
CompanyJ_5094,Kawhi vs Philly in the conference semis 45 PTS 16 23 FG 35 PTS 13 24 FG 33 PTS 13 22 FG 39 PTS 13 20 FG Machine ,112,1398,9730,11128,photo
CompanyJ_5095,On this day in 2015 Messi spun Boateng via brfootball ,54,744,4287,5031,video
CompanyJ_5096,This went in ,13,2136,19289,21425,photo
CompanyJ_5097,Chuck had a rough day on the course at the 2019 Black Masters via NBAonTNT ,75,3204,20315,23519,video
CompanyJ_5098,History Chiquita Evans is the first woman drafted to the NBA2KLEAGUE ,69,247,1360,1607,video
CompanyJ_5099, Last Chance U star Ronald Ollie DL Nicholls State announces he s signing with the Raiders via RonaldOllie ,107,10348,40923,51271,photo
CompanyJ_5100,Flicked it over him then scored a rocket via ChrisBCorey ,57,2816,13449,16265,video
CompanyJ_5101,Big year for Last Chance U Dakota Allen Rams 7th rounder Ronald Ollie Signed with Raiders They join John Franklin III Bears and C J Reavis Jags as players from the show to reach the league ,189,4443,18648,23091,photo
CompanyJ_5102,Ja Morant is about making plays for his teammates not just himself I m a point god GOD per ChrisBHaynes ,104,916,7175,8091,photo
CompanyJ_5103,Dropped him with the flick of the wrist via kyle_clos Instagram ,64,418,3099,3517,video
CompanyJ_5104, Happy Birthday Coach Ty Lue celebrates his birthday with a Lakers themed cake per TMZ ,87,1711,12490,14201,photo
CompanyJ_5105,Dez Bryant is running out on the field for the first time since tearing his Achilles just two days after signing with the Saints via DezBryant ,143,1279,8208,9487,video
CompanyJ_5106,WHAT A GOAL Kompany with a ROCKET via NBCSportsSoccer ,54,1813,6626,8439,video
CompanyJ_5107,1 Man City 95 pts 2 Liverpool 94 pts Only one game left in the Premier League title race via brfootball ,104,319,1617,1936,photo
CompanyJ_5108,Messi Griezmann Modric and all the La Liga housemates party all night but Gareth Bale still won t join The Champions Ep 2 ,122,205,710,915,video
CompanyJ_5109,Sergio Aguero was shouting Don t shoot at Kompany before his 30 yard winner via ManCity ,88,1285,7327,8612,video
CompanyJ_5110, MoSalah has become a huge NBA fan but his own game needed work at first New episode of Take It There with TaylorRooks drops early Tuesday morning ,147,87,680,767,video
CompanyJ_5111,16 4 in last 20 2 53 team ERA Javy on Cubs are tearing through the National League ,83,249,1127,1376,video
CompanyJ_5112,Even the giants of the paint can t stop JHarden13 from reverting Lord Basketball s curse StateFarm ,99,50,318,368,video
CompanyJ_5113,Kenneth Faried touts Harden s MVP performance and CP3 s amazing ability to read the court in critical Game 3 win From B R x WellsFargo ,135,72,652,724,video
CompanyJ_5114,Things getting a little chippy early ,37,215,2190,2405,video
CompanyJ_5115,Nothing but respect ,20,2882,13853,16735,photo
CompanyJ_5116,Tyronn Lue and Lakers are in the process of making him the next head coach per ChrisBHaynes ,92,734,5177,5911,photo
CompanyJ_5117,Sports world out at the MetGala ,32,296,2451,2747,photo
CompanyJ_5118,Mean mug Giannis out to win Game 4 ,35,399,2413,2812,video
CompanyJ_5119,Giannis drops 39 amp the Bucks take a commanding 3 1 series lead on Boston ,75,1929,8752,10681,photo
CompanyJ_5120,Down 3 1 ,9,1314,8968,10282,photo
CompanyJ_5121,Chuck thinks the Bucks will win it all via NBAonTNT ,52,629,3838,4467,video
CompanyJ_5122,KD and Harden both shaken up after this play ,45,286,1694,1980,video
CompanyJ_5123,Doc in the house to support Austin ,35,360,4649,5009,video
CompanyJ_5124,Bounce back game for Steph He s got a quick 13 PTS ,51,105,847,952,video
CompanyJ_5125,BE4RD BEH4VIOR ,15,4998,22661,27659,video
CompanyJ_5126,Draymond trying to light a fire under the Warriors ,51,193,1633,1826,video
CompanyJ_5127,Technically he was right ,25,6312,36938,43250,photo
CompanyJ_5128,Giannis took a second to check Smart s stats ,45,2380,13002,15382,video
CompanyJ_5129,Dray feels it after guarding Harden ,36,448,2924,3372,video
CompanyJ_5130,Dray is fed up ,15,187,1520,1707,video
CompanyJ_5131,Harden wants all the 4 point plays ,35,505,4196,4701,video
CompanyJ_5132,Classic Beard Harden extends the Rockets lead going into the fourth ,68,423,2452,2875,video
CompanyJ_5133,Point God ,10,1076,9203,10279,video
CompanyJ_5134,This game Wild ,15,298,2140,2438,photo
CompanyJ_5135,SERIES TIED Rockets beat the Warriors 112 108 Beard 38 PTS 10 REBS 4 ASTS ,74,4709,19895,24604,photo
CompanyJ_5136,You good SHAQ via NBAonTNT ,27,1150,7647,8797,video
CompanyJ_5137,Today Leo Messi takes on Liverpool at Anfield via brfootball ,61,299,2792,3091,photo
CompanyJ_5138, Still emotional over the infamous Ramos injury in UCL Has nothing to say to the haters who doubt him Thinks his hair is better than Odell s MoSalah is learning to embrace his newfound fame New Take It There with TaylorRooks ,225,60,332,392,photo
CompanyJ_5139,Harden dropped 38 to even the series Giannis went off for 39 What a night MetrobyTMobile ,89,167,1531,1698,video
CompanyJ_5140,24 years ago today Reggie Miller silenced Knicks fans with 8 points in 9 seconds ,81,2428,12981,15409,video
CompanyJ_5141,Salah and Firmino have scored almost 40 of LFC s 107 goals this season Neither of them will play vs Barcelona via brfootball ,125,66,568,634,photo
CompanyJ_5142,OBJ wants to build a dynasty ,29,1009,7663,8672,photo
CompanyJ_5143,2nd round Giannis 30 5 PTS 11 8 REB 4 5 AST Harden 35 8 PTS 7 5 REB 5 0 AST MVP Behavior ,89,525,3804,4329,video
CompanyJ_5144,Messi before the season We still have some unfinished business in the Champions League Now Barcelona are one game from the final via FCBarcelona ,145,787,4205,4992,video
CompanyJ_5145, AI s infamous practice rant was 17 years ago today ,52,877,3629,4506,photo
CompanyJ_5146,Jonathan Yim is the video coordinator for the Blazers Last Wednesday he missed their playoff game after being in a serious car crash Today Noah Vonleh wheeled him out of the hospital via Jonathan Yim Instagram ,210,491,5361,5852,video
CompanyJ_5147,The switch to Bucks in 5 real quick via nickgopaul86 IG ,56,2403,17726,20129,video
CompanyJ_5148,No 17 2021 recruit Chet Holmgren is blowing up The 7 foot sophomore is averaging 16 points 7 5 boards and 5 8 blocks per game on the UAA circuit ,145,439,3484,3923,video
CompanyJ_5149, I think the series is over The Celtics have gone 0 3 since Paul Pierce said the Bucks were done ,97,4016,26323,30339,photo
CompanyJ_5150,The Nets have the best odds to land Kyrie via br_betting ,57,631,3154,3785,photo
CompanyJ_5151,One hit wonder MoSalah has heard the doubters but he s happy to let his play on the field silence them New Take It There with TaylorRooks ,138,39,269,308,video
CompanyJ_5152,Salah believes ,15,938,3922,4860,photo
CompanyJ_5153,LIVERPOOL GOAL ,15,136,1200,1336,video
CompanyJ_5154,Suarez is getting under Liverpool s skin ,41,69,664,733,video
CompanyJ_5155,TURNAROUND Liverpool 3 3 Barcelona on aggregate ,48,886,3428,4314,photo
CompanyJ_5156,Liverpool scored two goals in two minutes ,42,420,1886,2306,video
CompanyJ_5157,LIVERPOOL TAKE THE LEAD ON AGGREGATE WHAT A GAME ,49,1171,4140,5311,photo
CompanyJ_5158,Barcelona shook ,16,699,3735,4434,photo
CompanyJ_5159,Trent Alexander Arnold caught Barcelona sleeping on Liverpool s 4th goal ,73,1229,5159,6388,video
CompanyJ_5160,Another Champions League miracle Liverpool complete the comeback and are through to the final via brfootball ,109,1067,3416,4483,photo
CompanyJ_5161,THEY DIDN T ,12,1679,9019,10698,link
CompanyJ_5162,First leg Barcelona 3 0 Liverpool Second leg Liverpool 4 0 Barcelona ,69,1624,7614,9238,video
CompanyJ_5163,LeBron knows something about historic comebacks via brfootball ,63,1532,6711,8243,photo
CompanyJ_5164,This is what it means UCL ,26,471,2771,3242,video
CompanyJ_5165,2018 Roma come back from 4 1 down to knock Barca out in quarterfinals 2019 Liverpool come back from 3 0 down to knock Barca out in semis It happened again via brfootball ,170,718,2795,3513,photo
CompanyJ_5166,Alisson said NO Liverpool s goalkeeper was huge vs Barcelona ,61,373,2383,2756,video
CompanyJ_5167,Paul George underwent rotator cuff surgery to repair right shoulder tendon Russell Westbrook had procedure to repair torn ligament in finger on left hand per royceyoung wojespn ,177,450,2501,2951,photo
CompanyJ_5168,D Antoni finally gets his revenge on Melo from their days in NY GameOfZones StateFarm Next episode is dropping EARLY Watch it on Wednesday only in the B R app ,159,152,755,907,video
CompanyJ_5169,What A Comeback ,16,1488,6579,8067,video
CompanyJ_5170,Winning a Super Bowl is thrilling but it wasn t as fulfilling for Martellus Bennett as some of the post retirement work via LefkoeShow ,135,58,436,494,video
CompanyJ_5171,Jokic has been a triple double machine in his first NBA playoffs ,65,172,1313,1485,video
CompanyJ_5172,Martellus wants to change the perception of the youth to promote more interests when they see these black kids all they see are athletes via LefkoeShow ,152,254,840,1094,video
CompanyJ_5173,30 years ago today Michael Jordan hit The Shot on Craig Ehlo No 3 seed Cavs eliminated by No 6 Bulls in Game 5 of 1st round Cavs swept regular season series 6 0 First playoff game winner of the many in Jordan s career Via NBAHistory ,233,612,3513,4125,video
CompanyJ_5174,Shaq s dominant personality inspired Bennett growing up representing what success looked like off the field via LefkoeShow ,123,62,311,373,video
CompanyJ_5175,Ouch ,5,107,1152,1259,photo
CompanyJ_5176,A few stitches can t keep Ibaka from throwing it down ,54,189,1956,2145,video
CompanyJ_5177,Kawhi jumped over everybody ,28,3060,15684,18744,video
CompanyJ_5178, You see what happened was Greg Monroe tried to explain why he took a corner 3 on the 76ers bench ,98,300,2297,2597,video
CompanyJ_5179,Kawhi threw one down on Embiid ,31,3279,16924,20203,video
CompanyJ_5180,Kawhi showed his Mamba Mentality ,33,2823,17035,19858,video
CompanyJ_5181,Faces say it all ,17,442,3055,3497,video
CompanyJ_5182, ,1,3500,22359,25859,video
CompanyJ_5183,Easy money for Dame Dolla ,26,183,1919,2102,video
CompanyJ_5184,That s cold Dame ,17,738,5680,6418,video
CompanyJ_5185,BBQ chicken alert ,18,739,5079,5818,video
CompanyJ_5186,Embiid didn t pay much attention to Drake and Raptors fans mocking his celebration ,83,201,1855,2056,video
CompanyJ_5187,M U S R L R A A M Y ,20,869,7690,8559,video
CompanyJ_5188,Things got heated between Jokic and the Blazers ,48,287,2574,2861,video
CompanyJ_5189,Nikola Jokic had a monster outing in Game 5 25 PTS 19 REB 6 AST Denver Nuggets take 3 2 series lead ,100,369,2949,3318,photo
CompanyJ_5190,Hernangomez put on the moves and the Nuggets bench lost it ,59,5536,38468,44004,video
CompanyJ_5191,All the Liverpool players joined the fans in singing You ll Never Walk Alone after their win Incredible via brfootball ,119,677,3745,4422,video
CompanyJ_5192,Zion LAUNCHED that so casually NSFW via chrissidy_wack IG ,58,1190,11276,12466,video
CompanyJ_5193,For the first time in six years neither Messi nor Ronaldo will be in the Champions League final via brfootball ,111,768,5036,5804,photo
CompanyJ_5194,4 years ago today D Rose hit the buzzer beater and the stare ,61,4923,23830,28753,video
CompanyJ_5195,Trent Alexander Arnold has been incredible for Liverpool Only 20 years old Nominated for 2018 Golden Boy 15 assists this season as a defender Assisted Liverpool s winning goal vs Barcelona on this quick corner ,210,260,2349,2609,video
CompanyJ_5196,Lonzo saw something he shouldn t have New GameOfZones drops early TONIGHT only in the B R app ,94,103,819,922,photo
CompanyJ_5197, Aye y all wanna see a dead body via hezifamily camarocarter Instagram ,71,1864,11175,13039,video
CompanyJ_5198,From draft training to MVP announcements bakermayfield and ChristianYelich are bro goals ,89,272,3574,3846,video
CompanyJ_5199,Coach World Peace ,18,396,3724,4120,photo
CompanyJ_5200, 4x Best Footballer in Asia All time leading Asian scorer in PL and UCL Helped South Korea to gold in the Asian Games for 1st time in 40 years How South Korea and Tottenham star Heung Min Son became an international hero ,221,118,824,942,photo
CompanyJ_5201,Man faked an injury to propose Next level via bbasiccc alex_mistev IG ,70,1951,12468,14419,video
CompanyJ_5202,4 goals vs Real Madrid and 2 vs Juventus Ajax levels up in the UCL second legs via brfootball ,94,31,626,657,photo
CompanyJ_5203, Deuce Dominguez tricked everyone at the NFL Draft into thinking that he was a first round pick via HoHighlights ,113,1177,5901,7078,video
CompanyJ_5204,No lead is safe via brfootball ,31,3619,16873,20492,photo
CompanyJ_5205,First step KEEP Lonzo SchoolboyQ fixes the Lakers franchise ,60,745,2922,3667,video
CompanyJ_5206,Ajax fans set off fireworks outside Tottenham s hotel last night via FSideNL ,77,107,753,860,video
CompanyJ_5207,Sterling Brown is playing key playoff minutes for the Bucks a year after his brutal encounter with police made national headlines He reflects on the experience and the support he s received ,190,103,591,694,photo
CompanyJ_5208,Zeke is covering the funeral costs of young football star Jaylon McKenzie who was shot and killed by a stray bullet He talked about him all the time When Ezekiel was playing his eyes were glued to the TV per clarencehilljr ,223,2558,12978,15536,photo
CompanyJ_5209,19 year old De Ligt coming up big again ,40,168,1342,1510,video
CompanyJ_5210,What a STRIKE from Ziyech ,26,579,3333,3912,video
CompanyJ_5211,Joker is in another zone this series 37 PTS 9 REB 6 AST 16 PTS 14 REB 7 AST 33 PTS 18 REB 14 AST 21 PTS 12 REB 11 AST 25 PTS 19 REB 6 AST ,138,984,6776,7760,photo
CompanyJ_5212,3 0 down on aggregate Tottenham mood ,37,54,606,660,video
CompanyJ_5213,Super Mario Run should be available at every ballpark this summer Via Cut4 ,75,1933,10083,12016,video
CompanyJ_5214,Lucas Moura really scored two goals in four minutes Now Ajax 3 2 Tottenham aggregate ,85,326,1756,2082,video
CompanyJ_5215,LAST MINUTE WINNER FOR TOTTENHAM COMEBACK COMPLETE ,51,1171,5111,6282,status
CompanyJ_5216,Tottenham vs Liverpool The 2019 Champions League final ,55,2869,8665,11534,photo
CompanyJ_5217,LAST MINUTE WINNER THROUGH TO THE CHAMPIONS LEAGUE FINAL ,57,2885,8819,11704,video
CompanyJ_5218,Leg 1 Ajax 1 0 Tottenham Leg 2 Lucas Moura 3 2 Ajax ,52,432,2387,2819,photo
CompanyJ_5219,Ajax s fairytale Champions League run comes to an end ,54,251,2025,2276,photo
CompanyJ_5220, SteveNash was in tears at full time of Tottenham s win ,56,5187,25753,30940,video
CompanyJ_5221,Two days Two games Two 3 0 comebacks via brfootball ,52,1066,6216,7282,photo
CompanyJ_5222,The LeBron AD trade deadline madness StateFarm Catch this week s GameOfZones early only in the B R app ,103,255,1364,1619,video
CompanyJ_5223, ,1,312,2731,3043,link
CompanyJ_5224,Tottenham going wild in the locker room after their win via ErikLamela ,71,372,1859,2231,video
CompanyJ_5225,Kyrie shows up in big games ,28,874,4348,5222,photo
CompanyJ_5226,Ty Lue has informed the Lakers that he is moving on from trying to become Lakers head coach per BA_Turner ,106,1269,5212,6481,photo
CompanyJ_5227, Ty Lue walked away ,20,568,2841,3409,photo
CompanyJ_5228,About that ,11,1480,10748,12228,link
CompanyJ_5229,Lakers front office after striking out on Ty Lue and Monty Williams ,68,844,4415,5259,photo
CompanyJ_5230,Horford tried Giannis in the paint It didn t end well ,54,2113,13749,15862,video
CompanyJ_5231,Kyrie after going 7 22 in Game 4 I should have shot 30 Kyrie in Game 5 5 16 FG in the 1st half ,95,1002,4656,5658,photo
CompanyJ_5232,Jaylen tried to end Giannis again ,34,485,3713,4198,video
CompanyJ_5233,Packers lineman David Bakhtiari chugged em both via MikeCianciolo ,66,1569,10600,12169,video
CompanyJ_5234,Danica Patrick tried to pay for a drink court side but the fan just gave it away for free ,90,1723,15480,17203,video
CompanyJ_5235,It s been BeardSeason the past two games for Harden averaging 39 5 PPG 9 5 RPG 5 0 APG Can he keep it going tonight ,116,1510,5846,7356,photo
CompanyJ_5236, ,1,5071,21447,26518,photo
CompanyJ_5237, Paul Pierce sucks chants to close out Game 5 in Milwaukee ,59,4032,17399,21431,video
CompanyJ_5238,Bucks end the Celtics season ,29,54008,161090,215098,video
CompanyJ_5239, ,1,1274,7309,8583,photo
CompanyJ_5240,The Kyrie Decision awaits ,26,6850,30326,37176,photo
CompanyJ_5241,Last time Kyrie is in a Celtics jersey ,39,1175,6699,7874,video
CompanyJ_5242,The year of the Greek Freak continues Career high PPG Career high APG Career high RPG Career high FG MVP front runner NBA s best record Eastern Conference Finals ,162,2090,11483,13573,photo
CompanyJ_5243,KLAY GAME Thompson is scorching 12 points 5 6 already ,54,278,2089,2367,video
CompanyJ_5244,Kyrie on if the free agency rumors affected his postseason No ,62,852,5276,6128,video
CompanyJ_5245,Kyrie in the conference semis 102 points 104 shots h t damanr ,62,1266,6467,7733,photo
CompanyJ_5246,KD full court dime Steph strong finish Warriors cannot be stopped ,66,294,1870,2164,video
CompanyJ_5247,You good CP3 ,13,371,2636,3007,video
CompanyJ_5248,Kevin Durant goes to the locker room after suffering an apparent non contact injury on lower leg ,97,4080,17187,21267,video
CompanyJ_5249,Kevin Durant has suffered a right calf strain and will not return to tonight s game ,84,614,3077,3691,photo
CompanyJ_5250,Draymond drains a BIG 3 after picking up a technical ,53,452,2869,3321,video
CompanyJ_5251,The Splash Bros stepped up BIG TIME in Game 5 Warriors now hold 3 2 series lead Steph 25 PTS 6 REB 5 AST Klay 27 PTS 4 REB 3 STL ,129,989,4147,5136,photo
CompanyJ_5252,Wild sequence seals Game 5 for the Warriors ,44,716,4104,4820,video
CompanyJ_5253,Steve Kerr on KD I was assured that it s a calf strain and not the Achilles ,76,513,3606,4119,video
CompanyJ_5254,Steve Kerr not holding back after the win ,42,421,3084,3505,photo
CompanyJ_5255,Did Klay step out of bounds ,28,1603,7161,8764,photo
CompanyJ_5256,These Champions League knockouts have been WILD Liverpool and Tottenham semifinal comebacks Ajax Cinderella run United knock out PSG Man City 4 3 Tottenham Ronaldo s comeback hat trick Messi s unreal free kick via brfootball ,225,333,2302,2635,photo
CompanyJ_5257,Ref couldn t believe it via purposebasketball IG ,49,8603,50295,58898,video
CompanyJ_5258, It s hard to speak Lucas Moura gets emotional re watching his 96 winner for Tottenham via Esp_Interativo brfootball ,117,365,2652,3017,video
CompanyJ_5259,That goal was a MESS via saoroque fc IG ,40,959,6279,7238,video
CompanyJ_5260,Sixers woes go deeper than their 3 2 deficit against Toronto ,61,138,1295,1433,video
CompanyJ_5261,Lakers fans will stage a protest tomorrow outside of Staples Center to voice their frustration with the franchise per AM570LASports ,132,4067,15968,20035,photo
CompanyJ_5262,Kevin Durant has mild strain on right calf will be re evaluated next week per wojespn ,86,860,4798,5658,photo
CompanyJ_5263,Aubameyang scored from outside the box with the outside of his boot ,68,335,2592,2927,video
CompanyJ_5264,Frankfurt started celebrating the goal before the ball was even hit via brlive ,79,123,1285,1408,video
CompanyJ_5265,Europa League finalists Arsenal is heading to their first European final since 2006 via brfootball ,99,372,1630,2002,photo
CompanyJ_5266, LeBron AD trade deadline madness Dirk knights KP and Luka New GameOfZones StateFarm ,85,2467,7580,10047,video
CompanyJ_5267,Are you still putting your money on the Warriors br_betting ,60,104,970,1074,photo
CompanyJ_5268,Are Raptors real contenders How prepared is The Process A playoffs without LeBron is teaching a lot about other teams ,118,207,1408,1615,video
CompanyJ_5269,That time Embiid prepped for a playoff game watching DBZ Happy GokuDay via NBAonTNT ,84,1597,9004,10601,video
CompanyJ_5270,Chelsea vs Arsenal The Europa League final is set via brfootball ,65,656,2233,2889,photo
CompanyJ_5271,Two European finals Four Premier League teams via brfootball ,61,1586,5916,7502,photo
CompanyJ_5272,THIS PENALTY SAVE ,18,1480,9267,10747,video
CompanyJ_5273,8 linemen had to catch a fade route to avoid conditioning LIGHT WORK via CoachRobLW ,84,2237,15299,17536,video
CompanyJ_5274,Gamebreaker in the Vans via Jamaaad ,36,4022,15875,19897,video
CompanyJ_5275,Mikey Williams hasn t even finished 8th grade yet via _mikeywilliams_ Instagram ,80,1674,10982,12656,video
CompanyJ_5276,Los Angeles mayor Eric Garcetti a Lakers fan says LA is a Clippers town right now per TMZ ,90,387,2130,2517,photo
CompanyJ_5277,Dolphins sign Pro Bowl CB Xavien Howard to record five year 76 5 million extension that will make him the highest paid CB in the NFL per AdamSchefter ,150,1179,6974,8153,photo
CompanyJ_5278,They ain t done yet ,20,126,1175,1301,photo
CompanyJ_5279,Kawhi snatched one over Boban via NBA ,38,1042,9314,10356,video
CompanyJ_5280,Jimmy and Simmons have been a PROBLEM in Game 6 via sixers ,59,324,2350,2674,video
CompanyJ_5281,He knocked his coach back down the hill via hhspioneersfb ,58,2578,12786,15364,video
CompanyJ_5282,Clint Frazier s cleat game is untouchable brkicks ,50,4795,21522,26317,photo
CompanyJ_5283,Simmons putback via sixers ,27,359,2527,2886,video
CompanyJ_5284,Live look at Nick Nurse ,24,60,918,978,photo
CompanyJ_5285,Jimmy and the Sixers force a Game 7 ,36,1120,7343,8463,photo
CompanyJ_5286,JoJo and the 76ers DENIED the Raptors in Game 6 ,48,286,1705,1991,video
CompanyJ_5287,Dame locking in ,16,226,2257,2483,photo
CompanyJ_5288,JoJo was thirsty ,17,766,8177,8943,video
CompanyJ_5289,Logo Lillard getting ready via trailblazers ,44,774,5664,6438,video
CompanyJ_5290,Dame isn t ready to go home yet via NBA ,40,1849,16891,18740,video
CompanyJ_5291, ,1,312,2984,3296,photo
CompanyJ_5292,Dame and the Blazers are headed to Game 7 ,42,1326,8421,9747,photo
CompanyJ_5293,Logo Lillard torched the Nuggets from 3PT land in Game 6 Dame finished with 32 PTS and hit 6 threes ,100,397,2514,2911,video
CompanyJ_5294, I wish I could play with my broken leg I would go out there right now and get hurt again if I could Dame tells story of what Nurkic said to him on the bench during Game 6 ,172,693,5923,6616,video
CompanyJ_5295,Four years ago today LeBron called his own number with Game 4 of the Eastern Conference Semifinals on the line Give me the ball and everybody get out of the way ,161,2805,14438,17243,video
CompanyJ_5296,Broke out Harden s Euro and step back at graduation via dpaulos IG ,67,5047,36007,41054,video
CompanyJ_5297,HOW via jordanthefreestyler IG ,31,1046,6612,7658,video
CompanyJ_5298,If the Rockets win tonight SUNDAY Rockets Warriors Game 7 Blazers Nuggets Game 7 Sixers Raptors Game 7 Final day of Premier League Game of Thrones ,147,4488,16050,20538,photo
CompanyJ_5299,Celebrated graduation like the iconic Dame game winner staredown included via ngel407 ,86,2180,15479,17659,video
CompanyJ_5300,KD and Klay s free agency looming Iguodala and Livingston on the verge of retirement The Warriors talk about their extra motivation and how this playoff run looks a lot like the 98 Bulls ,187,188,1330,1518,photo
CompanyJ_5301,Bucks fans showing no mercy right down to the phone number via KRoseSharkey ,76,3149,13715,16864,photo
CompanyJ_5302,The scene at the Lakers fans protest in front of Staples via latimessports ,75,939,4244,5183,video
CompanyJ_5303, THE LAKER ERA IS OVER Clipper Darrell crashed the Lakers protest via ArashMarkazi ,83,2531,12302,14833,video
CompanyJ_5304,Clipper fans watching the Lakers protest ,41,1789,10780,12569,photo
CompanyJ_5305,Three years ago today Steph Curry became the first unanimous MVP in NBA history 30 1 PPG 6 7 AST 50 4 FG Single season 3s record Scoring champ 50 40 90 club Steals leader 73 wins ,179,2353,11408,13761,photo
CompanyJ_5306,She sonned him via DirtyRedDev ,31,1409,8069,9478,video
CompanyJ_5307, They call it an embarrassment Unnamed Lakers players sounded off on what the franchise is doing per ChrisBHaynes ,114,484,3011,3495,photo
CompanyJ_5308,LeBron helped grant his I PROMISE school 1 million to build a new gym for its students ,87,1425,10190,11615,photo
CompanyJ_5309, and the Roc are in the building for Game 6 via NBA ,52,2160,11633,13793,photo
CompanyJ_5310, Bend the knee and I will name you Warden of the Western Conference ,68,2569,13273,15842,photo
CompanyJ_5311, GAME 6 Warriors Rockets tied at 57 Klay 21 PTS Harden 19 PTS ,62,358,2442,2800,photo
CompanyJ_5312,CP3 showing out to save the Rockets season via HoustonRockets ,62,249,1895,2144,video
CompanyJ_5313,Steph comes alive in the 4th and the Warriors are headed to the WCF ,68,3027,11407,14434,photo
CompanyJ_5314,The Rockets just can t get by the Warriors ,43,29386,84252,113638,video
CompanyJ_5315,Draymond gets the last laugh over Harden ,41,1039,4499,5538,video
CompanyJ_5316,Steph and Klay CALLED GAME ,27,3562,15546,19108,video
CompanyJ_5317, via HoustonRockets ,20,2444,17896,20340,photo
CompanyJ_5318, WYD this summer ,17,1465,9426,10891,photo
CompanyJ_5319, ,1,1892,10738,12630,photo
CompanyJ_5320,KD celebrating the Warriors Game 6 win from home ,49,1970,10439,12409,photo
CompanyJ_5321, If we want to get this 3 peat we desperately need him back He s our best player Klay on KD ,92,2874,20938,23812,video
CompanyJ_5322,Steph really bounced back to drop 33 second half points A night like tonight doesn t happen without belief in myself ,117,515,4463,4978,photo
CompanyJ_5323,Pulisic comes alive in his final home game via FOXSoccer ,57,262,2744,3006,photo
CompanyJ_5324,The Raptors don t know what Kawhi will do this summer but Kyle Lowry and other players have been blown away this year He s a really f kin good teammate man ,156,424,4287,4711,photo
CompanyJ_5325,Steph on his clutch 2nd half That was the best 18 minutes of my career per ChrisBHaynes ,88,453,4198,4651,photo
CompanyJ_5326,This couple changed the engagement shoot game by recreating iconic NBA moments via Thomas_Bullock_ row show Instagram ,118,4233,23693,27926,photo
CompanyJ_5327,Kyrie has had discussions with people about playing for the Lakers ahead of his free agency this summer per WindhorstESPN ,122,4520,19743,24263,photo
CompanyJ_5328,They played a quick game of monkey in the middle via USLChampionship ,69,479,3901,4380,video
CompanyJ_5329,What is this workout via findjores ,35,390,2390,2780,video
CompanyJ_5330,Just have to walk off the court at that point via FIBA3x3 ,58,176,1535,1711,video
CompanyJ_5331, Kick me off the court again boy Steph got the last laugh after Chris Paul kicked him off the court pregame via ReidForgrave ,125,13401,54813,68214,video
CompanyJ_5332,39 years ago today Dr J went UP UNDER AND ,42,4476,26601,31077,photo
CompanyJ_5333,Frank Vogel has emerged as a front runner to be offered Lakers HC job Lakers are planning to pair Jason Kidd with Vogel as an assistant coach per wojespn NotoriousOHM ,167,525,2418,2943,photo
CompanyJ_5334,Bronny Skyy Clark Dior Johnson and Emoni Bates put on a SHOW ,61,560,3784,4344,video
CompanyJ_5335,Incredible via danthemancina IG ,32,494,4462,4956,video
CompanyJ_5336,Breaking Frank Vogel has agreed to become the next head coach of the Lakers per wojespn ,88,1855,7097,8952,photo
CompanyJ_5337,Jason Kidd has joined the Lakers as an assistant coach on Frank Vogel s staff per taniaganguli ,95,1700,6957,8657,photo
CompanyJ_5338, Frank Vogel Frank Ocean Frank Gore don t matter this my team ,62,18703,72553,91256,photo
CompanyJ_5339,,0,642,3847,4489,photo
CompanyJ_5340,Mikey Williams is a problem in the making ,42,9461,46536,55997,video
CompanyJ_5341,8 years ago today LeBron took down the Boston Celtics for the first time in the postseason James ended Game 5 on a 10 0 run to close out the series ,148,1623,8319,9942,photo
CompanyJ_5342,A full out DIVE for the finish via SECNetwork ,46,5349,30472,35821,video
CompanyJ_5343,Douglas Lima put him to sleep via BellatorMMA ,46,5663,21552,27215,video
CompanyJ_5344,Anderson Silva loses to Jared Cannonier via 1st round TKO at UFC237 ,68,284,1600,1884,photo
CompanyJ_5345,Premier League title on the line via brfootball ,48,89,597,686,photo
CompanyJ_5346,Two Game 7s today LET S GO ,27,3978,18067,22045,photo
CompanyJ_5347,This 13 year old has a size 18 foot and struggled to find afford shoes Shaq heard and bought him 10 pairs via CNN ,114,9091,58969,68060,video
CompanyJ_5348,SADIO MANE PUTS LIVERPOOL AHEAD via NBCSportsSoccer ,52,158,1220,1378,video
CompanyJ_5349,Sergio Aguero nutmegs the keeper to bring the game to 1 1 via NBCSportsSoccer ,78,158,1219,1377,video
CompanyJ_5350,Best two words in sports Game 7 ,32,3810,22398,26208,photo
CompanyJ_5351,Happy Mother s Day ,19,1045,8147,9192,photo
CompanyJ_5352,Brighton 1 3 Man City Liverpool mood ,37,252,1215,1467,photo
CompanyJ_5353,CHAMPIONS AGAIN Manchester City wins the Premier League for the second year in a row via brfootball ,100,647,2443,3090,photo
CompanyJ_5354,Man City 98 points Liverpool 97 points Just short ,50,375,2896,3271,photo
CompanyJ_5355,PFA Young Player of the Year League Cup winner Premier League winner What a season for sterling7 via brfootball ,112,350,1940,2290,photo
CompanyJ_5356,CHAMPIONS via NBCSportsSoccer ,30,512,2754,3266,video
CompanyJ_5357,On this day in 1997 Kobe put up FOUR air balls in the 4th quarter and OT vs Utah to end his rookie season It changed his career Only 18 years old Shot at local HS into the a m Dropped out of He Got Game Motivated him for 20 years ,230,4034,18494,22528,photo
CompanyJ_5358,Mo Salah s daughter scores in front of the Liverpool fans and the crowd goes wild via nathanmurf ,97,3523,19441,22964,video
CompanyJ_5359,Moms are the real MVPs via NBATV ,33,5169,19497,24666,video
CompanyJ_5360,D Wade says he dunked on Kendrick Perkins as revenge for kicking him in the back of the head via HoHighlights ,110,8147,35838,43985,video
CompanyJ_5361,Wasn t expecting that via isayahhatter09 ,41,429,3613,4042,video
CompanyJ_5362,Kristaps Porzingis involved in a fight in Latvia with a group of Russians who were upset he left the Knicks per TMZ_Sports ,123,3157,13272,16429,photo
CompanyJ_5363,Pro skater at 14 First 900 spin ever Timeless video games Worth over 140M Built 500 skateparks Changed narrative around skating Happy 51st to the legendary Tony Hawk ,166,18554,79131,97685,photo
CompanyJ_5364,Dame to start Game 7 0 PTS 0 6 FG 0 3 3PT ,42,296,2734,3030,photo
CompanyJ_5365,Enes Kanter woke up at 3 25 a m to eat because he s fasting for Ramadan per heydb Fasting extends to water during timeouts but he says he feels like his mind is sharper ,169,1559,7817,9376,photo
CompanyJ_5366,CJ leaving everything on the floor in Game 7 via trailblazers ,62,439,3037,3476,video
CompanyJ_5367,That was tough thats_G_ via nuggets ,36,126,999,1125,video
CompanyJ_5368,Game 7 4th quarter 12 more minutes Who s moving on ,51,211,1869,2080,photo
CompanyJ_5369,CJ AND THE C STANDS FOR CHASEDOWN via NBCSNorthwest ,52,738,3932,4670,video
CompanyJ_5370,IT S TIME ,10,1186,7515,8701,photo
CompanyJ_5371,This man is on another level ,29,1043,5489,6532,photo
CompanyJ_5372,THIS GAME ,10,959,3895,4854,photo
CompanyJ_5373,CJ IS A BAD MAN ,16,1801,8578,10379,photo
CompanyJ_5374,G A M E 7 C J via NBAUK ,24,2106,9770,11876,video
CompanyJ_5375,Blazers eliminate the Nuggets and advance to the Western Conference Finals ,75,5320,23127,28447,photo
CompanyJ_5376,Two Northeast Ohio legends with clutch blocks in a Game 7 ,58,3917,18450,22367,video
CompanyJ_5377,CJ McCollum could not be stopped in Game 7 37 PTS 9 REB 17 29 FG W ,67,1167,5759,6926,video
CompanyJ_5378,Kanter had that in the drafts ,30,1167,8616,9783,link
CompanyJ_5379,Back in the WCF for the first time since 1999 2000 Rip City ,60,838,4990,5828,photo
CompanyJ_5380,The WCF should be fun ,22,7442,36932,44374,link
CompanyJ_5381, ,1,605,4459,5064,photo
CompanyJ_5382,All the feels via trailblazers ,31,7675,45005,52680,video
CompanyJ_5383,Blazers Game 7 summary ,23,1003,4685,5688,video
CompanyJ_5384,Seth vs Steph ,14,2787,15697,18484,photo
CompanyJ_5385, GIMME THAT Kawhi ,18,1957,13026,14983,video
CompanyJ_5386,CJ still feeling himself after his big shot ,44,1254,9102,10356,photo
CompanyJ_5387,Kobe confirmed ,15,1777,10411,12188,photo
CompanyJ_5388, I just went and got it Bron style CJ says his chase down block in Game 7 reminded him of LeBron s in 2016 ,107,3173,17267,20440,video
CompanyJ_5389,Things getting wild in Toronto ,31,239,1880,2119,video
CompanyJ_5390,Kawhi has taken 30 shots in this game We still have a quarter to go ,68,1458,9766,11224,photo
CompanyJ_5391,Jimmy G Buckets ,16,210,1672,1882,video
CompanyJ_5392,Kawhi goin IN for Game 7 36 and counting for Leonard ,53,337,2055,2392,video
CompanyJ_5393,Tobias too smooth NHTSAgov ,27,48,517,565,video
CompanyJ_5394,KAWHI GOING OFF 38 PTS ,23,414,2666,3080,video
CompanyJ_5395,JIMMY GAME IS TIED ,19,590,2809,3399,photo
CompanyJ_5396,OH MY KAWHI ,12,5878,21620,27498,status
CompanyJ_5397,Kawhi carries Toronto to the Eastern Conference Finals ,55,2937,11868,14805,photo
CompanyJ_5398,KAWHI FOR THE WIN NASDPIFHBKADNS GBF ,37,31447,84532,115979,video
CompanyJ_5399,Shooter s touch ,16,8116,34085,42201,video
CompanyJ_5400,Kawhi s reaction to his game winner is priceless ,49,7114,32116,39230,video
CompanyJ_5401,JoJo was in tears after a heartbreaking Game 7 loss ,52,3428,19843,23271,video
CompanyJ_5402,This photo Wow ,15,38326,141894,180220,photo
CompanyJ_5403,Drake used the curse against the 76ers with his shorts NSFW via Drake IG Story ,79,7475,36362,43837,video
CompanyJ_5404,There s something about Toronto walking off on Philly ,54,1994,10996,12990,photo
CompanyJ_5405,Kawhi s game winner has Drake ready to drop a classic ,54,5706,29410,35116,photo
CompanyJ_5406,Super Bowl champion WR Doug Baldwin announces his retirement via Twitter ,73,1633,13069,14702,photo
CompanyJ_5407,Breaking Michigan s John Beilein will be Cleveland Cavaliers next head coach after signing 5 year deal per wojespn ,115,1623,9016,10639,photo
CompanyJ_5408,Embiid gets perspective from his coach after a gut wrenching Game 7 loss ,73,237,2433,2670,video
CompanyJ_5409,The 6 God was on the Raptors side in Game 7 ,44,4760,27298,32058,video
CompanyJ_5410,Clutch ,7,991,10784,11775,photo
CompanyJ_5411,Incredible Game 7s Man City PL champs Curry comes alive UCL comebacks What a week ,82,963,7155,8118,photo
CompanyJ_5412,The newest GameOfThrones cast member via AaronRodgers12 ,56,255,2550,2805,photo
CompanyJ_5413, That was the first buzzer beating Game 7 winner in NBA history Kawhi ,70,11020,70734,81754,video
CompanyJ_5414,The GOAT free throw shooter De11eDonne just keeps it simple and hits 93 4 from the line New Take It There with TaylorRooks drops Wednesday ,139,350,2313,2663,video
CompanyJ_5415,Gobert knows when to put the rivalry aside ,43,4047,29116,33163,photo
CompanyJ_5416,Back to back Premier League top scorer ,39,127,1658,1785,photo
CompanyJ_5417,Kawhi averaged 34 7 PPG vs Philly and capped it with an iconic buzzer beater A series for the ages ,99,699,5971,6670,video
CompanyJ_5418, That was terrible I m sorry guys via dallasmavs ,49,545,6287,6832,video
CompanyJ_5419,Kevin Durant will miss Game 1 of the WCF and it s unlikely he plays Game 2 per ramonashelburne ,95,652,3530,4182,photo
CompanyJ_5420,On a SCOOTER via dantehutchinson IG ,36,2949,15337,18286,video
CompanyJ_5421,He said what s up to 50cent mid fight via BellatorMMA ,54,3793,19336,23129,video
CompanyJ_5422,Russell Wilson surprised his mom with a new house on Mother s Day Her reaction via DangeRussWilson ,99,12354,73674,86028,video
CompanyJ_5423, I still think my son is a victim Former top CBB recruit Brian Bowen and his dad were engulfed in a bribery scandal Where did he go from there ,143,68,464,532,photo
CompanyJ_5424,Ref broke out an impression of Harden complaining via CKPremierBall ,68,1848,12448,14296,video
CompanyJ_5425,Really juggling with her phone via lisafreestyle IG ,52,991,7350,8341,video
CompanyJ_5426,Kawhi s Uncle Dennis celebrated with Masai Ujiri and Raptors co owner Larry Tanenbaum last night via BikRaiMD ,110,330,2853,3183,video
CompanyJ_5427,Queensbridge AAU legend Infamy in Indiana Finals Glory Quiet Storm The Ron Artest Story drops on SHOsports on 5 31 ,115,680,2102,2782,video
CompanyJ_5428,The Champions have a surprise challenge a bake off The Champions Ep 3 ,70,105,596,701,video
CompanyJ_5429,Kawhi put the Raptors and these bettors on his back via br_betting ,67,381,2803,3184,video
CompanyJ_5430,There s hyped bench celebrations then there s this via ariivory ,64,347,2772,3119,video
CompanyJ_5431,Breaking Dallas Wings are finalizing a trade to send WNBA All Star Liz Cambage to the Las Vegas Aces per BradyKlopferNBA Cambage in 2018 23 PPG 9 7 RPG MVP runner up ,166,622,2825,3447,photo
CompanyJ_5432,Crowd went wild as Matthew Boling ran a 44 74 400 meter for the comeback win via vypehouston ,93,5345,34723,40068,video
CompanyJ_5433,Brett Brown will return as coach of the Sixers next season per wojespn ,71,974,8416,9390,photo
CompanyJ_5434,Lottery day ,12,3685,34666,38351,photo
CompanyJ_5435,Jimmy Butler thinks he ll get a max contract anywhere I choose to go per sjnard ,80,636,6548,7184,photo
CompanyJ_5436,Conference Finals 4 Teams Who makes it out metrobytmobile ,58,357,2291,2648,video
CompanyJ_5437,Mike Miller s son Mason with a MEAN poster via MikeMiller_13 ,61,1257,10440,11697,video
CompanyJ_5438, MuhammadAli s hand speed was ridiculous The two part special WhatsMyName drops tonight at 8PM on HBO ,102,401,2022,2423,photo
CompanyJ_5439,Knicks fans getting ready for the NBADraftLottery via ccortiz143 Instagram ,75,1070,6791,7861,photo
CompanyJ_5440,Rozier isn t interested in running it back with the same team ,62,754,4822,5576,photo
CompanyJ_5441,We took Knicks fans to a wrecking room before the NBADraftLottery ,66,430,2121,2551,video
CompanyJ_5442, He will be the Zion Williamson of college football Darnell Washington is a 6 8 260 pound high school recruit with 40 scholarship offers and high expectations ,159,247,1600,1847,photo
CompanyJ_5443,D Wade says he s gonna pull up at LeBron s house to have him sign the iconic Heat photo via HoHighlights ,105,2945,20578,23523,video
CompanyJ_5444,Knicks will shift focus to a deal for Anthony Davis if they get the No 1 pick per ShamsCharania ,96,2793,11637,14430,photo
CompanyJ_5445,Who you riding for in the NBADraftLottery tonight via br_betting ,65,216,1778,1994,photo
CompanyJ_5446,Baker feeding OBJ Get used to this via Browns ,46,3308,24242,27550,video
CompanyJ_5447,Miggy tired of the chin patch Via Cut4 ,39,74,1309,1383,video
CompanyJ_5448,After being linked to a transfer to Barcelona Griezmann has told Atlético Madrid he s leaving this summer per marca ,116,1597,5200,6797,photo
CompanyJ_5449,Steph and Seth Curry are set to make history in the conference finals Their parents plan to flip a coin to decide who to root for ,130,1112,6904,8016,video
CompanyJ_5450,Griezmann says goodbye to Atletico Madrid via brfootball ,57,670,4493,5163,photo
CompanyJ_5451,And then there were four Conference Finals begin today ,55,4500,21790,26290,photo
CompanyJ_5452,Lonzo caught LeBron AD in the act of tampering Last episode of GameOfZones was New one drops Thursday at 5 p m ET StateFarm ,124,475,1945,2420,video
CompanyJ_5453,Curry household using the coin toss to decide which parent will root for Seth and Steph via sydelcurrylee IG ,109,2673,14256,16929,video
CompanyJ_5454, I think sometimes people fear them and when they sense that little bit of fear you done Dame is ready for Golden State ,120,1340,7267,8607,video
CompanyJ_5455,Warriors Rockets Nuggets Blazers Two incredible series set up for what could be a historic Western Conference Finals ControlTheGame WellsFargo ,143,105,689,794,video
CompanyJ_5456,Every Knicks fan getting ready for the Lottery via jahson30 ,60,618,2685,3303,video
CompanyJ_5457,Zion is going 1st but Ja is no consolation prize for whoever gets No 2 ,71,694,5805,6499,photo
CompanyJ_5458,NBA fans ahead of tonight s lottery ,36,3835,23056,26891,video
CompanyJ_5459,Could Zion and RJ make history as the 2nd pair of teammates to be taken 1 and 2 in the NBA Draft ,97,219,1754,1973,video
CompanyJ_5460,This Knicks fan really tatted Zion on their ankle before the lottery even started via MasterTes ,96,1679,5984,7663,video
CompanyJ_5461,Lakers jump into the top 4 of the NBADraftLottery ,50,2149,7868,10017,photo
CompanyJ_5462,Suns Bulls Hawks Cavaliers all drop out the top 4 ,50,2446,10702,13148,photo
CompanyJ_5463,Pelicans get the 1st overall pick in the 2019 NBA draft Is Zion New Orleans bound ,82,3868,12570,16438,photo
CompanyJ_5464,Knicks fans after falling to No 3 ,34,7801,31760,39561,video
CompanyJ_5465,Knicks fans might never get to see this via brkicks ,52,2021,10181,12202,photo
CompanyJ_5466,Pelicans front office couldn t be more thrilled about winning the lottery via PelicansNBA ,90,3057,19457,22514,video
CompanyJ_5467,Wonder who the Pelicans will take via br_betting ,49,733,4679,5412,photo
CompanyJ_5468,Lakers secure a higher pick than the Cavs in Bron s first year in LA ,69,2446,18331,20777,photo
CompanyJ_5469,Vlad Jr goes yard First of many to come Via MLB ,48,1015,6415,7430,video
CompanyJ_5470, I think this is RJ s team RJ you wanna play for the Knicks Zion might have called RJ to the Knicks back in December via MikeAScotto ,133,1107,7209,8316,video
CompanyJ_5471,Warriors up 54 45 on Blazers in Game 1 Steph already with 4 3PTS and 19 PTS in the first half ,94,236,1628,1864,photo
CompanyJ_5472,Steph cookin in Game 1 via NBA ,31,500,3362,3862,video
CompanyJ_5473,Zion s rookie season about to be wild via HoHighlights ,55,17592,60485,78077,video
CompanyJ_5474,36 points and 9 threes for Steph and the Warriors take Game 1 ,62,1447,7587,9034,photo
CompanyJ_5475,Steph WENT OFF from 3PT land in Game 1 MountainDew ,51,408,2334,2742,video
CompanyJ_5476,Imagine playing against your sibling in the Western Conference Finals ,70,1537,12538,14075,photo
CompanyJ_5477,Vlad Jr decided one wasn t enough TWO moonshots for the rook in one night via BlueJays ,87,655,4649,5304,video
CompanyJ_5478, Who you with Steph after seeing his mom cheer for him in Portland gear ,72,819,6875,7694,video
CompanyJ_5479,Terry Stotts was not having it with this question ,50,1201,8307,9508,video
CompanyJ_5480,Kawhi came through for everyone in The 6 ,41,1696,8900,10596,video
CompanyJ_5481,Knicks fans celebrated the Lakers getting 4th pick then they got 3rd via ronnieebrani IG MasterTes ,99,4986,23254,28240,video
CompanyJ_5482,A look at NBADraftWass s early mock ,36,61,437,498,link
CompanyJ_5483,Tiger is hot off a Masters win but Francesco Molinari might steal his spotlight at the PGA Championship CallawayGolf ,117,16,142,158,video
CompanyJ_5484,Good to see Shareef dunking again via SSJreef brhoops ,54,889,8107,8996,video
CompanyJ_5485,GOT EM via sharif_eljackson IG ,31,1243,7192,8435,video
CompanyJ_5486,Teams might want to rethink the strategy ,41,1273,9043,10316,photo
CompanyJ_5487,Messi Suarez Griezmann This could happen next season via brfootball ,68,407,3347,3754,photo
CompanyJ_5488,NBA expected to move start of moratorium from midnight July 1st to 6pm June 30th to allow teams to start talking to players earlier per TimBontemps ,148,470,3074,3544,photo
CompanyJ_5489,Deontay Wilder says it s legal in boxing to kill a man and get paid for it at the same time so why not use my right to do so via ryansongalia ,142,11497,43217,54714,video
CompanyJ_5490,Adam Gase didn t want to spend a lot of money on any RB and absolutely did not want to sign Le Veon Bell per MMehtaNYDN ,120,482,2517,2999,photo
CompanyJ_5491,She dunked all over him via nate____hall IG ,44,8243,34220,42463,video
CompanyJ_5492,18 years ago today Allen Iverson was named MVP of the league First player since 92 93 Jordan to lead league in PPG 31 1 and SPG 2 5 With 93 124 first place votes AI beat out Duncan and Shaq At 6 0 and 165 pounds he s the shortest and lightest player to ever win ,262,5726,21367,27093,photo
CompanyJ_5493,The choice is always clear for Aguero via brfootball ,53,171,1721,1892,photo
CompanyJ_5494,Shaq on the NBA draft lottery per tmz_sports Knicks fans are so pissed and I m loving it ,89,865,8237,9102,photo
CompanyJ_5495,Larry Bird and Magic Johnson will receive the Lifetime Achievement Award at this year s NBA Awards ,99,1044,7712,8756,photo
CompanyJ_5496,Vlad Jr broke his slump in Guerrero fashion 2 HRs 4 RBIs ,57,132,1852,1984,photo
CompanyJ_5497,Zion is gonna put on a dunk show in NOLA via Shady00018 ,56,583,3874,4457,video
CompanyJ_5498,This tattoo of Kawhi watching his game winner fall couldn t be any cleaner via kriistian Instagram ,99,889,6806,7695,photo
CompanyJ_5499,LeBron s love for Muhammad Ali runs deep Mourned him during 2016 Finals Ali Frazier inspired 3 1 comeback Gave 2 5M to Ali museum exhibit Calls him the GOAT athlete Role model for charity work Exec produced HBO doc on him ,222,969,6743,7712,photo
CompanyJ_5500,Pelicans are still not interested in trading AD to the Lakers even after LA landed the No 4 pick per WindhorstESPN ,115,1995,10526,12521,photo
CompanyJ_5501, Oh excuse me via tylertrudeau_ Instagram ,42,4494,24494,28988,video
CompanyJ_5502, At least say order Postmates or something Mystics superstar De11eDonne is tired of the kitchen comments New Take It There with TaylorRooks ,140,280,1064,1344,video
CompanyJ_5503,Dominant two way superstars Best records in the league Shot at the East crown This series is gonna be good ,107,2234,17077,19311,photo
CompanyJ_5504,Garbage men were getting some shots up via brysongath IG ,57,483,4180,4663,video
CompanyJ_5505,Giannis silenced the Celtics Kawhi made history in Game 7 The Bucks Raptors Eastern Conference Finals matchup is a must watch ControlTheGame wellsfargo ,152,65,760,825,video
CompanyJ_5506, alexmorgan13 via brfootball ,29,95,812,907,photo
CompanyJ_5507,Raptors president Masai Ujiri helped Giannis get Greek citizenship and jump start his career growing up Giannis is still thankful ahead of the ECF He s an unbelievable guy ,172,1035,10124,11159,photo
CompanyJ_5508,Giannis is ready to feast ,26,646,5476,6122,video
CompanyJ_5509,Spicy P on Brook ,17,745,5708,6453,video
CompanyJ_5510,Pascal hits from DEEP to end the 3rd ,37,281,2397,2678,video
CompanyJ_5511,LOWRY IN HIS BAG ,17,289,3149,3438,video
CompanyJ_5512,BROOK HAS 29 ,13,337,2654,2991,photo
CompanyJ_5513,Bucks take Game 1 of the ECF Giannis 24 PTS 14 REB 6 AST Lopez 29 PTS 11 REB 4 BLK ,83,959,5263,6222,photo
CompanyJ_5514,THE LOPEZ GAME Brook went off vs Toronto 29 PTS 12 21 FG 4 11 3PT 4 BLK Season high PTS Playoff career high ,108,1886,14462,16348,video
CompanyJ_5515,Shaq started a Barkley sucks chant with the Milwaukee crowd via NBAonTNT ,73,1788,13142,14930,video
CompanyJ_5516,Kawhi shot 10 26 amp didn t make a FG in the 4th quarter ,57,365,3639,4004,photo
CompanyJ_5517,Tiger hasn t won back to back majors since 2006 Can he do it this weekend at the PGAChampionship Chevrolet ,107,129,1558,1687,video
CompanyJ_5518,May 16 1980 Magic Johnson secured the chip with LA in Game 6 6 9 PG started at C for injured Kareem Played all 5 positions 42 PTS 15 REB 7 AST Won Finals MVP as a rookie ,170,4888,25712,30600,photo
CompanyJ_5519,Nick Kyrgios lost it after a penalty call and was DQ d TennisChannel ,69,131,1071,1202,video
CompanyJ_5520,Tiger knocks down his first birdie of the day He s 1 after six holes at the PGAChampionship Watch on brlive ,108,49,565,614,photo
CompanyJ_5521,Back to back nutmegs and a backheel pass FILTHY via ForwardMSNFC ,65,492,3816,4308,video
CompanyJ_5522,Boban s a real star via tobias31 ,33,1414,15446,16860,video
CompanyJ_5523,Tiger s approach to set up his second birdie in a row Watch on brlive via PGAChampionship ,90,16,169,185,video
CompanyJ_5524,Tania Tare s trick shots are unreal ,36,739,3941,4680,video
CompanyJ_5525,Ric Flair has been hospitalized after a medical emergency situation is reportedly very serious per TMZ_Sports ,110,5661,16418,22079,photo
CompanyJ_5526,He was really going to do it again via brfootball ,50,162,2063,2225,photo
CompanyJ_5527,Patrick Peterson suspended first six games of season for violating the NFL s performance enhancing drug policy per AdamSchefter ,128,462,2043,2505,photo
CompanyJ_5528,Shaw University s Amir Hinton 29 4 PPG is trying to become the first D II player to get drafted in 14 years As a slasher and a scorer his game is exactly like Dwyane Wade s coming out of college ,195,711,2404,3115,photo
CompanyJ_5529,Dropped her with the fancy footwork via SudLadiesCup ,53,350,2240,2590,video
CompanyJ_5530,KD Kyrie rumors really got Knicks as potential favorites for next season via br_betting ,88,408,2139,2547,photo
CompanyJ_5531,Brooks Koepka was ridiculous in Round 1 of the PGAChampionship He finishes 7 and leads by four ,95,74,938,1012,video
CompanyJ_5532,WATCH OUT via kjodell01 ,24,471,2833,3304,video
CompanyJ_5533,Big stars could be on the move this summer via brfootball ,58,2430,13001,15431,photo
CompanyJ_5534,Teams make their Zion pitch to the lottery gods and LeBron is drinking through it all StateFarm GameOfZones ,108,2475,8192,10667,video
CompanyJ_5535,Wild ,5,1279,9060,10339,photo
CompanyJ_5536,The Knicks may have lost out on Zion but HowardBeck says they could still win the AD lottery ,93,240,1820,2060,video
CompanyJ_5537,Dame puts on for Oakland TownBusiness ,38,371,3606,3977,photo
CompanyJ_5538,He really squatted 655 pounds via justin_homberg IG ,52,2547,25534,28081,video
CompanyJ_5539,CJ finally meets Jennifer in person via trailblazers ,53,1368,10841,12209,video
CompanyJ_5540,Giannis says not having LeBron in the East makes things a little bit easier not trying to go through him ,105,3148,20088,23236,photo
CompanyJ_5541,The broadcaster called his own foul ball catch via MarcSchwartz26 mashmore98 ,77,1312,6306,7618,video
CompanyJ_5542,According to GM Bob Myers Kevin Durant calf strain will not travel to Portland for Game 3 and 4 ,96,676,2835,3511,photo
CompanyJ_5543,Tacko Fall is a force of nature ,32,1869,12375,14244,photo
CompanyJ_5544,Steph hit CJ with the combos via warriors ,42,865,5473,6338,video
CompanyJ_5545,Blazers lead Warriors 65 50 at halftime CJ s got 16 PTS ,56,327,2630,2957,photo
CompanyJ_5546,KD took time to support all his Warriors teammates in the tunnel ,65,567,7143,7710,photo
CompanyJ_5547,Steph heating up in the 3rd He s got 27 and counting ,53,227,1868,2095,photo
CompanyJ_5548,Klay starting to see the ocean via warriors ,44,339,2609,2948,video
CompanyJ_5549,Dame FROM DEEP via trailblazers ,32,678,5199,5877,video
CompanyJ_5550,THIS GAME ,10,396,2867,3263,photo
CompanyJ_5551,TOWN BUSINESS Warriors take Game 2 and 2 0 series lead ,55,1414,5516,6930,photo
CompanyJ_5552,Iggy LOCKED DOWN Dame and ran straight to the locker room ,58,4205,23307,27512,video
CompanyJ_5553,Just like old times ,20,411,4568,4979,photo
CompanyJ_5554, It s a little more serious than we thought Steve Kerr on Kevin Durant s calf strain ,85,264,1925,2189,video
CompanyJ_5555,Iggy stole Game 2 from Portland ,32,361,3192,3553,photo
CompanyJ_5556, Childhood karate prodigy MMA s next big thing UFC pariah Sage Northcutt embraces a new opportunity in his ONE Championship debut Watch now on BRLive ,150,60,668,728,photo
CompanyJ_5557,With two minutes left in Game 2 Seth tried to jinx his big bro at the free throw line That s like 70 in a row Steph s response Bout to be 72 via 957thegame ,156,3349,23142,26491,video
CompanyJ_5558, I wouldn t say I had a front row seat I kinda was like out there playing Klay interviews never get old ,104,3779,29180,32959,video
CompanyJ_5559,Iggy compares Draymond s defense to prime Melo s offense Melo was a fast fat dude with hops And can shoot People need to stop disrespecting Melo And Draymond is the Melo of defense via ThompsonScribe ,200,1581,9155,10736,photo
CompanyJ_5560,After D Wade bodied Varejao he looked at MJ and said That s how you do it via HoHighlights ,91,7895,33451,41346,video
CompanyJ_5561,Last year UCF QB McKenzie Milton was only a few minutes away from having his leg amputated after a horrible injury Now he s already planning his return to football ,164,171,1294,1465,photo
CompanyJ_5562,Warriors from courtside via upclosehoops IG ,44,520,5157,5677,video
CompanyJ_5563,Another one for Penny 5 star Precious Achiuwa is heading to Memphis per PaulBiancardi ,86,493,3034,3527,photo
CompanyJ_5564,Manu Boris Splitter and Patty made a Spurs version of the Banana Boat They call themselves the WienerBoatBoys via theborisdiaw ,127,1952,13121,15073,photo
CompanyJ_5565,Dirk s eating GOOD Big man says he s gained 15 pounds since retiring I have not worked out once I ve had ice cream almost every day via BenandSkin ,147,6875,63303,70178,photo
CompanyJ_5566,Iggy s defense has come up huge over the years h t pickuphoop ,62,1541,7063,8604,video
CompanyJ_5567,Tyreke Evans has been dismissed and disqualified from the NBA for violating the anti drug policy ,97,2948,11555,14503,photo
CompanyJ_5568,It s a different Eastern Conference without LeBron ,51,642,3965,4607,photo
CompanyJ_5569,Lakers will not hire a President of Basketball Operations Rob Pelinka will continue as GM reporting directly to ownership per RamonaShelburne ,142,245,1366,1611,photo
CompanyJ_5570, ,1,1016,8246,9262,photo
CompanyJ_5571,Draymond wholeheartedly believes he s the best defender ever per ThompsonScribe ,80,530,5040,5570,photo
CompanyJ_5572,Tiger misses the cut by one stroke at the 2019 PGA Championship ,64,127,1078,1205,photo
CompanyJ_5573,DJ Diesel getting the crowd ready in Milwaukee via NBAonTNT ,60,1686,8350,10036,video
CompanyJ_5574,Beard Giannis PG Your finalists for KiaMVP ,43,1179,7192,8371,photo
CompanyJ_5575,Giannis isn t messing around early in Game 2 ,45,591,4272,4863,video
CompanyJ_5576,Giannis downhill Unstoppable ,29,1073,7261,8334,video
CompanyJ_5577,Bucks refusing to cool off ,27,135,1450,1585,photo
CompanyJ_5578,Drake trying to get the Raptors back into this ,47,7180,39369,46549,photo
CompanyJ_5579, LA s calling Milwaukee trying to send Kawhi back to SoCal ,59,660,5057,5717,video
CompanyJ_5580,Bucks defeat the Raptors by 22 to take a 2 0 series lead They are 10 1 in the playoffs Giannis 30 PTS 17 REB 5 AST ,115,1749,8709,10458,photo
CompanyJ_5581,Kareem amp Giannis Elite company ,33,561,4199,4760,photo
CompanyJ_5582,Chuck gave Malcolm Brogdon 45 000 to build a well for his charity that helps bring clean water to Africa via NBAonTNT ,118,9356,49819,59175,video
CompanyJ_5583,EJ got emotional after he returned home to Milwaukee and the city declared May 17th as Ernie Johnson Jr Day via NBAonTNT ,121,5807,37515,43322,video
CompanyJ_5584,21 years ago today Jordan was announced Most Valuable Player of the 1997 98 season Fifth time winning MVP tying Bill Russell for second all time Played all 82 games for third consecutive season averaging 28 7 PPG Went on to sixth Finals MVP before retiring again ,263,2134,12160,14294,photo
CompanyJ_5585,Kawhi got jokes Via YahooCASports ,34,1890,14502,16392,video
CompanyJ_5586,Europe s top 5 league winners are all back to back champions ,61,351,1789,2140,photo
CompanyJ_5587,He really jumped over him to complete the catch via AFL ,56,429,3424,3853,video
CompanyJ_5588,Bayern Juventus The Patriots The Warriors Dynasties via brfootball ,67,351,2262,2613,photo
CompanyJ_5589,Klay Thompson is that you via maxisnicee ,41,4713,30431,35144,video
CompanyJ_5590,Runs in the family via DwyaneWade ,34,3665,24627,28292,photo
CompanyJ_5591,League Cup Premier League FA Cup Manchester City is the first English men s team to win the domestic treble via brfootball ,123,515,2202,2717,photo
CompanyJ_5592,THE REACH BACK via hamilton21official IG ,41,3060,22051,25111,video
CompanyJ_5593, Hey baby Chuck was just trying to answer some questions and then Shaq came through via Bucks ,94,836,7105,7941,video
CompanyJ_5594,BRYCE RIPPED THAT via MLB ,26,1099,8390,9489,video
CompanyJ_5595,Kid out hustled everybody via Beachsidebrady ,45,315,2941,3256,video
CompanyJ_5596,WOW ,4,563,4579,5142,video
CompanyJ_5597,He turned the lights out with the head kick via ufc ,52,1164,5865,7029,video
CompanyJ_5598,Bodexpress tried to win Preakness without a jockey ,51,692,5815,6507,photo
CompanyJ_5599,First WCF game in Portland since 2000 Rose City about to be live for Game 3 ,76,276,2549,2825,photo
CompanyJ_5600,Meyers Leonard has been a PROBLEM in Game 3 via NBA ,52,398,3998,4396,video
CompanyJ_5601,Seth took Steph s lunch money then cashed out via NBALatam ,59,1018,6859,7877,video
CompanyJ_5602,Clint Bowyer was throwing hands after Ryan Newman caused a collision via NASCARONFOX ,85,1283,5139,6422,video
CompanyJ_5603,Jordan Bell missed a wide open dunk via shaqtin ,48,321,2363,2684,video
CompanyJ_5604,FIRST ROUND KO FOR DEONTAY WILDER ,34,2587,10189,12776,photo
CompanyJ_5605,Wilder put him to SLEEP in the first round via CBSSports ,57,42218,105358,147576,video
CompanyJ_5606,Deontay snatched this man s soul via YungLost_Rebel ,52,2077,9375,11452,video
CompanyJ_5607,Steph drops 36 and the Warriors take a 3 0 lead ,48,1559,7057,8616,photo
CompanyJ_5608,Vintage Dray ,13,1562,8830,10392,photo
CompanyJ_5609,Dray made sure the Warriors stayed confident during 2nd half run to win Game 3 mic d up ,88,2372,13014,15386,video
CompanyJ_5610,That moment when you catch a body Cold ,39,2714,20306,23020,link
CompanyJ_5611, If we re gonna beat em I m gonna have to be rolling Dame on Game 3 struggles ,78,286,2521,2807,video
CompanyJ_5612,Draymond credits the Warriors video coordinator for inspiring him to be a leader in the WCF ,92,790,6003,6793,video
CompanyJ_5613,Damian Lillard has separated ribs and is playing through his injury per ShamsCharania ,86,2156,13642,15798,photo
CompanyJ_5614,Despite Damian Lillard appearing to injure his ribs on this play in Game 2 Portland s star has been playing through his injury Dame played 40 min in Game 3 ,156,569,3748,4317,video
CompanyJ_5615,Officer was handing out BUCKETS and let him know about it NSFW via stayreal302 IG ,82,25715,112721,138436,video
CompanyJ_5616, Dortmund will always feel like home Christian Pulisic says goodbye to BVB ,75,106,2122,2228,photo
CompanyJ_5617,Draymond has been dissecting the Blazers 12 PTS 10 REB 5 AST 3 BLK 16 PTS 10 REB 7 AST 5 BLK 20 PTS 13 REB 12 AST 4 STL Engine ,127,1750,12398,14148,photo
CompanyJ_5618,Kevin Garnett turns 43 today Nobody wanted it more Champ MVP DPOY 15x All Star 12x All Defensive Gold medalist 7th most games 20th most points 10th most rebounds T most seasons ever 21 Broke barriers as HS draftee Highest paid in NBA history ,242,6476,33026,39502,photo
CompanyJ_5619,5 0 on the season for Messi Ridiculous via brfootball ,54,413,2873,3286,photo
CompanyJ_5620,Iguodala flipped the bird soon as he saw the camera ,52,594,7427,8021,video
CompanyJ_5621, I got to a point where I was doing more crying than playing I m sure it was disgusting to watch because I felt disgusting playing that way Dray s locking in on the game not officials ,184,3812,27703,31515,video
CompanyJ_5622,Dirk s work ethic KG s competitiveness Harden s franchise ownership Giannis has taken his leadership to the next level And the league is taking notice He was playing for the Bucks and now he is the Bucks ,204,385,3201,3586,photo
CompanyJ_5623,Messi is La Liga top scorer for the SIXTH time via brfootball ,62,664,4572,5236,photo
CompanyJ_5624,10 years ago today Kobe 40 and Melo 39 combined for 79 points in Game 1 of the WCF Mamba later called Melo the player that I enjoyed guarding the most He was the most difficult because of his size and his speed ,211,4598,22421,27019,photo
CompanyJ_5625, Let s get our money s worth Deontay Chill not yet Gimme five rounds please Wilder 10 seconds later via boymeetsworld IG ,121,2502,15038,17540,video
CompanyJ_5626,Brooks Koepka No time for PDA ,30,1047,8619,9666,video
CompanyJ_5627,True teammate via chase3 _ chaiboiidiego IG ,44,2201,15702,17903,video
CompanyJ_5628,Blazers are down 3 0 but this dance team would sweep everybody via HoHighlights ,80,1448,7427,8875,video
CompanyJ_5629,22 years ago today the Spurs won the lottery David Robinson missed 76 games Spurs finished 20 62 Worst record in franchise history 21 6 chance at No 1 pick Took Duncan became a dynasty Never missed the playoffs again ,217,2812,11319,14131,photo
CompanyJ_5630,Dray got fed up and made a change ,34,336,3006,3342,photo
CompanyJ_5631,Lucas Bjerregaard Hole in one WOW PGAChamp ,43,419,2933,3352,video
CompanyJ_5632,First season in Serie A first MVP Ronaldo is enjoying life in Italy ,68,437,3817,4254,photo
CompanyJ_5633, I don t think you ve really seen it before in the NBA Brook Lopez dishes on Giannis jaw dropping plays as Bucks take 2 0 lead From B R x WellsFargo ,149,59,518,577,video
CompanyJ_5634,Back to back in dominant fashion Brooks Koepka is your winner at the 2019 PGA Championship PGAChamp ,100,218,1580,1798,photo
CompanyJ_5635,Mbappé is ready for a bigger role wherever it may be via brfootball ,68,394,3538,3932,photo
CompanyJ_5636,Marc Gasol came to play ,24,361,3468,3829,video
CompanyJ_5637,Kawhi pushing through the pain playing with a noticeable limp ,62,425,3482,3907,video
CompanyJ_5638,Raps bench wanted to know how many steps Giannis took ,54,809,5341,6150,video
CompanyJ_5639,Lowry leaving it all out there in Toronto ,42,116,1183,1299,video
CompanyJ_5640,Kawhi caused a two man pileup ,30,2808,13596,16404,video
CompanyJ_5641,Kawhi palms basketballs like it s nothing ,42,1412,12104,13516,video
CompanyJ_5642,Who was Marc passing to ,24,153,1105,1258,video
CompanyJ_5643,Lowry tried to draw two charges he got none ,44,257,2030,2287,video
CompanyJ_5644,Oh no Giannis ,14,488,3213,3701,video
CompanyJ_5645,Drake has some words for Giannis ,33,1285,7489,8774,video
CompanyJ_5646,OT IN THE NORTH ,16,858,4814,5672,photo
CompanyJ_5647,Drake still talking trash to Giannis ,37,385,2834,3219,video
CompanyJ_5648,DOUBLE OT IN THE NORTH ,23,1159,10006,11165,link
CompanyJ_5649,OH MY KAWHI ,12,429,2587,3016,photo
CompanyJ_5650,KAWHI CLEARED FOR TAKEOFF ,26,1012,4788,5800,video
CompanyJ_5651,Siakam block Kawhi bucket Clutch ,33,525,2989,3514,video
CompanyJ_5652,Kawhi comes up clutch and gets the Raptors their first win of the series ,73,988,6992,7980,photo
CompanyJ_5653, This is playoff basketball Everyone s hurting 52 MIN 36 PTS 9 REBS 5 ASTS 2 STLS Kawhi did it all on one good leg ,115,1380,8225,9605,video
CompanyJ_5654,Only took Kawhi one postseason to set this franchise record ,60,3924,28989,32913,photo
CompanyJ_5655,This was the best series finale GameOfThrones ,46,11693,54761,66454,video
CompanyJ_5656,The reverse curse worked via gucci1017 ,39,1146,10665,11811,photo
CompanyJ_5657, I stand tall and I ve developed to be who I am When Ethan wrote to sterling7 about being racially abused at school Sterling wanted to help via brfootball ,155,117,646,763,video
CompanyJ_5658,Oh ,3,691,5644,6335,photo
CompanyJ_5659,8th grader Arch Manning nephew of Peyton amp Eli threw 3 TDs in his varsity debut scrimmage via fox8nola ,105,1206,8342,9548,video
CompanyJ_5660, ,1,434,2913,3347,photo
CompanyJ_5661,Neymar partied with Rihanna via neymarjr ,41,318,3405,3723,photo
CompanyJ_5662,6 9 400 lbs Size 18 shoes XXXXL shirt Minnesota RT Daniel Faalele is the biggest dude in college football ,106,1150,7935,9085,photo
CompanyJ_5663,25 years ago today Scottie Pippen bodied Patrick Ewing then stepped over him That was probably the easiest dunk I ever did via NBATV ,133,6164,27746,33910,video
CompanyJ_5664,Dray trying to set a good example ,34,744,7272,8016,photo
CompanyJ_5665,Dropped a kid then scored BACKWARDS between his legs via NJCAATV ,65,326,2938,3264,video
CompanyJ_5666,OH MY via Feed_My_Fam brhoops ,30,2283,12094,14377,video
CompanyJ_5667,Nobody was more hyped for Man City s FA Cup win this weekend than their kit man NSFW via bernardocarvalhosilva IG ,114,324,2419,2743,video
CompanyJ_5668,Giannis after Game 3 12 PTS 8 TO What I have done in my life so far put my brothers in private schools taking care of family in Nigeria and Greece Disappointed in a game I d be disappointed in myself if I was disappointed via malika_andrews ,241,3530,21175,24705,photo
CompanyJ_5669,Five star forward Trendon Watford has committed to LSU via brhoops ,67,867,4427,5294,photo
CompanyJ_5670,Giannis when guarded by Kawhi in Game 3 41 possessions 4 PTS 2 12 FG 0 3 3PT 1 AST 2 TO The Klaw clamped him via nbastats ,122,1916,9970,11886,photo
CompanyJ_5671,Antoine Griezmann is introduced to Atletico Madrid s secret fight club The Champions Ep 4 ,90,226,898,1124,video
CompanyJ_5672,Too easy for Steph via NBA ,27,646,5308,5954,video
CompanyJ_5673,MEYERS LEONARD CANNOT MISS 22 points and counting ,50,462,4301,4763,photo
CompanyJ_5674,,0,2475,17546,20021,photo
CompanyJ_5675,DAME HAD HIM DANCING via nba ,29,6336,30083,36419,video
CompanyJ_5676,Kap in the house for Dubs Blazers Game 4 ,41,585,4574,5159,photo
CompanyJ_5677,The duel we all expected Steph vs Meyers ,41,304,3341,3645,photo
CompanyJ_5678,It s happening ,15,531,3281,3812,photo
CompanyJ_5679,MEYERS HAMMER ,14,235,2011,2246,photo
CompanyJ_5680,FORGOT ABOUT DRAY ,18,434,2561,2995,photo
CompanyJ_5681,Steph and the Warriors sweep the Blazers ,41,13515,44831,58346,photo
CompanyJ_5682,Blazers come up empty in the series ,36,6320,25260,31580,video
CompanyJ_5683,Steph knocks his brother out the playoffs ,42,18537,54775,73312,video
CompanyJ_5684,Warriors join the 56 57 Celtics as the only teams in NBA history to make 5 straight finals ,91,2681,9960,12641,photo
CompanyJ_5685,All love in the Curry family via NBCSWarriors ,46,2072,13325,15397,video
CompanyJ_5686,Steph and Dray making history ,30,1230,7193,8423,photo
CompanyJ_5687,Steph Curry s Western Conference Finals 36 5 PPG 7 3 AST 8 3 REB 47 1 FG 42 5 3PT 4 0 MVP form ,95,3834,21801,25635,photo
CompanyJ_5688,Damian Lillard Blazers are expected to agree to a four year 191M supermax extension this offseason per ChrisBHaynes ,116,4311,28333,32644,photo
CompanyJ_5689,Officer is automatic via LAPDHQ trickshotcop IG ,48,581,4677,5258,video
CompanyJ_5690,Christian Pulisic arrives at Chelsea ,37,848,5881,6729,photo
CompanyJ_5691,Steph surpasses some of the all time greats ,44,2107,10194,12301,photo
CompanyJ_5692,YOUNG BALLER via minimika142019 IG ,35,607,3684,4291,video
CompanyJ_5693,Metta World Peace felt really inspired by Chad Ochocinco when he changed his name Quiet Storm The Ron Artest Story drops on SHOsports on 5 31 ,142,129,751,880,video
CompanyJ_5694,Draymond was dead serious ,26,3261,23127,26388,video
CompanyJ_5695,This is really what it s like trying to stay with Steph via maxisnicee ,71,20584,91700,112284,video
CompanyJ_5696,Ndamukong Suh and the Bucs are finalizing a one year deal per AdamSchefter ,75,500,3068,3568,photo
CompanyJ_5697,Did they get it right ,22,682,7393,8075,photo
CompanyJ_5698,Projected No 2 pick igotgame_12 could use some help with his golf game New Take It There with TaylorRooks drops Wednesday ,122,119,1105,1224,video
CompanyJ_5699,Behind the scenes before the Pelicans won the Zion lottery StateFarm Next episode of GameOfZones drops Thursday at 5 p m ET ,124,421,2389,2810,video
CompanyJ_5700,Pulisic paving the way via brfootball ,38,665,5790,6455,photo
CompanyJ_5701,For the first time since 1985 the All Rookie First Team are the top 5 picks What a class Olajuwon Bowie Jordan Perkins Barkley ,127,926,5350,6276,photo
CompanyJ_5702,Aaron Rodgers went from explaining his GameOfThrones cameo to flaming the ending via WISN_Watson ,97,1580,7178,8758,link
CompanyJ_5703,Giannis will not be denied in Game 4 ,37,545,3707,4252,video
CompanyJ_5704,Giannis airballed for the 2nd time this series and the Toronto crowd loved it ,78,546,4550,5096,video
CompanyJ_5705,Clippers have emerged as an equally dangerous threat to the Knicks to sign KD away from Warriors per TheSteinLine ,114,1123,5481,6604,photo
CompanyJ_5706,Giannis should ve gotten out of Kawhi s way ,44,1996,10086,12082,video
CompanyJ_5707,Drake stays clowning Giannis at the free throw line ,52,3431,19336,22767,video
CompanyJ_5708,Nobody Drake at Raptors games ,30,3994,26031,30025,video
CompanyJ_5709,Raptors Republic created a sticker for local restaruants to display to keep Kawhi this summer The catch If Leonard re signs he eats free for life ,146,1015,4840,5855,photo
CompanyJ_5710,The Bucks couldn t hang at Jurassic Park in Game 4 Raptors tie up series at 2 2 ,80,1205,8001,9206,photo
CompanyJ_5711,Kawhi got em Game 5 on Thursday ,32,447,3241,3688,photo
CompanyJ_5712,This shaqtin Best of the Worst compilation is COMEDY via shaqtin ,65,628,4052,4680,video
CompanyJ_5713,They really tricked everyone into thinking they had broken the Premier League trophy via ManCity ,97,1402,6790,8192,video
CompanyJ_5714,Gianna Bryant is a bucket in the making via Ballislife ,55,2863,16861,19724,video
CompanyJ_5715,Bucks Raptors living up to the hype Greek Freak 22 8 PTS 16 0 REB 3 0 BLK The Klaw 29 3 PTS 8 3 REB 2 3 STL ,108,552,4418,4970,photo
CompanyJ_5716,On this day in 2003 LeBron signed a historic 90M Nike deal at 18 years old Reebok handed him 10M check to not talk to other brands Said no Chose Nike s legacy and signed for biggest initial deal ever Built an empire worth 1B Later got a lifetime contract ,255,6132,27261,33393,photo
CompanyJ_5717, You tell me not to do it I m going to do it This 20 year old s rare disease doesn t stop him from being a baller ,114,2805,14727,17532,video
CompanyJ_5718,KD or Bron at the 3 igotgame_12 names his dream starting lineup Ja Morant on calling himself Point God modeling his game after Russ and playing with Zion in AAU on a new Take It There with TaylorRooks ,201,423,2268,2691,video
CompanyJ_5719,Kawhi took flight in Game 4 ,28,414,3260,3674,video
CompanyJ_5720, You can t guard me bro Washington commit Jaden McDaniels is ready to dominate for his hometown squad via brhoops ,114,177,1352,1529,video
CompanyJ_5721,That s a new way to score via Travis_Chinn ,43,428,3444,3872,video
CompanyJ_5722,5 star recruit Jerrion Ealy is a Kyler Murray caliber two sport athlete He committed to Ole Miss as an RB but he could go early in the MLB draft next month In five years he s going to be in the All Star Game ,208,114,739,853,photo
CompanyJ_5723,Ten years ago today LeBron called game in the ECF via NBAUK ,60,1339,7129,8468,video
CompanyJ_5724,Postwoman pulled up and started hyping him via paul_stys11 ,59,9148,46040,55188,video
CompanyJ_5725,JuJu plays an amazing Rose in this Titanic recreation via Switz ,64,679,5894,6573,video
CompanyJ_5726,Juwan Howard is expected to sign with Michigan as their new HC per JonRothstein ,80,1357,6718,8075,photo
CompanyJ_5727,Season starts Friday ,21,277,1693,1970,photo
CompanyJ_5728,Memphis No 1 recruiting class is ready to go No 1 James Wiseman No 14 Precious Achiuwa No 37 Boogie Ellis No 48 DJ Jeffries No 56 Lester Quinones No 98 Malcolm Dandridge No 108 Damion Baugh via brhoops ,202,1128,5337,6465,photo
CompanyJ_5729,This season s top defenders ,28,807,4901,5708,photo
CompanyJ_5730,16 years later Kyle Korver never forgot the Nets traded him for a copy machine via Creighton ,93,5059,28302,33361,video
CompanyJ_5731,Had to humble him real quick via branchnout50 Instagram ,56,6004,38145,44149,video
CompanyJ_5732,Josh Hart on what he ll do if the Lakers draft a guard Bust his ass via The No Chill Podcast ,93,3202,23903,27105,photo
CompanyJ_5733,NYC basketball is different via NuevaYorkNico ,46,12377,43716,56093,video
CompanyJ_5734,Drake causing issues in the series ,35,943,7313,8256,photo
CompanyJ_5735,No playoff basketball tonight ,30,5712,28466,34178,photo
CompanyJ_5736,How Drake s been acting at Raptors games via maxisnicee ,56,5361,28332,33693,video
CompanyJ_5737,WR Floyd Allen signed with the Texans this week Unreal story Torn ACL ruined D I chance Bethany College NAIA Two JUCOs Ran from his job to practice daily Quit football Homeless slept in car Walked on at Ole Miss Earned scholarship NFL contract ,244,10135,51671,61806,photo
CompanyJ_5738,Quavo iced out Trae with a custom piece Young Rookie of the Year in my book via QuavoStuntin ,93,7201,44438,51639,video
CompanyJ_5739,He FLEW into that poster via kyle wesley_ IG ,45,349,3209,3558,video
CompanyJ_5740,Stacks cement blocks on the plate to practice working the corners Next level via SimoneEli_TV ,94,3403,27681,31084,video
CompanyJ_5741,Young kid from the Dominican Republic doesn t even have sneakers to ball but he s got moves via DomDeportes ,108,41093,152819,193912,video
CompanyJ_5742,Free kicks Chips Tight angles All of Messi s 36 league goals this season via LaLigaEN ,86,3016,12132,15148,video
CompanyJ_5743,Katie Lou Samuelson was one of UConn s best ever players but she never led the Huskies to a championship With that chip on her shoulder she s ready for WNBA glory ,163,83,464,547,photo
CompanyJ_5744,Federer is magic via TennisLegende ,35,2937,15121,18058,video
CompanyJ_5745,Harden and CP3 had a verbal exchange in the locker room regarding ball distribution during Game 6 vs Dubs per ShamsCharania ,124,1523,7132,8655,photo
CompanyJ_5746,Former summer leaguer and D II guard Jordan Stevens showed up to a private run where nobody knew who he was Cooked everyone in sight via ballislife ,148,6579,36267,42846,video
CompanyJ_5747,President Obama surprised the kids and then joined them for practice via NatsAcademy ,85,4931,25204,30135,video
CompanyJ_5748,The league s best of 2018 19 ,29,4414,24352,28766,photo
CompanyJ_5749,Kemba set himself up to get PAID By making All NBA Third Team he officially qualifies for the supermax this summer 221M five years ,131,2441,13150,15591,photo
CompanyJ_5750,After earning All NBA for the 2nd consecutive year Giannis is eligible to sign the largest contract extension in history starting in 2021 2022 h t BobbyMarks42 42 6M 46M 49 5M 52 9M 56 3M Total Earnings 247 3M ,210,2313,10562,12875,photo
CompanyJ_5751,KAT didn t make any All NBA teams which means he misses out on a 32M incentive in his contract ,95,1709,10348,12057,photo
CompanyJ_5752,KD is unlikely to play at the beginning of the NBA Finals Boogie is expected to play at some point in the series ,113,755,4968,5723,photo
CompanyJ_5753,Klay looked livid when he found out he didn t make All NBA via anthonyVslater ,78,7401,44041,51442,video
CompanyJ_5754,This dog is the nutmeg king via brfootball ,43,431,2986,3417,video
CompanyJ_5755,Brad Stevens channels his inner Pop to fix the Celtics chemistry issues GameOfZones StateFarm ,94,1047,3872,4919,video
CompanyJ_5756,Klay will miss out on a supermax extension worth 221M over 5 years ,67,823,5969,6792,video
CompanyJ_5757,LeBron joins rare company ,26,1426,8483,9909,photo
CompanyJ_5758,Kyle Lowry is rewriting his playoff history in the ECF says HowardBeck ,71,167,1250,1417,video
CompanyJ_5759,Steve Butcher uses his love for basketball to create these unreal tattoo designs ,81,553,3063,3616,video
CompanyJ_5760, ,1,3852,25226,29078,photo
CompanyJ_5761,LeBron has already begun the recruiting process He s had contact with Kawhi Leonard Jimmy Butler per WindhorstESPN ,115,1489,8177,9666,photo
CompanyJ_5762,Chuck thinks Mike Budenholzer should worry more about the Raptors instead of Drake via NBAonTNT ,96,281,1736,2017,video
CompanyJ_5763,Goodness Giannis ,17,1178,6978,8156,video
CompanyJ_5764,Aaron Rodgers couldn t hang ,28,9971,59306,69277,video
CompanyJ_5765,Daughter of Milwaukee Bucks owner rocking a Pusha T shirt ,58,1708,11366,13074,photo
CompanyJ_5766,Giannis all on the Raptors Oh man ,34,571,4181,4752,video
CompanyJ_5767,Drake really no different from regular fans via TSN_Sports ,59,1318,8288,9606,video
CompanyJ_5768,Kawhi s step back had Drake wildin ,35,2170,13574,15744,video
CompanyJ_5769,THIS GAME ,10,607,5671,6278,video
CompanyJ_5770,This Fun Guy was playing no games Kawhi Leonard leads Raptors to 3 2 series lead 35 PTS 7 REB 9 AST 2 STL ,106,4783,23025,27808,photo
CompanyJ_5771,Raptors did what no other team could tonight ,45,1115,6426,7541,photo
CompanyJ_5772,Kawhi postgame s remain undefeated KristenLedlow ,49,2396,13260,15656,video
CompanyJ_5773,Drake wants all the smoke ,26,4031,22035,26066,photo
CompanyJ_5774,You can feel Drake s passion for Toronto via LindsayDunnTV ,59,9602,46263,55865,video
CompanyJ_5775,Inside the NBA crew baby face filter ,37,495,3146,3641,video
CompanyJ_5776,Matt Stafford had to show Aaron Rodgers how to chug a beer properly via kbstafford89 IG ,88,2902,25177,28079,video
CompanyJ_5777,Kawhi is built for this ,24,2420,18870,21290,photo
CompanyJ_5778,This Kawhi fake ,16,4911,34135,39046,video
CompanyJ_5779,Drake s preaching for his childhood team like it s God s plan ,62,1333,9213,10546,video
CompanyJ_5780,Giannis is ready to go all out in Game 6 ,41,756,5939,6695,photo
CompanyJ_5781,Adam Pacman Jones announces his retirement from the NFL ,56,1871,12684,14555,photo
CompanyJ_5782,Messi still thinks about Barcelona s semifinal loss in the UCL via brfootball ,78,672,4923,5595,photo
CompanyJ_5783,LeBron liked this ,18,4508,34641,39149,photo
CompanyJ_5784,Nutmeg Drops defender Just another day for Cristiano Via juventusfcen ,70,760,4846,5606,video
CompanyJ_5785,Defense was getting dropped the moment he put grip on his sneakers NSFW via jaziel3_ marquezof Instagram ,105,4514,22607,27121,video
CompanyJ_5786, ,1,273,2622,2895,photo
CompanyJ_5787,3 years ago today Thunder annihilated the Warriors in Game 4 to take a commanding 3 1 lead in the WCF It would be KD s last W in a OKC uni ,139,3903,18328,22231,video
CompanyJ_5788,Tiger was all about the fan who bet 85K on The Masters He s a dumbass for the grand slam part though NSFW via AdamWeinraub h t br_betting ,138,262,2469,2731,video
CompanyJ_5789,Zlatan is unstoppable in FIFA too via Liavinco h t brfootball ,62,399,2871,3270,video
CompanyJ_5790,The 2019 WNBA season kicks off tonight ,39,971,5292,6263,photo
CompanyJ_5791,A LeBron less playoffs has been a curse for ratings and a blessing for opportunities Finals bound Draymond doesn t know what to make of it It s just weird More as a basketball fan than anything ,194,309,2025,2334,photo
CompanyJ_5792,Homie had to clean his whole locker after the Bucks lost Game 5 It was all covered in Raps in 6ix post its via aidans_11 dylremington10 Instagram ,146,254,2246,2500,video
CompanyJ_5793, Relationship with Blac Chyna Beef with 50 Cent 21 0 13 KOs New Money Devin Haney is trying to follow Floyd Mayweather s blueprint I was built on social media I didn t have a gold medal I did this on my own Floyd showed us it was possible ,239,207,1171,1378,photo
CompanyJ_5794,That touch via levisdudiis IG ,30,1352,10085,11437,video
CompanyJ_5795,Dray is still in awe the Warriors won t be seeing the King in the Finals ,73,1047,8908,9955,photo
CompanyJ_5796, TheRock has been laying the smackdown since birth ,51,1068,6808,7876,photo
CompanyJ_5797,He said and still caught the ball via jamopuppy IG ,51,711,6137,6848,video
CompanyJ_5798,Kawhi s comeback from his 2018 quad injury has been HISTORIC 2019 Playoffs so far 31 4 PPG 8 4 RPG 50 FG 41 3PT The Raptors are 1 win away from the NBA Finals ,159,2895,20574,23469,photo
CompanyJ_5799,ONE WEEK TIL CHAMPIONS LEAGUE FINAL via brfootball ,51,867,6013,6880,photo
CompanyJ_5800,LeBron became the all time playoff scoring leader two years ago today It took him 212 games to pass Jordan 5 987 who hit the mark in 33 fewer outings ,150,1613,9019,10632,video
CompanyJ_5801,19 year old Portugal stud Joao Felix met Ronaldo for the first time and his description is on point via brfootball ,115,624,5242,5866,photo
CompanyJ_5802,Dwyane got an All NBA vote in his last season but it wasn t from Gab Union The whole Wade house voted for Klay via DwyaneWade ,126,5010,30652,35662,video
CompanyJ_5803,Drop The Hammer No 3 2020 recruit Jalen Johnson flew via brhoops ,65,307,2900,3207,video
CompanyJ_5804,Four pro bowlers took control in the All New BMWUSA 3series competing for the best football player in the driver s seat From B R amp BMWUSA TheUltimateDrive ad ,160,33,159,192,video
CompanyJ_5805,A couple days ago Roldany Velez was hooping in Santiago without shoes Now he s in gear calling out defenders to cross them up for game via kordellv Instagram ,158,12277,49077,61354,video
CompanyJ_5806, I m trying to tell the bum to get up and fight 54 years ago today Muhammad Ali had one of the most iconic moments in sports ,125,2983,13844,16827,photo
CompanyJ_5807,Drake just wants more life for his Raptors but his sideline antics got the Bucks in their feelings ,99,508,3444,3952,video
CompanyJ_5808,Some within the Nets organization think a Kyrie Irving D Angelo Russell backcourt could not only coexist but thrive per NYPost_Lewis ,133,937,7246,8183,photo
CompanyJ_5809,This kid tied his loose tooth to the soccer ball and kicked it out of his mouth Next level via SeanKilby1 ,106,3445,19563,23008,video
CompanyJ_5810,Two legends end their time at Bayern on a high note brfootball ,63,600,2925,3525,photo
CompanyJ_5811, When prayers go up you know what that means blessings come down This guy has endless sayings and buckets for Ramadan via soufs_videos ,135,11964,39771,51735,video
CompanyJ_5812,Messi has now scored in a record six Copa del Rey finals via brfootball ,72,192,1625,1817,photo
CompanyJ_5813,Brook Lopez credits Raptors supporting cast after Game 5 loss says Bucks need the Utmost Energy to extend series From B R x WellsFargo ,135,52,547,599,video
CompanyJ_5814,Russ had the upper hand on Tiger via LynnGilmartin ,51,1219,7806,9025,video
CompanyJ_5815,The perfect bet for tonight via br_betting ,43,608,5907,6515,photo
CompanyJ_5816,Bucks not ready for this series to end ,39,436,3825,4261,video
CompanyJ_5817,Filthy ,7,666,6211,6877,video
CompanyJ_5818,Above the Rim inspired ,23,1189,7237,8426,photo
CompanyJ_5819,There s no defending this ,26,423,4342,4765,video
CompanyJ_5820,Lowry went B2B ,15,161,1604,1765,video
CompanyJ_5821,KAWHI PURE HEART ,17,1474,9876,11350,video
CompanyJ_5822,ISO VANVLEET ,13,790,5016,5806,video
CompanyJ_5823,KAWHI ME A RIVER ,17,23488,79977,103465,video
CompanyJ_5824,THIS GAME ,10,381,2206,2587,photo
CompanyJ_5825,This Giannis block ,19,1797,10393,12190,video
CompanyJ_5826,A new King in the East Raptors are going to the NBA Finals ,59,15255,56996,72251,photo
CompanyJ_5827,Kawhi was too much for Giannis this series ,43,9580,28480,38060,video
CompanyJ_5828,Drake got the last laugh ,25,3835,23248,27083,video
CompanyJ_5829,History for The 6ix ,20,1214,6254,7468,photo
CompanyJ_5830,Chills Congrats to the Raptors on their 1st NBA Finals appearance ,66,4141,21458,25599,video
CompanyJ_5831,Another Drake Nurse massage Kawhi not ,38,2605,15525,18130,video
CompanyJ_5832,Nothing but respect Kawhi and Giannis put on a show ,52,2934,22415,25349,video
CompanyJ_5833, MVP chants for the Fun Guy ,28,1851,13277,15128,video
CompanyJ_5834,Giannis walked out of his presser ,34,3725,22800,26525,video
CompanyJ_5835,More Life ,10,1281,10079,11360,photo
CompanyJ_5836,VanVleet can t even get on the road NSFW via FredVanVleet ,58,2165,18107,20272,video
CompanyJ_5837,Kawhi took Giannis soul in Game 6 ,34,9369,39837,49206,video
CompanyJ_5838,Bucks had a 15 point lead with two minutes left in the 3rd Kawhi almost single handedly erased it ,98,1005,7001,8006,video
CompanyJ_5839,They found a Kawhi lookalike via a k a ak IG ,45,2704,21855,24559,video
CompanyJ_5840,Fred VanVleet has been unconscious since having a son Monday BEFORE playoffs 4 PPG 25 6 FG 19 5 3PT SINCE 16 PPG 68 FG 82 4 3PT ,128,3412,27630,31042,photo
CompanyJ_5841,One year ago today Real Madrid capped the Champions League 3 peat via brfootball ,81,456,3128,3584,photo
CompanyJ_5842,Friends until the engines roar TeamJuJu and TheAdamsEra compete for bragging rights riding in the All New BMWUSA 3series From B R amp BMWUSARacing TheUltimateDrive ad ,167,115,842,957,video
CompanyJ_5843,It s still all love in Milwaukee for Giannis via Bucks ,55,3521,27011,30532,video
CompanyJ_5844,OUT COLD All he saw was via dazn_usa ,37,3617,13262,16879,video
CompanyJ_5845,Kid showed up in a Curry jersey and Kanter wasn t having it via AJ_McCord ,74,1194,11840,13034,video
CompanyJ_5846,Kawhi is on a playoff run for the ages 31 2 PPG 8 8 RPG 50 7 FG Raptors first NBA Finals Iconic buzzer beater Helped stop Giannis 7 games with 35 points Playoff points leader by 100 Playoff leader in PTS FGM MIN STL ,216,4908,20963,25871,photo
CompanyJ_5847,Kobe missed Then Shaq missed 17 years ago today Robert Horry saved the Lakers via NBATV ,88,14199,73983,88182,video
CompanyJ_5848,Toronto went WILD last night via gauravkapoor08 rishikoparde IG masonrewbury IG ,80,454,2920,3374,video
CompanyJ_5849,Not your average jumper via ArkBulldogs ,40,3395,17169,20564,video
CompanyJ_5850,Top scorer in Europe AGAIN Messi wins a sixth European Golden Shoe with 36 league goals via brfootball ,103,748,5869,6617,photo
CompanyJ_5851,OOOOHH BLOCKED BY JAMES JR via brhoops ,39,4155,27750,31905,video
CompanyJ_5852,Nneka and Chiney Ogwumike take the court tonight as teammates for the Sparks joining some other famous sibling duos to team up in the pros Serena amp Venus Williams Shaquill amp Shaquem Griffin Markieff amp Marcus Morris Devin amp Jason McCourty Steph amp Seth Curry ,267,763,4456,5219,photo
CompanyJ_5853,14 year old Gabe Cupps gave LeBron a run for his money in a 3 point shootout via brhoops ,89,679,6946,7625,video
CompanyJ_5854, KevinHart4real dominating against his daughter on a 7 foot rim ,64,3972,29531,33503,video
CompanyJ_5855,Kobe brought his daughter Gianna and her AAU squad to meet the Las Vegas Aces after their win over the Sparks via LVAces ,121,411,4815,5226,photo
CompanyJ_5856,This week ,10,869,4416,5285,photo
CompanyJ_5857,This kid in Bangkok helps raise money for school by juggling a toilet paper roll in the street via chrismdwyer ,111,1583,10404,11987,video
CompanyJ_5858,This Raptors jersey collection via rsr7n IG ,44,993,7920,8913,video
CompanyJ_5859,Soon ,5,4069,32014,36083,photo
CompanyJ_5860,A year ago today 20 year old Jayson Tatum threw down a poster on one of his childhood idols Still wild ,103,6663,32724,39387,video
CompanyJ_5861,Harry Kane could return for the UCL final after being out since April via brfootball ,85,206,2404,2610,photo
CompanyJ_5862,Kawhi couldn t care less about being called the best player in the league ,74,2311,16118,18429,video
CompanyJ_5863,On this day in 1996 Michael Jordan took down Shaq and Penny 45 PTS 16 23 FG in Game 4 72 win Bulls swept Orlando Mike wanted revenge after 1995 Magic wouldn t pay Shaq Diesel left for Lakers that summer ,203,1478,7221,8699,photo
CompanyJ_5864,Security tape caught stevenash running through the halls after Tottenham s semifinal comeback ,94,2975,20230,23205,video
CompanyJ_5865,Everything about this Kawhi impression is on point via maxisnicee ,66,3621,23738,27359,video
CompanyJ_5866,Drake makes a special appearance for the house s ultimate sing off The Champions Season 2 Finale ,97,170,886,1056,video
CompanyJ_5867,In 2014 a young Kawhi 22 won Finals MVP and kept the Heat from their third straight championship Five years later he s trying to stop another three peat via NBATV ,163,10531,52466,62997,video
CompanyJ_5868,Get this man courtside for Game 1 NSFW via LouieOxRankin ,57,1331,7107,8438,video
CompanyJ_5869,Lil Nas X Bruins Old Town Road gets the Boston fans hype for Game 1 of the StanleyCup Final via LilNasX ,104,5539,36952,42491,video
CompanyJ_5870,Bron and TT living their best lives NSFW via djmeel ,52,4222,26150,30372,video
CompanyJ_5871,Uncle is blind and he sunk the free throw in one try The family s reaction via YoungBullBlade ,94,11013,63791,74804,video
CompanyJ_5872,Sequence of events for Torey Krug 1 Loses helmet 2 Annihilates Blues Robert Thomas 3 Wins Game 1 of the StanleyCup Final via NHLBruins ,135,859,4858,5717,video
CompanyJ_5873,Neymar has been stripped of Brazil national team captaincy and replaced by Dani Alves ahead of the Copa America ,112,958,7347,8305,photo
CompanyJ_5874,Three years ago today Klay put on an all time shooting clinic in Game 6 to save the Warriors in the WCF ,104,2349,13363,15712,video
CompanyJ_5875,Rob Pelinka allegedly made up a story about Kobe having dinner with Heath Ledger after seeing The Dark Knight to study how he locks in for a role per Baxter Ledger died six months before the movie came out ,206,3974,15225,19199,photo
CompanyJ_5876,Embiid was in full relaxation mode pregame Happy NationalHamburgerDay ,70,310,3589,3899,video
CompanyJ_5877,RJ Hampton is bypassing college to hoop professionally overseas brhoops ,72,1282,9525,10807,photo
CompanyJ_5878,Last time Kawhi saw Golden State in the playoffs 2017 26 PTS in 24 MIN Spurs had 23 point lead Landed on Zaza s foot and hurt ankle Warriors came back and swept ,161,1096,5561,6657,video
CompanyJ_5879,Best AAU team ever Ron Artest Elton Brand and Lamar Odom went 69 1 in the summer of 1996 QuietStorm The Ron Artest Story drops Friday May 31 on SHOSports ,154,4179,14022,18201,video
CompanyJ_5880,Turn is filthy smooth via brfootball ,37,6669,32955,39624,video
CompanyJ_5881,Roberto Aguayo went from one of the best college kickers ever to getting cut by four NFL teams Can he overcome the infamous yips I m not gonna feel sorry for myself I m not gonna tell myself I can t do it anymore I m coming back ,229,143,1171,1314,photo
CompanyJ_5882, The Logo Jerry West turns 81 today Basketball icon Champ Finals MVP 14x All Star every year 9 Finals Highest series PPG 46 3 Scoring title Assist title 12x All NBA 5x All Defense 2x Exec of the Year 8 rings as exec Helped build Warriors dynasty ,246,1918,11972,13890,photo
CompanyJ_5883,Bronny James just hit 1M followers in less than 24 hours The heir to the throne is ready to dominate via BRHoops ,113,3669,21065,24734,video
CompanyJ_5884,Bron s reaction when 21 year old Kawhi checks back into his first Finals is priceless ,86,18569,97877,116446,video
CompanyJ_5885, terrellowens vs deandrehopkins Yup Who will back up the talk with performance in the All New 3series TheUltimateDrive From B R amp BMWUSA BMWUSA ad ,149,139,623,762,video
CompanyJ_5886,Practicing his goal celebration on the treadmill via n_adarkwa700 ,66,725,5350,6075,video
CompanyJ_5887,The Celtics tried everything to fix their chemistry issues this season StateFarm Rewatch last week s GameOfZones No episode this week but the season finale drops Thurs June 6 ,175,142,819,961,video
CompanyJ_5888,Chelsea manager Maurizio Sarri stormed out of Chelsea training the day before the Europa League final via brfootball ,117,264,2441,2705,video
CompanyJ_5889,A year ago today Warriors punched a ticket to their 4th consecutive Finals Rockets had an 11 point lead at the end of the 1st half of Game 7 Dubs outscored them by 18 in the 3rd never looked back ,196,512,3211,3723,video
CompanyJ_5890,The technology in BMWUSA s All New 3series calls for TheUltimateDrive challenge Four pro bowlers 2 races 1 winner Check back tomorrow From B R amp BMWUSA ad ,157,25,106,131,video
CompanyJ_5891,They were coaching the kid on how to get the poster off It worked via eli cappalot ricobanga_ IG ,97,23751,84165,107916,video
CompanyJ_5892,50 Cent would be proud via NBCSGiants ,38,376,2877,3253,video
CompanyJ_5893,Cameraman will never forget this first pitch via FSKansasCity ,62,1342,5628,6970,video
CompanyJ_5894,One of the smoothest 360s ever via tcurrie22 Dunkademics ,57,3111,18262,21373,video
CompanyJ_5895,Absolutely filthy via c_noah0 IG ,33,1944,13834,15778,video
CompanyJ_5896,Mark Wahlberg found the perfect basketball coach for his 9 year old daughter via JimmyButler ,93,8800,64971,73771,video
CompanyJ_5897,You already know what day it is in the James household via KingJames ,69,17622,88971,106593,video
CompanyJ_5898,FINALS START TOMORROW ,22,2681,17131,19812,photo
CompanyJ_5899,When are they gonna change their plates via jessewitt13 jacktnathan ,68,168,1775,1943,photo
CompanyJ_5900,Obama gets it via brfootball ,29,504,4044,4548,photo
CompanyJ_5901,Shooters shoot Get buckets in the 6ix and by the Bay Play Shoot Your Shot now ,78,49,279,328,video
CompanyJ_5902,When Sadio Mane crossed up Neymar ,34,1962,11586,13548,video
CompanyJ_5903,Daryl Morey showing aggressive desire to improve Rockets roster would move CP3 in the right deal per wojespn ,109,1243,5905,7148,photo
CompanyJ_5904,Jordan Harold s unorthodox tactics got him a walk on spot at Mizzou Now they could get him an NFL tryout via WillKunkelFOX46 ,125,169,1018,1187,video
CompanyJ_5905,From Queensbridge to Infamy in Indiana to Finals Glory QuietStorm The Ron Artest Story drops on SHOsports this Friday at 10pm ET ,129,99,395,494,video
CompanyJ_5906, AMA with MettaWorldPeace dropping at 4pm ET tomorrow only in the BR App ,73,44,210,254,link
CompanyJ_5907,Demar still has love for the Raptors ,37,1413,12845,14258,photo
CompanyJ_5908, 500 BA 15 HR 54 RBI SS RP Bobby Witt Jr wins Gatorade National Baseball Player of the Year ,92,76,590,666,video
CompanyJ_5909,Neymar threw him to the ground over a nutmeg via globoesportecom ,65,772,5618,6390,video
CompanyJ_5910, The Raptors legitimately have a shot Experts make their picks for NBA Finals champion and MVP ,95,123,941,1064,photo
CompanyJ_5911,Kawhi s had an exciting year in Toronto Now I m here for 41 games you see how much support is really around the city ,117,705,5775,6480,video
CompanyJ_5912,The sound of that knee on impact via ufc ,41,1084,4498,5582,video
CompanyJ_5913,Randy Moss and Primetime want all the smoke in any 2v2 via DeionSanders ,72,4400,22527,26927,video
CompanyJ_5914,Just because Klay gotta face the Raptors doesn t mean he s skipping Drake on his playlist Via NBAonTNT ,103,2654,16134,18788,video
CompanyJ_5915,Mo Salah s Champions League final ended in injury and tears last season This Saturday he and Liverpool get a second chance You need to win it ,142,52,532,584,video
CompanyJ_5916,Steve Kerr said Bosh s Heat wouldn t 3 peat now he s returning the favor via TSN_Sports ,88,878,6265,7143,video
CompanyJ_5917,Olivier Giroud puts Chelsea ahead against his former club ,58,162,929,1091,video
CompanyJ_5918,All that for NOTHING via Cut4 ,30,541,3622,4163,video
CompanyJ_5919,Two goals One assist hazardeden10 in the Europa League final ,61,349,1819,2168,photo
CompanyJ_5920,NBA spoke with the Raptors about Drake s activity and presence on the sidelines in the ECF per ESPNMichele ,107,755,3995,4750,video
CompanyJ_5921,Chelsea wins the Europa League via brfootball ,46,358,1569,1927,photo
CompanyJ_5922,Could this be Eden Hazard s last goal for Chelsea via brfootball ,65,160,1281,1441,video
CompanyJ_5923, I think this is goodbye Eden Hazard after Chelsea s Europa League win via brfootball ,86,1580,6859,8439,video
CompanyJ_5924, You don t mistakenly become great This Dray speech Powerful ,61,37061,104569,141630,video
CompanyJ_5925,Hazard s goodbye ,17,708,4061,4769,photo
CompanyJ_5926,JuJu was TOO confident at TheUltimateDrive From B R amp BMWUSA BMWUSA 3Series ad ,81,114,658,772,video
CompanyJ_5927,Is this Steph s best shot at winning his 1st Finals MVP 35 PTS in 4 straight games tied for longest streak by Warriors player KD s status unclear after calf strain out for Game 1 Postseason stats 27 3 PPG 6 3 RPG 5 6 APG 45 2 FG 39 0 3PT ,238,224,1662,1886,photo
CompanyJ_5928,DSJ thought we paired him with a world renowned trainer but he was Just OK att ,79,531,3573,4104,video
CompanyJ_5929,Kawhi Leonard the best player on the planet Alexa detects no lies via danibaki IG ,82,1442,8924,10366,video
CompanyJ_5930,Pops got dunked on so he tried to get revenge Didn t work via jeezy_hbg IG ,75,1196,8176,9372,video
CompanyJ_5931,Steph is more focused on winning a 4th title over a Finals MVP via NBATV ,73,1251,8909,10160,video
CompanyJ_5932,24 hours until the NBAFinals ,29,755,4029,4784,photo
CompanyJ_5933,Bronny James and Zaire Wade will both play at Sierra Canyon High School next season per Tarek_Fattal WOW x brhoops ,115,17964,72288,90252,photo
CompanyJ_5934,They got next via brhoops ,26,1496,10691,12187,photo
CompanyJ_5935,Slam Dunk Contest might need Kevin Porter Jr via corey__porter ,63,545,3907,4452,video
CompanyJ_5936,Masai Ujiri runs the Raptors with no fear It s paying off In the past year Fired Coach of the Year Dwane Casey Hired Nick Nurse no NBA HC experience Traded franchise player DeRozan Gambled on Kawhi Dealt for Marc Gasol at deadline ,231,692,5394,6086,photo
CompanyJ_5937,Kawhi was asked if he wants to be as famous as Bron and Steph Man is all about hoop ,84,14584,80620,95204,video
CompanyJ_5938, High school hoops THIS IS FOR YOU Bronny x Zaire about to be must watch via BRHoops ,85,1205,7477,8682,video
CompanyJ_5939,GUNNARSSON CALLED GAME 1st STANLEYCUP Final win in franchise history via StLouisBlues ,86,384,2985,3369,video
CompanyJ_5940,NBA FINALS TODAY ,17,4249,22057,26306,photo
CompanyJ_5941,Raptors fans started lining up outside Jurassic Park before 7 a m over 14 hours before 9 p m tip off via KamilKaramali ,119,1414,8305,9719,video
CompanyJ_5942,Three years ago today KD played his final game with OKC and lost Game 7 to the Warriors He joined Golden State that summer ,123,2722,15446,18168,video
CompanyJ_5943,The takeover x via brhoops ,27,3343,23406,26749,photo
CompanyJ_5944,Kawhi s journey back to the Finals has come full circle since the 2017 Zaza Pachulia injury ,92,3187,12112,15299,video
CompanyJ_5945,10 years ago today the Magic eliminated the Cavs in the ECF The closest we got to LeBron vs Kobe in the Finals ,111,2876,18787,21663,photo
CompanyJ_5946,Can you beat the high score Play Shoot Your Shot now ,53,28,148,176,video
CompanyJ_5947,Metta never held back QuietStorm The Ron Artest Story drops Friday May 31 on SHOsports ,87,244,1281,1525,photo
CompanyJ_5948, Tune in for Metta s AMA today at 4 p m ET in the B R App ,58,52,313,365,link
CompanyJ_5949,LeBron will be a Finals spectator for the first time in nearly a decade ,72,1951,13320,15271,video
CompanyJ_5950,DeMarcus Cousins quad will be active to play for Game 1 per ShamsCharania ,74,2712,11728,14440,photo
CompanyJ_5951,When Neres did him dirty to get past via brfootball ,52,138,1254,1392,video
CompanyJ_5952,The Warriors team chemistry might be the most impressive part about their recent run of success Andre Iguodala is the driving force behind keeping the Dubs focused on a 3 peat ,176,166,1293,1459,photo
CompanyJ_5953,Jaylen Brown THE DISRESPECT via SimeonV2 ,41,3774,20206,23980,video
CompanyJ_5954,Juwan Howard cried tears of joy in his return to Michigan via MichiganOnBTN ,76,3655,18819,22474,video
CompanyJ_5955,Will the Warriors continue their dynasty or will the Raptors be crowned as new champions Here s what you missed ControlTheGame WellsFargo ,138,59,471,530,video
CompanyJ_5956,D Wade chugging wine on the water in Greece Retirement life via DwyaneWade ,75,6334,46474,52808,video
CompanyJ_5957,RJ Hampton signed his New Zealand contract a month ago but couldn t tell anyone So he let them guess ,101,372,3235,3607,video
CompanyJ_5958,Winning isn t always fun in Golden State it s expected ,55,334,2442,2776,photo
CompanyJ_5959,LeBron could still win a trophy this season with Liverpool UCLFinal ,68,486,3469,3955,video
CompanyJ_5960, mettaworldpeace is in the building for his AMA Head to the B R App NOW to ask questions ,89,21,181,202,photo
CompanyJ_5961,Raptors in their first NBAFinals Tottenham in their first UCLFinal History made via brfootball ,95,405,2674,3079,photo
CompanyJ_5962,Warriors will secure their place among the GOAT franchises if they win the NBA Finals says howardbeck ,102,397,4105,4502,video
CompanyJ_5963,The road to a championship continues tonight in Toronto ,56,365,1924,2289,video
CompanyJ_5964,Oakland is ready for another championship run ,46,551,2511,3062,video
CompanyJ_5965,Raptors fans want all the smoke via Skinny_Post ,48,3330,17697,21027,video
CompanyJ_5966,D Wade NBA Legend 2K Legend Edition via mikescriburner h t BRGaming ,68,1540,6445,7985,photo
CompanyJ_5967, ,1,1235,7569,8804,photo
CompanyJ_5968,Warriors Raptors players have got a fit off all playoffs but who s had the most refined looks 1800tequila ,106,86,552,638,video
CompanyJ_5969,The Warriors are 4 wins away from reaching a 3 Peat Will they make it to the top ,81,917,5385,6302,video
CompanyJ_5970,The Finals MVP will be won by ______________ ,45,492,2621,3113,video
CompanyJ_5971,Drake is repping the OG Curry for Game 1 via NBATV ,51,2981,18446,21427,video
CompanyJ_5972,LET S GO ,9,478,2163,2641,photo
CompanyJ_5973, Paul Pierce sucks via BenGolliver ,35,2497,15018,17515,video
CompanyJ_5974,Drake and E40 not in the studio anymore Via E40 ,48,1603,9746,11349,photo
CompanyJ_5975,Steph becomes the only player to hit 100 3 s in the Finals via NBA ,67,1206,8873,10079,video
CompanyJ_5976,Drake really thinks he s one of the players ,44,2363,21598,23961,photo
CompanyJ_5977,Curry McGrady Bosh A timeline of Toronto legends all lined up Via Raptors ,74,5212,32166,37378,video
CompanyJ_5978,Talking about and they music with bring up somebody Pusha T ,60,3587,21424,25011,photo
CompanyJ_5979,Spicy P takes over in Game 1 as the Raptors secure their first Finals win in franchise history 32 PTS 8 REB 5 AST 2 BLK ,120,5852,27112,32964,photo
CompanyJ_5980,Drake called Dray trash immediately after the Raptors won Game 1 ,65,23918,93659,117577,video
CompanyJ_5981, Warriors are better without KD KD ,35,4471,18620,23091,video
CompanyJ_5982, Warriors even making the Finals after KD leaves ,49,2654,12170,14824,photo
CompanyJ_5983,Warriors couldn t get past Spicy P in Game 1 Gatorade ,54,380,2503,2883,video
CompanyJ_5984,Toronto is getting ROWDY after the Raptors Game 1 win via TSN_Sports ,69,499,3715,4214,video
CompanyJ_5985,Somebody take Drake s phone ,28,9320,46683,56003,photo
CompanyJ_5986,Dray ain t sweating Drizzy ,27,2085,13369,15454,video
CompanyJ_5987,Pascal is doing it all for his father ,38,1865,14401,16266,photo
CompanyJ_5988,Klay I ll skip Hotline Bling Drake ,35,5808,36877,42685,photo
CompanyJ_5989,Drizzy started an eCommerce movement ,37,397,2393,2790,photo
CompanyJ_5990,Kevin Durant expected to return from injury at midway point of Finals per ChrisBHaynes ,87,967,5769,6736,photo
CompanyJ_5991,One of the most viral moments in Finals history JR Smith s Game 1 blunder is still wild a year later ,101,2170,11013,13183,video
CompanyJ_5992,Spicy P was too hot for Golden State in Game 1 ,47,7830,41998,49828,video
CompanyJ_5993,Waking up the next day Raptors up 1 0 in the Finals Kawhi ,58,899,9642,10541,video
CompanyJ_5994,TOMORROW Tottenham s first ever appearance Liverpool s second straight Only the second all Premier League final in history UCLFinal on brlive ,142,233,1561,1794,photo
CompanyJ_5995,This UFC training is NEXT LEVEL via HenryCejudo ,48,796,5523,6319,video
CompanyJ_5996,On this day in 2007 LeBron took matters into his own hands in Game 5 of ECF Scored the last 25 points for Cleveland 48 points and the go ahead basket in double OT Would lead Cavs to first Finals appearance at 22 years old ,222,3982,16353,20335,video
CompanyJ_5997, How am I supposed to go out there and hit a ball that s coming at me 100 mph when I can t see straight After battling a severe concussion for a year Clint Frazier is on his way to becoming a Yankees star ,205,116,978,1094,photo
CompanyJ_5998, How do you think peace is accomplished Through war Kobe knew how to motivate Metta World Peace QuietStorm The Ron Artest Story drops TONIGHT on SHOSports ,155,532,1986,2518,video
CompanyJ_5999,Tottenham was five minutes away from being knocked out of the Champions League group stage Now they re in the final via brfootball ,131,120,772,892,video
CompanyJ_6000, When you give you always get back remember that Back with more Ramadan blessings this guy can t miss via soufs_videos ,119,11537,39367,50904,video
CompanyJ_6001,The Champions League via brfootball ,36,3523,10959,14482,video
CompanyJ_6002,Dray knows it s Warriors vs everyone ,37,2129,14067,16196,photo
CompanyJ_6003,He really just did a 2497 lb leg press via HenchAsPossible ,59,1569,9385,10954,video
CompanyJ_6004,DSJ stays locked in by connecting with close friends and eating well on the road ATT ,85,62,450,512,video
CompanyJ_6005,Tottenham vs Liverpool Who s winning it all pepsi ,50,35,359,394,video
CompanyJ_6006,The look on their faces says it all via coach_thomp ,52,3719,22056,25775,video
CompanyJ_6007,Wilder v Fury II Deontay Wilder confirms rematch against Tyson Fury on Twitter ,79,5137,19694,24831,photo
CompanyJ_6008,Dray really walking around Toronto in a Drake hoodie via Money23Green ,70,4060,29853,33913,video
CompanyJ_6009,She s here Liz Cambage makes her Aces debut in Phoenix against the Mercury tonight ,83,182,1551,1733,photo
CompanyJ_6010,The HoHighlights Show is LIVE with special guest spidadmitchell ,64,14,73,87,link
CompanyJ_6011, spidadmitchell reflects on how special it was going up against D Wade via HoHighlights ,88,251,2212,2463,video
CompanyJ_6012,The exotic animals are back on the HoHighlights Show Watch LIVE ,64,11,90,101,link
CompanyJ_6013,WALK IT OFF MATT CARPENTER via FSMidwest ,41,258,2220,2478,video
CompanyJ_6014,IT S UCL FINAL DAY via brfootball ,34,452,2344,2796,photo
CompanyJ_6015,The first time Artest went into the stands it was all love He won the city title and celebrated with Queens QuietStorm The Ron Artest Story is streaming on SHOSports ,166,172,989,1161,video
CompanyJ_6016,Real Madrid and the UCL are finally breaking up after 3 years via brfootball ,77,527,2805,3332,photo
CompanyJ_6017,Giannis too big for the rides at Disney via nickrazzano19 ,58,6179,45015,51194,video
CompanyJ_6018,Salah Firmino and Dele Alli have been bringing the heat DareToCreate From B R Football x adidassoccer ,102,48,321,369,video
CompanyJ_6019, Run run run 4 year old casually walked up to 1st after the hit via edwin_614 Instagram ,88,1366,16070,17436,video
CompanyJ_6020,Zidane scored one of the most epic ChampionsLeague final goals ever Can TheTraeYoung recreate it at Atleti s training ground ,125,69,550,619,video
CompanyJ_6021,Two unreal semifinal comebacks from Liverpool and Tottenham got them to the final ,82,254,1604,1858,video
CompanyJ_6022,The principal s stare down after scoring on him via ethanmoncada19 IG ,70,6000,43258,49258,video
CompanyJ_6023,50 000 Liverpool fans PACKED OUT Madrid via Noemidemiguel ,58,3692,14420,18112,link
CompanyJ_6024,Meanwhile not at the UCLFinal via brfootball ,45,132,943,1075,photo
CompanyJ_6025,Kawhi when asked how he responds to trash talking It really doesn t happen too much via NBAonTNT ,97,1425,11422,12847,video
CompanyJ_6026,HE S BACK Harry Kane starts in the UCLFinal for Tottenham his first appearance since April ,91,276,1855,2131,photo
CompanyJ_6027,Big game big fans All eyes on the UCL final via brfootball ,59,499,2866,3365,photo
CompanyJ_6028, I can t get beat by an old man DeAndreHopkins was chirping terrellowens the whole time at TheUltimateDrive with BMWUSA From B R amp BMWUSA 3Series ad ,151,124,539,663,video
CompanyJ_6029,LET S GO UCLFinal ,18,259,1145,1404,photo
CompanyJ_6030,REDEMPTION via brfootball ,26,434,2011,2445,photo
CompanyJ_6031,Salah puts Liverpool ahead in under two minutes a year after leaving the Champions League final injured ,104,262,1588,1850,video
CompanyJ_6032, MoSalah ,9,214,1594,1808,photo
CompanyJ_6033,GOT EM ,7,166,1256,1422,video
CompanyJ_6034, Keep counting OKAY KAWHI via Raptors ,38,1854,14907,16761,video
CompanyJ_6035,HUGE stop from Virgil van Dijk Watch the final minutes on brlive ,65,84,582,666,video
CompanyJ_6036,LeBron called it ,17,357,2541,2898,link
CompanyJ_6037,Winner vs Barcelona then a dagger in the final ,47,338,1952,2290,video
CompanyJ_6038,LIVERPOOL WINS THE 2019 CHAMPIONS LEAGUE ,41,1598,4850,6448,photo
CompanyJ_6039,Sixth time via brfootball ,26,725,3637,4362,photo
CompanyJ_6040,What a difference a year makes ,31,509,2759,3268,photo
CompanyJ_6041,What a feeling ,15,514,2736,3250,video
CompanyJ_6042,The Liverpool team s Klopp lift via brlive ,43,267,1831,2098,video
CompanyJ_6043,Déjà vu via brfootball ,23,6931,23167,30098,photo
CompanyJ_6044,Fans back in Liverpool went WILD when Origi scored the dagger via LivEchoLFC ,77,2043,7129,9172,video
CompanyJ_6045,Trent Alexander Arnold Only 20 years old Debuted for Liverpool less than 3 years ago Assisted winning goal vs Barca Champions League winner ,140,666,4465,5131,photo
CompanyJ_6046, MrsElleLeonard got bucket buckets via MeyersLeonard11 ,55,539,3471,4010,video
CompanyJ_6047, KingJames loved it ,20,486,3963,4449,photo
CompanyJ_6048,He just kept running via _ovo kenny_ IG ,40,1370,9075,10445,video
CompanyJ_6049,Jordan Henderson with his dad after Liverpool s win via CharlieMooseGib ,72,1032,6434,7466,video
CompanyJ_6050,D Wade couldn t get in Gab s head NSFW via DwyaneWade ,54,7009,45864,52873,video
CompanyJ_6051, PatrickMahomes MVP beer chugger via RaulNBCBoston ,51,1476,12845,14321,video
CompanyJ_6052,Andy Ruiz upsets Anthony Joshua to win the heavyweight championship in the 7th round via DAZN_USA ,98,11995,35872,47867,video
CompanyJ_6053,,0,27299,90898,118197,photo
CompanyJ_6054,Underdogs ,10,3591,23676,27267,photo
CompanyJ_6055,Andy Ruiz Jr did the impossible last night 1200 underdog First Mexican heavyweight champ ever One of the biggest heavyweight upsets since Tyson Douglas ,152,5602,24196,29798,photo
CompanyJ_6056,They found a Mo Salah lookalike at the bar during the Champions League final via brfootball ,92,2117,12441,14558,video
CompanyJ_6057,Kawhi says guys like Kobe Shaq and Mike didn t always show emotion either Cold blooded ,87,3495,23917,27412,video
CompanyJ_6058,Klopp sang Salt n Pepa after Liverpool s win Let s talk about six baby via ViasportFotball ,91,567,3687,4254,video
CompanyJ_6059,Andy Ruiz Jr to his mom after becoming the heavyweight champ Our lives are gonna change We don t have to struggle no more via ryansongalia ,139,11851,57092,68943,video
CompanyJ_6060,Teacher scored on this kid and bounced it OFF THE DOME ryan__jackson__ IG ,74,984,9620,10604,video
CompanyJ_6061,Tottenham via brfootball ,25,676,3604,4280,video
CompanyJ_6062,Daddy daughter ballet for Russ and Sienna via DangeRussWilson ,62,1050,6968,8018,video
CompanyJ_6063,Klay s respect for Steph is so real ,36,6478,43258,49736,video
CompanyJ_6064,Gini Wijnaldum dropped his phone off Liverpool s trophy parade bus ,67,830,7238,8068,video
CompanyJ_6065,Teams that go up 2 0 in the Finals are 29 4 in the series 87 8 Toronto could put the pressure on tonight via AP_Sports ,119,450,4450,4900,photo
CompanyJ_6066,D Wade surprised everyone at Marjory Stoneman Douglas High School graduation today Wade also met with students last year after the tragic shooting via drsafeerbhatti ,166,1391,8736,10127,video
CompanyJ_6067,Sacrificed the whole net to put his friend on a poster Worth it via vgxjay IG ,78,6082,33232,39314,video
CompanyJ_6068,Kawhi grew up playing under pressure He s battle tested It s just basketball at this point ,91,759,6299,7058,video
CompanyJ_6069,500K fans showed up to Liverpool s UCL parade via danroan ,58,1136,7888,9024,video
CompanyJ_6070,UCLA s Rachel Garcia today PITCHING 10 innings 179 pitches 16 strikouts 0 runs BATTING Walk off HR in the 10th to send Bruins to College World Series via NCAAsoftball ,167,1051,6454,7505,video
CompanyJ_6071,Warriors gotta pull out all the stops to avoid going down 2 0 ,62,1307,7336,8643,photo
CompanyJ_6072,Obama in the 6ix for Game 2 via Raptors ,40,9867,61101,70968,video
CompanyJ_6073, This is my house I have to defend it Drake pulled up to Game 2 in a Home Alone hoodie via SpeedyMorman ,104,701,5103,5804,link
CompanyJ_6074,Prez Commish ,13,1430,15007,16437,photo
CompanyJ_6075, ,1,2646,20371,23017,photo
CompanyJ_6076,Toronto gave Obama a standing O and an MVP chant via TaylorRooks ,65,6786,41668,48454,video
CompanyJ_6077,Shake N Bake via Raptors ,25,293,2303,2596,video
CompanyJ_6078,That s just ridiculous Steph via warriors ,42,2095,11053,13148,video
CompanyJ_6079,Klay Thompson has left hamstring tightness and will not return to Game 2 ,73,317,1942,2259,photo
CompanyJ_6080,Steph and the Warriors tie the series 1 1 ,42,1936,9410,11346,photo
CompanyJ_6081,Andre Iguodala Game 2 dagger Series tied at 1 1 ,48,3345,13932,17277,video
CompanyJ_6082,Game 1 Game 2 vs ,17,11702,49926,61628,photo
CompanyJ_6083,KD salutes his teammates after their comeback win via TSN_Sports ,65,1124,9113,10237,video
CompanyJ_6084,Bigger shot ,12,829,6448,7277,photo
CompanyJ_6085,This Tweet from BleacherReport has been withheld in response to a report from the copyright holder Learn more ,110,2920,13814,16734,link
CompanyJ_6086,Andre came up clutch again ,27,897,6926,7823,photo
CompanyJ_6087, ,1,673,3840,4513,photo
CompanyJ_6088,Kawhi with another priceless postgame answer ,45,4662,33063,37725,video
CompanyJ_6089,True Warrior ,13,1533,14154,15687,photo
CompanyJ_6090,ZLATAN BEING ZLATAN via MLS ,28,10275,39502,49777,video
CompanyJ_6091,27 years ago today via NBATV ,29,4884,25360,30244,video
CompanyJ_6092, ,1,6918,39437,46355,photo
CompanyJ_6093,Iggy s got Steph s back I m doing whatever it takes to protect his legacy via 957thegame ,89,446,3654,4100,video
CompanyJ_6094,The Keep Kemba in Charlotte campaign has begun via CodyZeller ,62,1347,10146,11493,photo
CompanyJ_6095, You were slinging crack or playing ball Young Ron Artest tried both He learned quickly where his future was QuietStorm The Ron Artest Story is streaming on SHOSports ,167,159,690,849,video
CompanyJ_6096,Livingston Iguodala Every angle of the Dubs dagger ,51,575,3818,4393,video
CompanyJ_6097,Zlatan s bicycle kick is even better in slow mo via LAGalaxy ,61,672,3861,4533,video
CompanyJ_6098,Three years ago we lost Muhammad Ali 56 5 record Olympic gold medalist First 3x heavyweight champ Worldwide activist More than an athlete The Greatest shook up the world ,170,6498,27206,33704,photo
CompanyJ_6099,The details on this full leg LeBron tattoo via ustinovatattoo IG ,65,9975,48417,58392,photo
CompanyJ_6100, DeMar_DeRozan reflects on his friendship with Nipsey Hussle and says the two had dinner 2 3 weeks before the LA rapper s tragic death Take It There with TaylorRooks finale drops Tuesday ,187,1334,5575,6909,video
CompanyJ_6101,Lamar Odom called Kobe the father figure that I never had ,58,3822,25480,29302,photo
CompanyJ_6102,This kid s date broke up with him before prom so he hit up JuJu per WPXI TeamJuJu came through ,95,3601,35362,38963,photo
CompanyJ_6103,Cooked him up off the full court press AND 1 via hugo baskett Instagram ,72,3002,17650,20652,video
CompanyJ_6104,Warriors ball movement stayed ridiculous in Game 2 22 AST 22 FGs in 2nd half 63 AST 72 FGs in Finals 87 5 via NBAStats ,119,339,2103,2442,video
CompanyJ_6105, SteveNash and luka7doncic hit 35 headers ,42,1027,8883,9910,video
CompanyJ_6106,Little man stared him down too via conner_brain IG ,51,2208,15544,17752,video
CompanyJ_6107,Made him do the splits on the way to the end zone via kennedy_kevin_dad59 IG ,77,778,7335,8113,video
CompanyJ_6108,That s a 20 lb medicine ball via infamous_wu13 ,47,16792,81572,98364,video
CompanyJ_6109, Bryant TO SHAQ 19 years ago today the Lakers dynasty reached their first Finals together with an iconic lob in Game 7 ,119,5413,26983,32396,video
CompanyJ_6110,Broke out the eastbay layup via brhoops ,40,1012,10706,11718,video
CompanyJ_6111,Salah changing the world via brfootball ,40,2147,11689,13836,photo
CompanyJ_6112,Still absurd Messi s free kick wins UCL Goal of the Tournament ,63,1801,12193,13994,video
CompanyJ_6113, I had to be the sacrificial lamb DeMar_DeRozan is still rooting for the Raptors in the Finals but explains why he was so hurt when the trade went down Season finale of Take It There with TaylorRooks ,200,2163,9622,11785,video
CompanyJ_6114,The levels of disrespect via _kennedychandler1 IG ,50,8017,36308,44325,video
CompanyJ_6115, Get your ass in shape and stop f king around ZachLaVine and his dad playing no games this offseason ,101,5116,33003,38119,video
CompanyJ_6116,Steph wishes he would ve handled things differently ,52,1225,9344,10569,video
CompanyJ_6117,Pelicans have begun listening to teams about potential Anthony Davis deals per ShamsCharania ,93,1324,7796,9120,photo
CompanyJ_6118,She hung the Kawhi poster with the classics in the Louvre via athinavandame IG ,79,2469,21022,23491,video
CompanyJ_6119,JuJu pulled up to prom and everyone chanted F k AB ,51,1851,14594,16445,video
CompanyJ_6120,Dodgers have been tearing up the NL 1st in runs 1st in batting average 1st in slugging Supercuts ,97,237,1052,1289,video
CompanyJ_6121,Flawless touch from the couch and his brother couldn t care less via matanos10 IG h t brfootball ,97,18386,85361,103747,video
CompanyJ_6122,More history for the Serena Williams is the first athlete to make Forbes Richest Self Made Women list ,102,3188,19211,22399,photo
CompanyJ_6123,Bigger than basketball Kobe and the Lakers Youth Foundation donated his Wizenard book to LeBron s IPROMISESchool ,113,1840,11803,13643,photo
CompanyJ_6124, Can we get a track DeMar_DeRozan says he has a secret mixtape and that Kendrick Drake both think it s nice Season finale of Take It There with TaylorRooks ,156,216,1435,1651,photo
CompanyJ_6125,WALK OFF FOR THE NATTY UCLA softball wins its 12th national title via Pac12Network ,83,2092,12643,14735,video
CompanyJ_6126,On this day in 1991 Jordan switched hands midair Game 2 would be the Bulls first win in the beginning of their championship run with MJ via NBATV ,146,3399,18813,22212,video
CompanyJ_6127,Neymar showed up to Brazil training in his own branded helicopter via sntvstory ,80,565,3357,3922,video
CompanyJ_6128,Iggy was the hero in Game 2 Who will step up in Game 3 tonight ,63,885,6444,7329,video
CompanyJ_6129,In Game 1 of 2008 Paul Pierce came back in the 3Q after being carried out in a wheelchair the rest is history ,110,1482,8313,9795,video
CompanyJ_6130,Dwyane Wade s memoir entitled 3 Dimensional detailing his roller coaster journey is set to release October 22 per AP ,117,356,2681,3037,photo
CompanyJ_6131,Wounds from Indiana were still raw for Jermaine O Neal when Metta and the Lakers won it all I was not happy for him QuietStorm The Ron Artest Story is streaming on SHOSports ,174,297,1238,1535,video
CompanyJ_6132,21 STRAIGHT MAKES Steph is locked in for Game 3 via NBA ,56,3315,17843,21158,video
CompanyJ_6133,PSG announce Gigi Buffon is leaving after one season with the club via brfootball ,82,116,888,1004,photo
CompanyJ_6134,D Rose not holding back ,24,6392,31103,37495,photo
CompanyJ_6135,Embiid is big talk until the tennis ball flies by via j o morrison IG ,70,597,6371,6968,video
CompanyJ_6136,A Rod knew without hesitation who he wanted to date since 1998 Via IntentionalTalk ,83,823,4122,4945,video
CompanyJ_6137, Youngest player to make USWNT debut since 2002 Youngest U S women s player to score in an Olympics Already 52 appearances Mallory Pugh s rise to USWNT stardom has been fast and furious and she s still only 21 ,210,105,742,847,photo
CompanyJ_6138,This tennis player s son ran on the court to give him a hug after seeing him cry in loss at the French Open Respect Via Eurosport_UK ,133,5636,41426,47062,video
CompanyJ_6139,Kyrie went home and reminisced with his childhood crossing guard ,65,5212,36168,41380,video
CompanyJ_6140,It s Kobe over everybody for DeMar_DeRozan Season finale of Take It There with TaylorRooks ,91,385,1849,2234,video
CompanyJ_6141,He really scored from a handstand via fagerlibrothers ,54,944,5992,6936,video
CompanyJ_6142,This parrot sings Mo Salah s song perfectly via Kelo the African Grey FB ,73,1042,4013,5055,video
CompanyJ_6143,Messi s son is the ultimate troll via brfootball ,49,829,6822,7651,photo
CompanyJ_6144,Vince Carter says this will be his last season in the NBA via The Jump ,71,7137,40392,47529,photo
CompanyJ_6145, It s over The league will miss Vinsanity after 2019 20 via NBATV ,66,7565,33916,41481,video
CompanyJ_6146,One last flight for No 15 ,26,1258,9082,10340,photo
CompanyJ_6147,RONALDO HAT TRICK via UnivisionSports ,38,1652,6241,7893,video
CompanyJ_6148,34 and not slowing down Cristiano ,34,1641,7870,9511,photo
CompanyJ_6149, The goal s always going to be the same Hang banners OBJ s ready for Cleveland via BenAxelrod ,94,894,6513,7407,video
CompanyJ_6150,Eden Hazard is set to join Real Madrid now that the club has agreed on a transfer fee with Chelsea per FabrizioRomano via brfootball ,133,2083,8662,10745,photo
CompanyJ_6151,Warriors officials want Klay to sit Game 3 hamstring but he has continued to lobby them on playing tonight per wojespn and ramonashelburne ,139,484,2882,3366,photo
CompanyJ_6152,This Raiders janitor went OFF via JohnathanAbram1 h t LefkoeShow ,65,2032,11720,13752,video
CompanyJ_6153, 1 MORE DAY GameOfZones Season 6 finale drops tomorrow ,55,74,641,715,photo
CompanyJ_6154,He took his principal s ankles via like_abbas99 IG ,51,1139,8014,9153,video
CompanyJ_6155,Warriors bumping Pusha s Story of Adidon pregame IT S ON via andrew__reed ,74,4723,19589,24312,video
CompanyJ_6156,Klay has been ruled out for Game 3 He played in 120 consecutive playoff games prior to tonight ,95,1226,6155,7381,photo
CompanyJ_6157,Kawhi couldn t be more locked in for Game 3 via TSN_Sports ,59,8391,46049,54440,video
CompanyJ_6158, ,1,1454,8141,9595,photo
CompanyJ_6159,Steph Unleashed 1st quarter 17 PTS 6 11 FG 6 REB 3 AST ,55,671,3526,4197,photo
CompanyJ_6160,Fun guy Mean dunk via Raptors ,30,1224,10343,11567,video
CompanyJ_6161,Carters in 4 ,13,933,6045,6978,photo
CompanyJ_6162,Steph in video game mode via warriors ,38,1227,6958,8185,video
CompanyJ_6163,Steph s on pace for 50 25 points 7 13 FG at half ,49,352,2598,2950,photo
CompanyJ_6164,Steph pulling every chance he gets via warriors ,48,269,2085,2354,video
CompanyJ_6165,Steph s got a new Finals career high with 40 points Still a full quarter left via warriors ,91,410,2641,3051,video
CompanyJ_6166,In case you forgot Danny Green is MADE for the Finals via Raptors ,66,1145,7929,9074,video
CompanyJ_6167,6ix years later Danny Green still money in the NBAFinals ,57,3664,21189,24853,photo
CompanyJ_6168,45 points still down by 17 ,27,3509,23036,26545,photo
CompanyJ_6169, Now you know what it feels like ,33,29253,95743,124996,photo
CompanyJ_6170,Kawhi leads the Raptors to a 2 1 series lead in the NBA Finals 30 PTS 7 REB 6 AST 2 BLK 2 STL ,94,3787,19734,23521,video
CompanyJ_6171,Steph drops a playoff career high 47 PTS and it s still not enough ,67,1445,7128,8573,photo
CompanyJ_6172,Finals Danny Green made a big splash in Game 3 ,47,1032,6605,7637,video
CompanyJ_6173,Kawhi and the Raptors were too much to handle ATT ,50,271,1828,2099,video
CompanyJ_6174,Canada has taken over Oracle via tsnjamesduthie ,48,1187,8473,9660,video
CompanyJ_6175,Shaq knew Danny Green was gonna bounce back via NBATV ,54,920,6767,7687,video
CompanyJ_6176,Crazy what can change in a year ,32,3788,25150,28938,photo
CompanyJ_6177,Dray ain t worried at all ,26,834,5377,6211,photo
CompanyJ_6178, Kawhi s Plan via HoHighlights OfficialMinks ,45,3509,10500,14009,video
CompanyJ_6179, The board man gets paid Kawhi confirms his old catch phrase and says it was about doing whatever it took to reach the league ,126,3246,24475,27721,video
CompanyJ_6180,Neymar is ruled out of the Copa America after suffering an ankle injury in a friendly ,86,177,1217,1394,photo
CompanyJ_6181,18 years ago today Iverson dropped 48 on the Lakers and stepped over T Lue Iconic ,82,2624,10601,13225,video
CompanyJ_6182,Windmill poster Stepover Sheesh via apaltzer1 marcelldrone IG ,62,601,3616,4217,video
CompanyJ_6183,Pulisic got it from his mom via cpulisic_10 ,44,1090,8549,9639,video
CompanyJ_6184,Warriors could ve used this Kerr last night Hit the Hotline Bling and everything via Shady00018 ,96,650,4407,5057,video
CompanyJ_6185,Kyle Lowry didn t appreciate what happened in Game 3 ,53,1277,8122,9399,video
CompanyJ_6186,Left pic is a drawing via jerrylester20 ,40,2931,23635,26566,photo
CompanyJ_6187,Nutmegged twice in a row via docteur_stres IG ,46,1210,6962,8172,video
CompanyJ_6188,DeAndre Hopkins turns 27 today and he s got a case for best receiver in the league Last two years No 1 fantasy T No 1 in receiving TD No 2 in receiving yards No 2 in catches No 3 in YPG 5 drops on 333 targets ,209,3554,16794,20348,photo
CompanyJ_6189,Dirk in the batting cage is comedy via dallasmavs ,50,452,3271,3723,video
CompanyJ_6190, ,1,1856,10832,12688,photo
CompanyJ_6191, BINGE ALL OF SEASON 6 GameOfZones finale drops at 5 p m ET Catch up NOW ,73,106,503,609,link
CompanyJ_6192,Bringing that MambaMentality to Seattle dkmetcalf14 has a signed Kobe jersey in his locker ,91,193,1662,1855,video
CompanyJ_6193,Steph learned last night it takes more than one via brfootball ,63,3702,18856,22558,photo
CompanyJ_6194,Kawhi watched Jordan highlights for 4 5 hours at a time and snuck his phone into team dinners to have them on per a San Diego State manager He called them Mike highs via JaysonJenks ,182,2991,25090,28081,photo
CompanyJ_6195,Grandpa got crossed up via travistingey_ IG ,44,7501,35301,42802,video
CompanyJ_6196,Too easy for the Klaw Kawhi from all angles ,44,284,2454,2738,video
CompanyJ_6197,Breaking KD calf is OUT for Game 4 ,35,3368,15483,18851,photo
CompanyJ_6198,Fitzmagic pulling out the Mahomes no look dime via MiamiDolphins ,65,998,7542,8540,video
CompanyJ_6199,Nets are trading Allen Crabbe No 17 pick and a protected first in 2020 to the Hawks for Taurean Prince and a 2021 second rounder per wojespn ,141,1448,6875,8323,photo
CompanyJ_6200,Kyrie is serious about the Nets this summer per wojespn ,56,2181,17120,19301,photo
CompanyJ_6201,Patrick Beverley tries to lure KD to the Clippers A new king is crowned in the East GameOfZones finale StateFarm ,113,1654,5672,7326,video
CompanyJ_6202,Part owner of Warriors Mark Stevens has been banned from NBA games for a year and fined 500K for shoving Lowry ,111,5385,26069,31454,link
CompanyJ_6203,Carson Wentz agrees to a 4 year extension with the Eagles per caplannfl ,72,619,2996,3615,photo
CompanyJ_6204,Vince gonna be dunking when he s 60 via NBATV ,46,13310,76800,90110,video
CompanyJ_6205,Six years ago today Tony Parker silenced South Beach with an incredible bank shot over Bron to steal Game 1 via NBA ,116,2393,13726,16119,video
CompanyJ_6206,Former Cy Young winner Dallas Keuchel agrees to a deal to sign with the Atlanta Braves per JeffPassan ,102,1497,6057,7554,photo
CompanyJ_6207, via giseleofficial ,20,5475,27985,33460,video
CompanyJ_6208,Brady chugging beers now via mackdemp26 ,40,991,7287,8278,video
CompanyJ_6209,Seven years ago today LeBron s legacy was on the line Chasing first title Down 3 2 in Boston One year after Mavs Finals He delivered 45 PTS 19 26 FG 15 REB 5 AST ,162,13116,47628,60744,video
CompanyJ_6210,Rafael Nadal knocks out Roger Federer to advance to the French Open final in straight sets ,91,850,4232,5082,photo
CompanyJ_6211, The Answer turns 44 today 11x All Star 2001 MVP 4x scoring champion 2nd all time playoff scoring avg Introduced today s NBA style ,131,7649,34143,41792,photo
CompanyJ_6212,WORLD CUP READY FIFAWWC via brfootball ,39,142,824,966,photo
CompanyJ_6213,The largest margin of victory in the Finals happened on this day when the Bulls beat the Jazz by 42 MJ in the 1998 postgame interview We in a situation where we kill or be killed ,179,996,6970,7966,photo
CompanyJ_6214,From Olympics bound to training in isolation during cancer treatments to unstoppable rising star in MMA Tatiana Suarez shares her incredible story back to the top with a chance to stay undefeated this weekend ,209,22,151,173,photo
CompanyJ_6215,It really went in via jakekaradizian IG ,40,4668,30089,34757,video
CompanyJ_6216,He s 8 years old and draining 3 s like Steph via coachhark3 IG ,63,280,2358,2638,video
CompanyJ_6217,LeBron wants war with everybody in the James house via mrs_savannahrj Instagram ,80,915,9215,10130,video
CompanyJ_6218,Bron s offseason on NBATwitter is the vibe everybody needs to be on ,68,738,4653,5391,video
CompanyJ_6219,LeBron passed up better basketball situations for LA and it looks like Kawhi and KD could do the same this summer Could the NBA be shifting away from the rings culture ,168,162,1160,1322,photo
CompanyJ_6220,Cole Anthony hops unreal via The_ColeAnthony brhoops ,53,2051,12253,14304,video
CompanyJ_6221,Breaking Eden Hazard has officially joined Real Madrid on a deal until 2024 via brfootball ,91,3407,13673,17080,video
CompanyJ_6222,Eden Hazard leaves Chelsea after 7 years 110 goals 92 assists and 6 trophies via brfootball ,92,573,3231,3804,photo
CompanyJ_6223,Real Madrid s newest signing is lethal hazardeden10 via brfootball ,67,383,2010,2393,video
CompanyJ_6224,Dipo gonna be back in no time via VicOladipo ,45,804,6255,7059,video
CompanyJ_6225,Even lego Steph hitting shots from the tunnel via warriors h t goldyeller ,74,305,2316,2621,video
CompanyJ_6226,Slo mo Pat Flip via Royals ,27,441,4789,5230,video
CompanyJ_6227,A loud welcome back for Klay as he steps onto the court for warmups via loislane28 ,83,217,1792,2009,video
CompanyJ_6228,Cleveland this is for you ,26,1043,10319,11362,photo
CompanyJ_6229,KL Y via warriors ,18,339,2885,3224,video
CompanyJ_6230,Kawhi pull up game MEAN via Raptors ,36,1456,9734,11190,video
CompanyJ_6231,Dray pinned Lowry via warriors ,31,213,1379,1592,video
CompanyJ_6232, Toronto has taken over Oracle via william_lou ,47,923,6250,7173,video
CompanyJ_6233,VanVleet took a hard elbow to the face and he s headed to the locker room ,74,663,4106,4769,photo
CompanyJ_6234,,0,11490,51131,62621,photo
CompanyJ_6235,Board Man gets paid Kawhi drops 36 as the Raptors take a commanding 3 1 series lead in the NBA Finals ,102,8567,33527,42094,photo
CompanyJ_6236,Raptors realizing they have a 3 1 lead ,39,3797,24431,28228,photo
CompanyJ_6237,This is how KD has to come back ,32,2767,10354,13121,photo
CompanyJ_6238,Steph on being down 3 1 We ve been on both sides of it Klay nods head via sandeepchandok ,89,1831,14445,16276,video
CompanyJ_6239, One more game via YahooCASports ,33,252,1822,2074,video
CompanyJ_6240, ,1,12727,49165,61892,video
CompanyJ_6241,Lowry clowned Ibaka s postgame fit ,35,675,6264,6939,video
CompanyJ_6242,Will they ,10,582,4684,5266,photo
CompanyJ_6243,After taking the 3 1 lead Kawhi s goal remains simple play to win ,66,2529,19401,21930,video
CompanyJ_6244,2003 04 Pistons and 2018 19 Raptors have a lot in common Round 1 Advance 4 1 Round 2 Advance 4 3 Conference Finals Advance 4 2 Finals Pistons won 4 1 Raptors have 3 1 lead H T pickuphoop ,187,980,4994,5974,photo
CompanyJ_6245,FIFA 20 is taking it back to the street via brfootball ,55,1452,6981,8433,photo
CompanyJ_6246, You keep that ball in a yoyo you going to be straight Only in 2nd grade and he s owning these dribble workouts via coach_mook3 Instagram ,138,1674,11926,13600,video
CompanyJ_6247,Too quick with it via brfootball ,33,3182,17012,20194,video
CompanyJ_6248,A fan wore a No 35 Knicks jersey to Game 4 at Oracle ,53,2543,21793,24336,video
CompanyJ_6249,Rajon Rondo opens up about the Lakers environment this season The circus atmosphere came as no surprise You know what you re coming into with LeBron James on the team ,167,713,3809,4522,photo
CompanyJ_6250,Kawhi s game is lethal ,23,2123,17977,20100,video
CompanyJ_6251,The young Lakers learned the hard way that playing with your idol doesn t always go as planned ,95,1163,7792,8955,photo
CompanyJ_6252,The sound he made going up for the dunk via suprememariii j3rmaine_ IG ,71,194,2110,2304,video
CompanyJ_6253,Windmill turned into a mid air backboard alley to the left hand via jordankilganon IG ,86,5841,34896,40737,video
CompanyJ_6254,Emoni Bates is unfair via brhoops ,34,258,2115,2373,video
CompanyJ_6255,Running routes and hitting buzzer beaters Jamarion Styles has no arms and he can do it all via xxstylesxx561xx ,111,1762,9527,11289,video
CompanyJ_6256, Without Cedella there would be no qualification for the World Cup How cedellamarley Bob Marley s daughter rescued the Jamaican women s national team via brfootball ,165,380,1295,1675,video
CompanyJ_6257, Let me tell you something bout my best friend NationalBestFriendsDay ,70,534,5401,5935,photo
CompanyJ_6258,Last time a team came back from down 3 1 in the finals ,55,15266,63345,78611,video
CompanyJ_6259, Lets go Raptors chant breaks out at the PGA Tour via PGATOUR ,62,1152,8671,9823,photo
CompanyJ_6260,Bed time came early via trboxing ,33,3405,15032,18437,video
CompanyJ_6261,OTD in 2001 Shaq put up video game numbers in the NBAFinals 28 PTS 20 REB 9 AST 8 BLK ,86,1383,7573,8956,video
CompanyJ_6262,Friendly advice don t ever get caught in a windmill via stfujalen IG ,69,4358,26048,30406,video
CompanyJ_6263,GGG put him to SLEEP via DAZN_USA ,34,7946,26839,34785,video
CompanyJ_6264, UFC238 ,8,732,4255,4987,photo
CompanyJ_6265,LaMelo pulled out the step back 3 in his Drew League debut via brhoops ,71,2559,21345,23904,video
CompanyJ_6266,41 years old and playing in her SEVENTH World Cup Brazil s Formiga is a legend via brfootball ,94,2332,13021,15353,photo
CompanyJ_6267,Four years ago today Bron dropped 40 and carried the Cavs to a 2 1 lead on the Warriors They didn t have Love Kyrie and their second leading scorer was Delly 20 ,161,11258,53177,64435,video
CompanyJ_6268,Sometimes the disrespect cuts too deep via hohighlights SupremeDreams_1 ,72,3234,14890,18124,video
CompanyJ_6269,D Jax handing out food to the homeless in Philly via DeSeanJackson11 ,69,2578,13040,15618,video
CompanyJ_6270,Raptors are 5 1 against the Warriors this year Kawhi won t say they re better yet ,82,1165,10141,11306,video
CompanyJ_6271,Rafael Nadal wins his 12th French Open Never lost a French Open final 18 total Grand Slam titles ,97,1873,9705,11578,photo
CompanyJ_6272,Fred VanVleet s even locking up kids via TSN_Sports ,52,332,4678,5010,video
CompanyJ_6273,Kawhi on the rumor that he s buying property in Toronto It didn t happen yet no ,80,1635,10807,12442,video
CompanyJ_6274,KD BACK No 35 will be cleared to practice today per ChrisBHaynes ,65,4652,22527,27179,photo
CompanyJ_6275,SKATES via oc_chin IG ,22,1324,7679,9003,video
CompanyJ_6276,Klay s laugh ,13,5361,28424,33785,video
CompanyJ_6277,When the goalie has the footwork too via brfootball ,52,167,2011,2178,video
CompanyJ_6278,Kawhi leads the 2019 playoffs in Minutes Points by over 100 Rebounds Steals Field goals Free throws ,100,5500,35074,40574,photo
CompanyJ_6279,He lagged mid air via josiahs_on_a_diet IG ,43,13254,59728,72982,video
CompanyJ_6280,Nations League Another trophy for Ronaldo via brfootball ,57,1530,5437,6967,photo
CompanyJ_6281, ,1,1587,6281,7868,photo
CompanyJ_6282,Kyle Lowry explains what real pressure is Powerful ,51,13821,56502,70323,video
CompanyJ_6283,Rory Raptors McIlroy puts on for Kyle Lowry and Toronto after winning the Canadian Open via PGATOUR ,100,751,7713,8464,photo
CompanyJ_6284,Real dedication via foreveriball IG ,36,1932,15502,17434,video
CompanyJ_6285,Dejounte Murray s little brother graduated and made honor roll so he bought him a car via DejounteMurray ,105,17863,106627,124490,video
CompanyJ_6286,David Ortiz hospitalized after being shot in Dominican Republic during an apparent robbery per CDN37 ,101,8515,22060,30575,photo
CompanyJ_6287,Bruins get it done in Game 6 Boston comes up big to force Game 7 in the StanleyCup Final ,89,223,1650,1873,photo
CompanyJ_6288,Chief of Police says David Ortiz is in stable condition per dSoldevila ,71,4909,31747,36656,photo
CompanyJ_6289,Teamwork via hikki10 IG ,24,1756,14903,16659,video
CompanyJ_6290,Raptors president Masai Ujiri showed up to meet the fans camping outside Jurassic Park via Devin_Heroux ,104,212,2590,2802,video
CompanyJ_6291, What the hell is a chilly bin RjHampton14 tries to learn Australian and New Zealand slang ,91,138,878,1016,video
CompanyJ_6292,David Ortiz is in intensive care with organ damage but is expected to quickly recover per Enrique_Rojas1 ,105,1334,8507,9841,link
CompanyJ_6293,Players send love to Big Papi as he recovers ,45,683,5558,6241,video
CompanyJ_6294,Breaking Tony Parker is retiring from the NBA after 18 seasons per MarcJSpearsESPN ,83,7892,38462,46354,photo
CompanyJ_6295,18 seasons 4x champ Finals MVP 6x All Star What a career ,57,3880,24097,27977,photo
CompanyJ_6296,This chapter is officially closed ,34,21155,79375,100530,photo
CompanyJ_6297,David Griffin is starting to provide teams with a framework of a package he wants for AD including multi team scenarios per WojESPN Suitors Lakers Knicks Clippers Nets ,168,1300,5804,7104,photo
CompanyJ_6298,In 2003 Carli Lloyd almost walked away from soccer 16 years later she has almost 300 USWNT appearances and is in her fourth World Cup Carli is the most impactful player the world has ever seen ,193,72,687,759,photo
CompanyJ_6299, 2x reigning Finals MVP 34 2 playoff PPG before injury 40 5 PPG in reg season vs Raps KD s on the verge of changing this series ,128,1233,7404,8637,video
CompanyJ_6300,Tierna Davidson knows the secret to a winning mindset when she s on the road ATT ,81,12,148,160,video
CompanyJ_6301,KD IS BACK Durant plans to play in Game 5 tonight per wojespn ,62,3403,13792,17195,photo
CompanyJ_6302,Kawhi s just happy to be hooping again after getting hurt last year ,68,1194,10727,11921,video
CompanyJ_6303,They were watching Raptors Warriors at prom via Dhillon_679 jairellvialu IG ,76,403,3506,3909,video
CompanyJ_6304,Players like PJ Tucker bring out the best fits and kicks for the tunnel walk From tissot x B R ,95,59,509,568,video
CompanyJ_6305,Tomorrow the USWNT begin their journey to World Cup No 4 USA via brfootball ,76,684,4505,5189,photo
CompanyJ_6306,Lakers and Knicks are AD s two desired long term destinations per ShamsCharania ,80,1877,9839,11716,photo
CompanyJ_6307,Lakers are the leader in the clubhouse for Anthony Davis per wojespn ,69,4830,25167,29997,photo
CompanyJ_6308,Pelicans would hypothetically love to have a deal in place to trade Anthony Davis by this weekend per wojespn ,110,1828,8988,10816,photo
CompanyJ_6309,KD is in via YahooCASports ,27,3397,19851,23248,video
CompanyJ_6310, Midrange is dead Kawhi via Raptors ,36,1549,11898,13447,video
CompanyJ_6311,Nurse told the Raptors after Game 2 that all they had to do was win one at Oracle to regain home court advantage Kawhi s response Expletive that Let s go get both ,163,3801,21225,25026,photo
CompanyJ_6312,One more hour NBAFinals ,24,309,1888,2197,photo
CompanyJ_6313,Toronto cheered after KD missed a three in warm ups Crowd wasn t so loud when he drilled 11 straight shots via TSN_Sports ,122,1928,9556,11484,video
CompanyJ_6314,Drake and Uncle Nav looking ready to witness history via NBATV ,63,3289,28662,31951,video
CompanyJ_6315,It s time ,10,1296,5443,6739,photo
CompanyJ_6316,Drake felt that ,16,512,4620,5132,photo
CompanyJ_6317,KD in Game 5 after missing the start of the Finals ,51,1279,4751,6030,photo
CompanyJ_6318,Raptors fans joined in for O Canada ahead of Game 5 Chills via NBATV ,69,698,4073,4771,video
CompanyJ_6319, HE S BAAAACK via NBATV ,24,1318,8325,9643,video
CompanyJ_6320,BUCKET LAYUP via Raptors ,25,489,3286,3775,video
CompanyJ_6321,11 PTS in 10 minutes 75 shooting in the first quarter Easy Money just getting started ,86,1611,8803,10414,photo
CompanyJ_6322,Oh no KD ,9,5828,24475,30303,photo
CompanyJ_6323,Prayers up ,11,20906,80954,101860,photo
CompanyJ_6324,Steph and Dre walking KD to the locker room via NBATV ,54,3627,30698,34325,video
CompanyJ_6325,Game 5 has been an absolute battle Warriors lead 62 56 Steph 23 PTS ,68,394,3161,3555,photo
CompanyJ_6326,Kevin Durant has a lower right leg injury out for the remainder of Game 5 ,74,685,3904,4589,photo
CompanyJ_6327,KD left the arena on crutches in a walking boot via Skinny_Post ,64,2045,7970,10015,video
CompanyJ_6328, ,1,1048,6884,7932,photo
CompanyJ_6329,BOARD MAN HITS BIG SHOTS ,25,3019,9685,12704,photo
CompanyJ_6330,BUCKETS ,8,3877,16412,20289,photo
CompanyJ_6331,WHAT A GAME ,12,3635,19336,22971,photo
CompanyJ_6332,Heart of a Champion Steph drops 31 amp the Warriors push the NBA Finals to a Game 6 ,84,3943,13416,17359,photo
CompanyJ_6333,Finals Klay gets it done CoorsLight ,36,1606,7385,8991,video
CompanyJ_6334, Stay alive via warriors ,25,2186,14003,16189,video
CompanyJ_6335,More than a game Drake showed love to KD after his injury ,58,1492,10333,11825,video
CompanyJ_6336,Fingertips ,11,6577,33229,39806,link
CompanyJ_6337,Kevin Durant has an Achilles injury ,36,2869,11643,14512,video
CompanyJ_6338,Bob Myers fighting back tears talking about KD s injury I don t believe there s anyone to blame if you have to you can blame me via NBATV ,138,6343,31897,38240,video
CompanyJ_6339,Keep your head up KDTrey5 ,26,3098,16220,19318,photo
CompanyJ_6340,Warriors believe MRI will confirm Kevin Durant has torn right Achilles tendon per ramonashelburne ,98,1169,6031,7200,photo
CompanyJ_6341,22 years ago today MJ s Flu Game 1997 Finals vs Jazz tied 2 2 Got food poisoning from pizza Fetal position at 2 a m 38 PTS 44 MIN Dagger with 25 seconds left Won fifth title in Game 6 ,184,2814,12301,15115,photo
CompanyJ_6342,Respect for a true warrior via drake ,37,2670,24236,26906,photo
CompanyJ_6343, USWNT ASSEMBLE Game day for the defending World Cup champions via brfootball ,78,956,5082,6038,photo
CompanyJ_6344,Kawhi had to laugh when questioned why he didn t take the last shot ,68,3376,27032,30408,video
CompanyJ_6345,Boogie on anyone questioning KD s heart F k them via 957thegame ,64,1409,8407,9816,video
CompanyJ_6346, ,1,2175,9841,12016,photo
CompanyJ_6347,Drake leaving like he just played 40 minutes via TSN_Sports ,60,11544,78338,89882,video
CompanyJ_6348,Winning mentality ,18,480,3700,4180,photo
CompanyJ_6349,Klay says Durant is the best player in the world and one of the greatest ever He s praying for KD s recovery ,109,2855,20302,23157,video
CompanyJ_6350,Rookie phenom Pete Alonso journals his at bats every night While some people call it his diary Alonso insists it s a notebook It s official ,140,75,531,606,photo
CompanyJ_6351,Down six Two minutes left Finals on the line Splash Bros came through ,70,2283,13113,15396,video
CompanyJ_6352,Two basketball legends have birthdays today Maya Moore 4x Champion MVP and Finals MVP 5x All Star Diana Taurasi 3x Champion 2x Finals MVP and 1x MVP 9x All Star That s a lot of hardware ,186,2256,9927,12183,photo
CompanyJ_6353,This is mpinoe From B R Football x drinkbodyarmor ,50,28,155,183,video
CompanyJ_6354,Kevin Porter Jr s dad was murdered when he was four That s why the NBA prospect wears No 4 And make sure you remember the Jr in his name ,137,6800,29786,36586,video
CompanyJ_6355,First USWNT game of the 2019 World Cup LET S GO ,48,110,666,776,photo
CompanyJ_6356,Kylian Mbappe reaches 100 career goals at only 20 years old via brfootball ,75,1345,10417,11762,photo
CompanyJ_6357,Who else but alexmorgan13 via brfootball ,41,370,2375,2745,photo
CompanyJ_6358,Alex Morgan with the opening goal for the USWNT via FOXSoccer ,62,555,2654,3209,photo
CompanyJ_6359,Rose Lavelle from DISTANCE USWNT up 2 0 in under 20 mins via FOXSoccer ,71,230,1116,1346,photo
CompanyJ_6360,The Lakers are GIGANTIC favorites to get Anthony Davis via BR_Betting CaesarsPalace ,84,1380,5883,7263,photo
CompanyJ_6361,Tobin Heath FILTHY via FOXSoccer ,33,216,1148,1364,photo
CompanyJ_6362,And it s not even the 60th minute USWNT ,40,1736,8036,9772,photo
CompanyJ_6363,HAT TRICK FOR ALEX MORGAN via brfootball ,41,1083,7259,8342,video
CompanyJ_6364,8 0 The most goals the USWNT have ever scored in a World Cup game ,66,342,1886,2228,photo
CompanyJ_6365, USWNT is up 10 0 on Thailand ENERGY ,37,861,5172,6033,photo
CompanyJ_6366,Thirteen To Zero The USWNT enjoying the World Cup so far via brfootball ,72,799,4125,4924,photo
CompanyJ_6367,Alex Morgan scored FIVE via FOXSoccer ,38,872,3601,4473,photo
CompanyJ_6368, ,1,1116,5295,6411,photo
CompanyJ_6369,Ten goals in the second half alone 50 Mewis 53 Morgan 54 Mewis 56 Lavelle 74 Morgan 79 Rapinoe 81 Morgan 84 Pugh 87 Morgan 92 Lloyd ,132,515,4537,5052,photo
CompanyJ_6370,Raiders will be the team featured on this season of Hard Knocks via Raiders ,76,1791,7750,9541,video
CompanyJ_6371,She caught JuJu slipping via TeamJuJu ,38,3197,29825,33022,video
CompanyJ_6372,Nationals are trimming into the 1st place lead in NL East with aces syncing and bats picking up the hole left by Bryce Harper Supercuts ,136,55,207,262,video
CompanyJ_6373,20 years ago today the Knicks became the only 8th seed in NBA history to make the NBA Finals Lost Ewing to torn Achilles in Game 2 of ECF Beat Pacers in 6 games clinching in MSG Only No 8 seed to make it to conference finals Last time NY was in the Finals ,256,963,5005,5968,photo
CompanyJ_6374,11 year old Laila Anderson will be going to Game 7 of the Stanley Cup after doctors said she was cleared to travel Her reaction to finding out is priceless via StLouisBlues ,173,4474,27834,32308,video
CompanyJ_6375,She s five years old and has HANDS via HeroGawd ,48,9037,43466,52503,video
CompanyJ_6376,Rich Paul warns the Celtics about pursuing AD They can trade for him but it ll be for one year per bySLPrice ,109,1543,7532,9075,photo
CompanyJ_6377,On this day in 1991 Michael Jordan won his first title at 28 Beat childhood hero Magic 31 2 PPG 11 4 APG 6 6 RPG No one can ever take this away from me ,152,3137,17254,20391,photo
CompanyJ_6378,Kobe and Metta targeted specific players to bully game to game We had fun doing that QuietStorm The Ron Artest Story is streaming on SHOSports ,143,921,4302,5223,video
CompanyJ_6379,Fair warning ,13,754,5057,5811,photo
CompanyJ_6380,Kyrie Irving will not opt into player option for next season will become unrestricted free agent per ShamsCharania ,115,6474,31182,37656,photo
CompanyJ_6381,Bol Bol is the NBA draft s biggest mystery The 7 2 center has top five talent But with injury and character concerns will he be the draft s biggest steal or risk ,162,310,2479,2789,photo
CompanyJ_6382,Zo getting right for 2019 via AndyBarrPT ,41,2541,22441,24982,video
CompanyJ_6383,Through the years Tiger s swing has only gotten better since 93 via PGATOUR ,76,295,2248,2543,photo
CompanyJ_6384,Cavs are hiring UC Berkeley HC Lindsay Gottlieb as an assistant coach per wojespn Gottlieb will be the first women s collegiate head coach to be hired to an NBA coaching staff ,176,1467,8024,9491,photo
CompanyJ_6385,Real teammates ,15,1404,11295,12699,photo
CompanyJ_6386,Two years ago today KD won his first NBA title and Finals MVP Get well soon KD ,79,3484,25132,28616,photo
CompanyJ_6387,Atletico Madrid s CEO confirms that Antoine Griezmann is headed to Barcelona We ve known since March where Griezmann will play at Barcelona per sport via brfootball ,165,1333,5306,6639,photo
CompanyJ_6388,It was really 13 0 USA via brfootball ,38,114,939,1053,video
CompanyJ_6389,Breaking KD confirms he s torn his Achilles Surgery was today and it was a success EASY MONEY via KDTrey5 ,106,15454,82691,98145,photo
CompanyJ_6390,Lakers and Celtics are both engaged in trade talks with Pels for Anthony Davis per wojespn ,91,784,5148,5932,photo
CompanyJ_6391,Lakers have made Ingram Lonzo and the No 4 pick in the draft available in trade talks with the Pelicans per TheSteinLine ,121,3297,15520,18817,photo
CompanyJ_6392,KD just wanted to hoop ,23,759,4814,5573,photo
CompanyJ_6393,Potential AD Lakers trade could hinge on Kyle Kuzma Lakers don t want to trade Kuz but Pelicans want him in the deal per taniaganguli and BA_Turner ,148,1695,8384,10079,photo
CompanyJ_6394,Kawhi gives KD advice on recovering from Achilles injury ,57,1860,12252,14112,video
CompanyJ_6395,11 year old Laila Anderson is a Blues superfan She has a rare immune disease that s kept her mostly homebound Tonight she gets to go to Game 7 of the StanleyCup ,161,702,4355,5057,video
CompanyJ_6396,Jim has a special message for Pam ahead of Game 7 via johnkrasinski ,68,7488,33390,40878,video
CompanyJ_6397,Kyrie Irving expected to sign with ROC Nation Sports ahead of free agency per wojespn ,86,2155,12028,14183,photo
CompanyJ_6398,BACK TO BACK BLUES StanleyCup via StLouisBlues ,47,235,1765,2000,video
CompanyJ_6399,8 years ago today Dirk and the Mavs upset the Heat to capture their first title ,80,9125,44481,53606,video
CompanyJ_6400,Blues win first StanleyCup in 52 year history with 4 1 victory over Bruins in Game 7 ,85,1958,8872,10830,photo
CompanyJ_6401,Nothing sweeter than this 11 year old Blues superfan Laila Anderson celebrates St Louis 1st StanleyCup via NHL ,111,1478,14797,16275,video
CompanyJ_6402,Koepka or Tiger Both have a strong chance to take down the US Open Chevrolet ,77,55,492,547,video
CompanyJ_6403,Premier League schedule is set These matchups via brfootball ,61,520,2947,3467,photo
CompanyJ_6404,St Louis fans really lifted a cart after winning their first ever Stanley Cup Via jacobmelsha ,94,188,1600,1788,video
CompanyJ_6405,Game 6 in the Bay TONIGHT ,26,5721,34552,40273,photo
CompanyJ_6406,Klay on if KD is worthy of Splash Brother status I guess he ain t win enough Finals MVPs ,89,709,5883,6592,video
CompanyJ_6407,Cooked everybody at the park via w0o24 IG brhoops ,50,2833,17410,20243,video
CompanyJ_6408,Kawhi is focused on the moment ,31,1550,9647,11197,photo
CompanyJ_6409,Tonight is the last game at Oracle Baron Davis mean poster on AK 47 is one of the best moments in the arena s history via NBAHistory ,133,8173,34156,42329,video
CompanyJ_6410,Jordan Spieth won three majors by 23 and looked like the potential GOAT Now he s ranked No 28 What happened ,108,60,703,763,photo
CompanyJ_6411,Caught them with back to back nutmegs Via FOXSoccer ,52,144,1056,1200,photo
CompanyJ_6412,Eden Hazard in Real Madrid s kit for the first time via realmadriden ,69,1669,7416,9085,video
CompanyJ_6413,June 13 will be remembered as the start of the most epic Finals comeback Down 3 1 in 2016 Kyrie and Bron WENT OFF for 41 points each ,133,16847,65805,82652,video
CompanyJ_6414,Klay has a message for Dubs Nation Do it for K via KlayThompson ,64,2987,16192,19179,photo
CompanyJ_6415,50 000 Real Madrid fans PACKED the stadium just to see Eden Hazard put on the shirt for the first time via realmadriden ,120,557,3641,4198,video
CompanyJ_6416,Raptors fans signed a Get Well card for KD via TSN_Sports ,58,2622,18647,21269,video
CompanyJ_6417,Warriors need Game 6 Klay tonight 2016 vs OKC 41 PTS 14 31 11 18 3PT W 2018 vs HOU 35 PTS 13 23 9 14 3PT W ,107,2187,10127,12314,video
CompanyJ_6418, Oracle Arena to me means home It s a staple in the community and it s just a beautiful place to play basketball warriors reflect on what their historical arena means to them ahead of the last game via NBA ,206,452,2217,2669,video
CompanyJ_6419,Kyrie is prepared to sign with the Brooklyn Nets this offseason per SteveBHoop ,79,5342,20706,26048,photo
CompanyJ_6420,Quinn Cook rocking a KD shirt in warmups via warriors ,54,941,9516,10457,video
CompanyJ_6421,Steph s final tunnel shot at Oracle via YahooCASports ,54,1955,14734,16689,video
CompanyJ_6422,GAME 6 LOWRY 4 5 FG 3 3 3PT 11 PTS via NBACanada ,49,1485,8407,9892,video
CompanyJ_6423, Oracle ERUPTS for KD s tribute video via wontgottlieb ,55,718,3642,4360,video
CompanyJ_6424,Drake back home at Jurassic Park for Game 6 via TSN_Sports ,59,463,3608,4071,video
CompanyJ_6425,Klay has passed LeBron to become No 3 on the all time playoff threes list He trails only Steph and Ray Allen ,109,1292,6945,8237,photo
CompanyJ_6426,Kyle Lowry wants a ring He has 15 PTS on 4 4 3PT after the 1st Q ,65,811,6074,6885,photo
CompanyJ_6427,Kawhi blocked Steph and hit em with a cold step back via Raptors ,65,1914,12400,14314,video
CompanyJ_6428,Steph and Klay making sure Kawhi gets no extra shots after the whistle via NBCSWarriors ,88,388,2649,3037,video
CompanyJ_6429,Both veteran guards going back and forth in the first half Lowry 21 PTS 6 REB 6 AST Klay 18 PTS 3 REB 2 STL NBAFinals ,118,433,2910,3343,photo
CompanyJ_6430,Klay is 22 38 from deep in the Finals 57 9 That d be the best 3PT in Finals history per bball_ref ,98,1062,5928,6990,photo
CompanyJ_6431,KAWHI TOO STRONG via TSN_Sports ,32,509,3352,3861,video
CompanyJ_6432, GAME 6 KLAY ,13,1162,4142,5304,photo
CompanyJ_6433,Klay launching from everywhere via warriors ,44,759,3625,4384,video
CompanyJ_6434,Oh no Klay ,11,2013,8990,11003,photo
CompanyJ_6435,KLAY IS BACK,12,1963,9373,11336,status
CompanyJ_6436,Klay was carried off the court after an awkward landing and knee injury He came back in and drilled two FT s ,109,2480,12799,15279,photo
CompanyJ_6437,No one wants it more than Klay via NBATV ,41,6828,38866,45694,video
CompanyJ_6438,Klay is out for the rest of Game 6 with a knee injury per HeyDB ,64,1775,6232,8007,photo
CompanyJ_6439,Game 6 Klay was on his way to a vintage performance before going down knee 30 PTS 8 12 FG 4 6 3PT 10 10 FT Hope he s alright ,125,3468,17201,20669,photo
CompanyJ_6440,Klay leaving Oracle on crutches Man via NBCSWarriors ,53,1661,8441,10102,video
CompanyJ_6441,THIS GAME ,10,2545,8528,11073,photo
CompanyJ_6442,BOOGIE ,7,246,2159,2405,photo
CompanyJ_6443,RAPTORS TURNOVER WITH 9 6 LEFT ,31,611,3510,4121,status
CompanyJ_6444,Raptors win their first NBA title in franchise history ,55,24354,69107,93461,photo
CompanyJ_6445,The Drake curse is over ,24,43752,147601,191353,photo
CompanyJ_6446,CELEBRATION TIME FOR TORONTO ,29,7330,26519,33849,video
CompanyJ_6447,Mood in Toronto ,16,71598,173212,244810,video
CompanyJ_6448,Drake been waiting a long time for this feeling via TSN_Sports ,63,16568,63123,79691,video
CompanyJ_6449,Kawhi stops another potential 3 peat for the second time this decade ,69,19851,69836,89687,photo
CompanyJ_6450,Kawhi becomes the third player to win Finals MVP with two different teams ,74,15502,60499,76001,photo
CompanyJ_6451, This is what I play basketball for kawhileonard reflects on historic season with Toronto after winning Finals MVP NBAFinals ,125,4335,17901,22236,video
CompanyJ_6452,Jeremy Lin is an NBA Champion via garystriewski ,48,24568,124614,149182,video
CompanyJ_6453, Never let anybody tell you you can t do something special What a moment for Lowry and Toronto NBAFinals ,105,3233,16221,19454,video
CompanyJ_6454,VanVleet stepped up when it mattered most ,42,2227,13214,15441,video
CompanyJ_6455,Spicy P and the Raptors closed out the NBAFinals at Oracle s last game ATT ,75,261,1974,2235,video
CompanyJ_6456,FUN GUY via Raptors ,20,5217,31701,36918,video
CompanyJ_6457, Drake dropping a championship anthem NBAFinals ,48,7366,24462,31828,photo
CompanyJ_6458, A lot of people were doubting me Thought I was either faking an injury or didn t want to play for a team Kawhi on his incredible comeback NBAFinals ,149,2830,11870,14700,video
CompanyJ_6459, I just really thought about him I didn t care about the game that much Kawhi on Klay s injury is class personified NBAFinals ,126,3789,25956,29745,video
CompanyJ_6460,Nick Nurse has been grinding for almost 30 years It paid off Youngest US college coach 11 years in Europe Player coach in British League Helped found G League team G League head coach Raptors assistant Raptors head coach NBA champion ,234,3490,25444,28934,photo
CompanyJ_6461,Aubrey hype ,12,1266,8138,9404,photo
CompanyJ_6462,BREAKING Klay Thompson suffered a torn ACL in Game 6 per wojespn ,65,6748,23495,30243,photo
CompanyJ_6463,We really might get a season without these two next year Brutal ,64,11031,49781,60812,photo
CompanyJ_6464,Kawhi s coming back North with an NBA trophy for Toronto ,57,1037,7503,8540,photo
CompanyJ_6465,The Klaw never lost faith ,26,2397,16761,19158,photo
CompanyJ_6466,The ending to a WILD 2018 19 NBA season Gone too soon ,54,1057,9736,10793,video
CompanyJ_6467,The Gasol family makes history ,31,8796,55982,64778,photo
CompanyJ_6468,Masai thanks Kawhi for helping bring a championship to the city of Toronto The ultimate payoff for trading a beloved franchise star in DeRozan ,143,634,6836,7470,video
CompanyJ_6469,Steph and Dray are confident in the Dubs future ,48,672,4530,5202,photo
CompanyJ_6470,After winning the chip Kawhi is back to his scheduled programming via HoHighlights ,83,8332,34265,42597,video
CompanyJ_6471,Drizzy got jokes via Drake ,27,3915,23328,27243,video
CompanyJ_6472,Kawhi needs to frame this ,26,16132,92493,108625,photo
CompanyJ_6473,Steve Kerr was only off by two games via mattzitzerman IG ,58,386,4228,4614,video
CompanyJ_6474,Fred VanVleet s story just got even better Went from Unranked in HS Two D I offers Wichita State stud Final Four Too small 6 0 Undrafted 4th string PG To NBA champion Key shooter and defender 18 million extension ,213,7345,37033,44378,photo
CompanyJ_6475,He s a world champion boxer and a full time gas leak technician ,64,39,301,340,photo
CompanyJ_6476,Lakers are the favorites to take it all next season It hasn t even been 24 hours since Raps were crowned champs via br_betting ,127,5491,21787,27278,photo
CompanyJ_6477,Still the last team to three peat ,34,20763,79957,100720,photo
CompanyJ_6478,Toronto has one mission this summer re sign Kawhi ,50,3050,20705,23755,video
CompanyJ_6479,Klay Thompson s father Mychal says there s no question he will re sign with Warriors this summer per Con_Chron ,111,3606,19223,22829,photo
CompanyJ_6480,The Copa America starts today via brfootball ,45,1555,8248,9803,photo
CompanyJ_6481,With a minute left nobody knew how Game 6 would end Wild finish ,64,694,4670,5364,video
CompanyJ_6482,The gods have rewarded Ujiri s sacrifices for the North ,56,2046,7183,9229,video
CompanyJ_6483,Kawhi is the first non Nike athlete in over a decade to win Finals MVP via brkicks ,83,3476,23117,26593,photo
CompanyJ_6484,On this day in 1998 MJ ended the Jazz to win his 6th title ,59,5179,25220,30399,video
CompanyJ_6485,Steve Nash s footwork brfootball x stevenashfdn Showdown 6 19 at 6 PM in NYC Open to the public Donate get tickets ,115,326,2223,2549,video
CompanyJ_6486,10 years ago today Kobe won his 4th title and 1st without Shaq Bryant won Finals MVP averaging 32 4 PTS 5 6 REB 7 4 AST ,120,6676,29480,36156,photo
CompanyJ_6487,Patrick Reed is gonna need a new club via GolfonFOX ,52,206,1805,2011,video
CompanyJ_6488, LeBron Russ CP3 Squad came through for Liberty vs Aces via WNBA ,65,4070,29970,34040,video
CompanyJ_6489,Bumping that new Drake via SportsLine ,38,2297,15624,17921,video
CompanyJ_6490,A year ago today Ronaldo s World Cup hat trick vs Spain capped off with an incredible free kick via FOXSoccer ,110,382,2120,2502,photo
CompanyJ_6491,Today marks five years since the Klaw stopped his first three peat Finals MVP 17 8 PPG 6 4 RPG 1 6 SPG Tim Duncan s last Finals appearance LeBron s last year in Miami Patty Mills Kawhi Leonard Superhero speech says it all ,222,5166,32062,37228,video
CompanyJ_6492,What re these kids eating nowadays via 12jordangeorge ,54,3583,24042,27625,video
CompanyJ_6493,Donovan caught Trae Young acting different via spidadmitchell ,62,3107,27472,30579,video
CompanyJ_6494,A King and a Prince via KMbappe ,32,2060,21041,23101,photo
CompanyJ_6495,Post Achilles Kevin Durant might not be Kevin Durant again according to a doctor and a trainer He s not going to be an 82 game a year guy ,138,4328,19013,23341,photo
CompanyJ_6496,RIGHT HOOK COLD Wild walk off KO from jarchmma via BellatorMMA ,63,582,2935,3517,video
CompanyJ_6497,Like father like son Bronny hitting game winners via brhoops BallingOnTheBeach ,79,1660,12945,14605,video
CompanyJ_6498,First touch too clean via brfootball ,37,347,2913,3260,video
CompanyJ_6499,A regular poster wasn t enough via swiper thefox IG ,52,7503,38812,46315,video
CompanyJ_6500,He got Kawhi s celebration tatted via jtattoos IG ,50,3652,30650,34302,video
CompanyJ_6501,Kawhi knows the board man gets paid to win He remembers the rebound he missed to lose the 2013 Finals and had a strategy to win this year ,138,979,8706,9685,video
CompanyJ_6502,BREAKING Anthony Davis is headed to the Lakers for Lonzo Ball Brandon Ingram Josh Hart and 3 1st round picks including No 4 overall pick in 2019 draft per wojespn ,163,49580,107543,157123,photo
CompanyJ_6503,AD becomes the next star big man for the Lakers ,48,13490,53496,66986,photo
CompanyJ_6504,L A MOOD ,9,12499,47612,60111,video
CompanyJ_6505,Lonzo s time in L A is over ,28,54063,139757,193820,video
CompanyJ_6506,The NBA landscape has been flipped ,35,3360,18372,21732,photo
CompanyJ_6507,Kemba Walker will be top target for Lakers in free agency after reaching an agreement in principle to trade for Anthony Davis per TheSteinLine ,143,7809,30688,38497,photo
CompanyJ_6508, You ready ,11,7307,33730,41037,photo
CompanyJ_6509,The moment AD knew he wanted to be in LA ,41,6805,30555,37360,video
CompanyJ_6510,Brandon Ingram s trade reaction via B_Ingram13 ,47,2396,14413,16809,photo
CompanyJ_6511,Rich Paul made a dream into reality ,36,1814,12614,14428,photo
CompanyJ_6512,AD plans to re sign with Lakers next summer in 2020 when he enters free agency per wojespn ,91,5758,29322,35080,photo
CompanyJ_6513,Lakers starting point guard after they traded everyone ,55,15736,77409,93145,photo
CompanyJ_6514,Lakers fans don t know how to act after the AD trade via patelanika IG ,71,1451,7291,8742,video
CompanyJ_6515,Game of Zones predicted this ,29,814,4360,5174,link
CompanyJ_6516,LaVar Ball on Lakers trading Lonzo I guarantee it will be the worst move the Lakers ever did in their life and they will never win another championship via NotoriousOHM ,169,5180,25362,30542,video
CompanyJ_6517, KingJames approves ,20,5789,38500,44289,photo
CompanyJ_6518,Fury went Apollo Creed on the intro FurySchwarz ,48,1139,6310,7449,photo
CompanyJ_6519,Tyson Fury 2nd round TKO with EASE FurySchwarz ,47,883,4267,5150,photo
CompanyJ_6520,Tyson Fury is a LEGEND TKO in 2nd round Confirms Wilder rematch Grabs mic and sings Aerosmith FurySchwarz ,106,2216,11997,14213,photo
CompanyJ_6521, HappyFathersDay ,17,896,8534,9430,photo
CompanyJ_6522,On this day in 2008 Tiger Woods won the U S Open with a broken leg and a torn ACL Still unreal ,95,4647,28737,33384,photo
CompanyJ_6523,Got their dream summer moves via brfootball ,44,1161,10741,11902,photo
CompanyJ_6524,CP3 s dad taught him that teammates come first HappyFathersDay statefarm ,73,286,2334,2620,video
CompanyJ_6525, USA could break a lot of records this World Cup via brfootball ,64,264,2200,2464,photo
CompanyJ_6526,Kawhi s chilling now via sergeibaka ,36,23034,141720,164754,video
CompanyJ_6527,Pogba on the move via brfootball ,33,291,2103,2394,photo
CompanyJ_6528,Father s Day 1996 MJ dedicated his fourth title to his father who was murdered in 1993 First full year back from baseball Collapsed on the floor in tears I know he s watching This is for Daddy ,193,5252,31084,36336,photo
CompanyJ_6529, USWNT GAME 2 LET S GO ,23,104,833,937,photo
CompanyJ_6530,Carli Lloyd with the ROCKET via FOXSoccer ,42,333,1992,2325,photo
CompanyJ_6531,Last time the USWNT were up 3 0 at halftime ,44,208,2355,2563,photo
CompanyJ_6532,Russ throwing down alleys with his pops Father son bonding at its finest HappyFathersDay ,89,8627,47662,56289,video
CompanyJ_6533,The USWNT are through to the World Cup knockout stages via brfootball ,70,350,2645,2995,video
CompanyJ_6534,Zach Ertz was hyped to see Julie Ertz score her first World Cup goal via FOXSports ,83,675,7150,7825,video
CompanyJ_6535,Tyson Fury is 6 9 263 pounds Wow via trboxing ,46,16349,82142,98491,video
CompanyJ_6536,Brow mural in LA Not even 24 hours after the trade via gz jr IG ,64,4627,27330,31957,photo
CompanyJ_6537,Neymar wants to leave PSG and the club is open to letting him go for the right offer this summer per lequipe ,109,947,5383,6330,photo
CompanyJ_6538,Lakers expected to pursue Kawhi Leonard in free agency per KevinOConnorNBA ,75,10165,53802,63967,photo
CompanyJ_6539,FVV wants Kawhi to stay but if not ,35,2616,26714,29330,photo
CompanyJ_6540,Pops got dunked on for Father s Day via Rickceno ,49,928,8576,9504,video
CompanyJ_6541,Tiger wasn t feeling it via robinsingh93 IG ,44,659,8538,9197,video
CompanyJ_6542,He SHREDDED the defense via hendo_matt IG ,42,4179,32644,36823,video
CompanyJ_6543,U S Open champion Gary Woodland is a problem on the golf course and hardwood via PGATOUR ,89,640,6803,7443,photo
CompanyJ_6544,Over 100 people are already lined up for the Raptors parade tomorrow via SNFaizalKhamisa ,89,776,7807,8583,video
CompanyJ_6545, ANYTHING S POSSIBLEEEE 11 years ago today KG gave us an iconic reaction after breaking Boston s championship drought ,118,2326,10550,12876,video
CompanyJ_6546,Usain Bolt played in a charity soccer match and made his shirt number his World Record time ,92,919,8063,8982,photo
CompanyJ_6547,Kawhi s in full title mode via Sportsnet ,41,5350,34929,40279,video
CompanyJ_6548,Between 1 5 and 2 million fans could be at the Raptors parade today per CP24 via Raptors ,89,1834,13918,15752,video
CompanyJ_6549,Fake Kawhi is taking photos and signing autographs at the parade via blogTO ,76,1753,11312,13065,video
CompanyJ_6550,Kawhi rocking a Board Man Gets Paid shirt at the parade via NBAonTNT ,69,5621,34027,39648,video
CompanyJ_6551,Klaw 6 God via NBA ,19,13673,80782,94455,video
CompanyJ_6552,Board Man vibing the MVP chants via NBA ,40,3833,29694,33527,video
CompanyJ_6553,J Lin broke out the champagne Life of a champion via JLin7 ,59,5644,40814,46458,video
CompanyJ_6554,Drake will perform at the Raptors parade per Sid_Seixeiro ,58,645,6508,7153,photo
CompanyJ_6555,People got out of their cars on the highway to watch the parade via TSN_Sports ,79,754,5829,6583,video
CompanyJ_6556,Crowd was chanting One more year to Kawhi Lowry got them chanting Five more years via YahooCASports ,100,11165,66074,77239,video
CompanyJ_6557,Drake catching and chugging beers at the parade like he s Gronk via blogTO frazercb IG ,87,1226,8514,9740,video
CompanyJ_6558,Raptors fans TURNED OUT via Sportsnet ,38,3811,22896,26707,video
CompanyJ_6559,Spicy P was checking IDs via TSN_Sports Cabbie ,47,539,5328,5867,video
CompanyJ_6560,Marc Gasol is chugging wine on the parade bus Legend via djlateknight ,70,5654,37216,42870,video
CompanyJ_6561,Melo Ball is signing with the NBL s Illawarra Hawks Australia says he wants to be the No 1 pick next year via Rachel__Nichols The Jump ,135,1626,8125,9751,photo
CompanyJ_6562,WE THE CHAMPS Re live the Raptors epic title run up close and personal ,71,314,2372,2686,video
CompanyJ_6563,Toronto Police confirm at least two people suffered serious injuries from shooting at Raptors celebration ,106,1033,3517,4550,photo
CompanyJ_6564,FUN GUY Kawhi really broke out the laugh to end his speech via TSN_Sports ,74,23282,94024,117306,video
CompanyJ_6565, Risk of kidnappings and ransoms 6 8 bodyguards for their families Flight bans prevent them from sending food home Venezuelan MLB players struggle with turmoil back home ,170,242,1132,1374,photo
CompanyJ_6566,Nine years ago today Metta let it fly QuietStorm The Ron Artest Story is streaming on SHOSports ,96,151,1276,1427,photo
CompanyJ_6567,Mbappe turned up to play street soccer in LA via gabriel_maluf IG ,66,1528,13798,15326,video
CompanyJ_6568,Busted out the behind the back throw via Ry_Tapz ,49,2657,17866,20523,video
CompanyJ_6569,Tree got in the way of Marc s celebration via justsaycb ,56,254,2990,3244,video
CompanyJ_6570,Can t stop watching via riolutm h t BRGaming ,45,5021,26281,31302,video
CompanyJ_6571,Kawhi s focus is on the Clippers if he leaves Toronto not the Lakers per wojespn The idea of him being a third wheel on a team trying to create a superteam that has not been Kawhi s M O ,186,3288,18437,21725,photo
CompanyJ_6572,Shareef O Neal missed last season after having heart surgery This past weekend he showed up at the Drew and left no doubt that he s back via brhoops ,149,2235,14966,17201,video
CompanyJ_6573,It s more than a game via BarneyHope8 ,38,2613,17380,19993,video
CompanyJ_6574,Kyrie has essentially ghosted the Celtics per AdamHimmelsbach Some in the organization have had little if any communication with Irving in recent weeks ,152,2636,15051,17687,photo
CompanyJ_6575,Khabib wouldn t take a picture with a young Barcelona fan until he said Hala Madrid Savage via diarioas ,104,1093,7272,8365,video
CompanyJ_6576,Down three Bron miss Bosh board Six years ago today Ray Allen hit one of the most cold blooded shots of all time ,113,2805,12940,15745,video
CompanyJ_6577,Haircut got Bron feeling himself via KingJames ,47,2944,28374,31318,video
CompanyJ_6578,Tre Flowers daughter wants to be just like dad via _slimm7 ,59,834,7005,7839,video
CompanyJ_6579,Antoine Griezmann and Josh Richardson are the new D Wade and LeBron via AntoGriezmann ,86,1279,9527,10806,video
CompanyJ_6580, I m doing what I feel is right for my family and that s to support my kids D Wade responds to getting criticism for going to Miami Pride to support his son via Variety ,169,10641,44693,55334,video
CompanyJ_6581,Harrison Barnes declines 25 1M player option will become UFA on June 30th per wojespn ,86,797,6372,7169,photo
CompanyJ_6582,They switched to soccer in the middle of a tennis match via TennisTV ,69,4095,21106,25201,video
CompanyJ_6583,FOR GAME 5 star Michigan commit J J McCarthy puts it right where 2022 recruit Kaleb Brown could reach back via BOOMfootball ,124,1066,6628,7694,video
CompanyJ_6584,Jamaica just scored their first ever World Cup goal via FOXSoccer ,66,460,2534,2994,photo
CompanyJ_6585,James Harden and Chris Paul relationship is unsalvageable CP3 demanded a trade and Harden told the front office to choose between them after losing to the Warriors per VinceGoodwill ,182,8269,32006,40275,photo
CompanyJ_6586,Marta is now the ALL TIME top World Cup scorer with 17 goals via brfootball ,76,693,3510,4203,photo
CompanyJ_6587,It all makes sense now via princejohndouglas Instagram ,55,19425,80703,100128,video
CompanyJ_6588,Daryl Morey said CP3 s reps never asked to trade him and that he ll be on the Rockets next season per Jonathan_Feigen ,118,1346,5889,7235,photo
CompanyJ_6589,Leo Messi has told Barcelona that he wants the club to re sign Neymar instead of signing Griezmann per elmundoes ,113,2854,14460,17314,photo
CompanyJ_6590, ,1,3211,22280,25491,photo
CompanyJ_6591,You don t get that ZachLaVine bounce through normal drills ,59,2940,21348,24288,video
CompanyJ_6592,Al Horford and Celtics are no longer discussing a 3 year deal is expected to sign a 4 year deal somewhere else per SteveBHoop ,126,1433,7331,8764,photo
CompanyJ_6593,Lakers trying to open 32M max salary slot by July 6th shopping contracts of Moe Wagner Jemerrio Jones and Isaac Bonga per wojespn ,130,1930,11078,13008,photo
CompanyJ_6594,Celtics and Rockets recently checked in about potential Clint Capela trade per IanBegley ,89,948,5962,6910,photo
CompanyJ_6595,USA is on the board in the GoldCup2019 via FOXSoccer ,53,280,2522,2802,photo
CompanyJ_6596,Zardes in the right place at the right time A goal is a goal via FOXSoccer ,75,804,6424,7228,photo
CompanyJ_6597, The Block The Shot The 3 1 comeback Bron Kyrie and the Cavs made history against the Warriors three years ago today ,117,15398,54877,70275,video
CompanyJ_6598,Messi wants Neymar back via brfootball ,39,553,4896,5449,photo
CompanyJ_6599,Being an unknown recruit didn t stop igotgame_12 from climbing to the top of draft boards ,90,693,4498,5191,video
CompanyJ_6600, ,1,21663,110260,131923,photo
CompanyJ_6601,Draft night is full of surprising gems Nikola Jokic was the 41st pick in 2014 made All NBA First Team 2x Finals MVP Kawhi was traded on draft night by the Pacers The MVP race is between a No 3 Harden No 10 PG and No 15 Giannis pick ,232,641,4842,5483,photo
CompanyJ_6602,Mike Conley is being traded to the Jazz for Jae Crowder Kyle Korver and draft picks per ShamsCharania ,102,3171,16784,19955,photo
CompanyJ_6603,Grant Hill remembers his first poster in the league down to the kicks he laced up From FILAUSA X B R ,101,209,1153,1362,video
CompanyJ_6604,Zion remembers exactly where he was when Pelicans traded AD via BenGolliver ,76,851,7888,8739,video
CompanyJ_6605, What does it feel like to be the best prospect since LeBron James RJ and Zion via usatodaysports ,98,2970,20737,23707,video
CompanyJ_6606,Potential top five pick Jarrett Culver could become Jimmy Butler 2 0 marriottbonvoy ,84,276,2089,2365,video
CompanyJ_6607,Ja says he thrives on negative energy My dad was my first hater If I can take it from him I can take it from anybody via BenGolliver ,133,4742,30305,35047,video
CompanyJ_6608,The Zion effect via FletcherWDSU ,33,3270,18538,21808,photo
CompanyJ_6609,Imagine how different things would be if Steph Curry was drafted No 1 by the Clippers 10 years ago ,99,5188,24608,29796,video
CompanyJ_6610, ,1,2705,21369,24074,photo
CompanyJ_6611,Michael Jordan was drafted 35 years ago today Hakeem Olajuwon and Sam Bowie would be selected ahead of the 6x Finals MVP ,121,1924,14051,15975,photo
CompanyJ_6612, tobias31 x joshhart x TaylorRooks B R s NBA Draft show is LIVE Thursday night ,79,84,729,813,video
CompanyJ_6613,On this day in 1988 Isiah Thomas severely sprained his ankle in Game 6 of the NBA Finals vs the Lakers Zeke played through it and went off for 25 of his 43 PTS in the 3Q ,170,5655,28235,33890,video
CompanyJ_6614,NFL HOF Steve Young surprises Sophie Jones with the Gatorade National Girls Soccer Player of the Year award Gatorade ,117,40,318,358,video
CompanyJ_6615,Dominican Republic lead prosecutor says shooting of David Ortiz was case of mistaken identity per AP ,101,339,1878,2217,photo
CompanyJ_6616, You want me to shoot a three like that Ja Morant s world class trainer was just ok ATT ,88,2039,12992,15031,video
CompanyJ_6617,Space Jam 2 will feature key roles for Damian Lillard Anthony Davis Klay Thompson Diana Taurasi Nneka Ogwumike Will also include several other NBA and WNBA players per ShamsCharania ,182,5420,23840,29260,photo
CompanyJ_6618, NBA champion League MVP 31 560 PTS 20 year career Maverick legend Future Hall of Famer Happy 41st Birthday swish41 ,116,4552,30582,35134,photo
CompanyJ_6619,Brooklyn might have doubts about signing Kyrie Irving if he isn t bringing KD with him per NYPost_Lewis ,104,2255,13145,15400,photo
CompanyJ_6620,After the Raptors went up 3 2 on the Bucks Nick Nurse told a story about winning Game 1 of the D League Finals but not finishing the series at home Kawhi interrupted and joked In the D League I m done listening to this via ZachLowe_NBA ,236,7940,42376,50316,photo
CompanyJ_6621,NBA draft is TODAY Zion Williamson will officially be part of an NBA team after tonight ,88,3269,26426,29695,photo
CompanyJ_6622,The future will arrive in tonight s NBA draft ,46,1985,7651,9636,video
CompanyJ_6623,Vince Wilfork really had a field goal challenge with Carli Lloyd HardKnocks returns Aug 6 with the Raiders on HBO ,114,1574,8100,9674,video
CompanyJ_6624,Cassius Stanley should have no problem EATING at Duke next season via brhoops ,78,1013,7412,8425,video
CompanyJ_6625,Today in 2013 LeBron s dominant Game 7 performance secured the Heat going back to back Bron 37 PTS 12 REB 4 AST Heatles last chip together ,139,3164,13158,16322,video
CompanyJ_6626, His game is exactly like Dwyane Wade coming out of college Amir Hinton could be the first D II player drafted since 2005 ,122,2856,15082,17938,video
CompanyJ_6627,Dwyane Wade delivered Miami its first championship on this day in 2006 Down 0 2 to the Mavs the Heat won the next 4 Flash averaged 39 3 PPG during that streak Finals MVP at 24 ,176,6583,25470,32053,photo
CompanyJ_6628, via br_betting ,16,175,2061,2236,photo
CompanyJ_6629,The USWNT score ALREADY Lindsey Horan puts the US up 1 0 in less than 3 minutes via brfootball ,95,244,2222,2466,photo
CompanyJ_6630,Same accolade different kicks via brkicks ,42,2068,15321,17389,photo
CompanyJ_6631,Don t sleep on Gabe Cupps He s already dared Bron to a shootout contest via brhoops ,84,954,8065,9019,video
CompanyJ_6632,Another win for the USWNT The hype train rolls on via brfootball ,65,425,2952,3377,video
CompanyJ_6633,The USWNT so far Scored 18 Conceded 0 A record for goals scored in a World Cup group stage ,91,543,2677,3220,photo
CompanyJ_6634,Young bucks rolling in CLEAN to the draft via PelicansNBA ,58,2141,19546,21687,video
CompanyJ_6635, NBA DRAFT SOON tobias31 joshhart amp TaylorRooks have you covered for every lottery pick tonight Tune in at 7 30pm ET ,119,88,578,666,video
CompanyJ_6636,The USWNT get their revenge chocolate_milk ,43,44,415,459,video
CompanyJ_6637,Bol Bol pulled up like a supervillain via usatodaysports ,57,2912,15862,18774,video
CompanyJ_6638,Zion needs to be in the dunk contest this season ATT ,53,319,2162,2481,video
CompanyJ_6639,Hawks have acquired Pelicans No 4 pick in exchange for No 8 17 and 35 picks Pelicans are sending Solomon Hill No 57 pick and future second round pick per wojespn ,162,851,4044,4895,photo
CompanyJ_6640,New Orleans is STACKED in this NBADraft No 1 No 8 No 17 No 35 ,62,1435,7469,8904,photo
CompanyJ_6641,Wolves are sending No 11 pick and Dario Saric to Suns for No 6 pick per wojespn ,80,511,3453,3964,photo
CompanyJ_6642, 100K watch for Zion on draft night Power moves via darrenrovell ,65,2646,20094,22740,video
CompanyJ_6643,It s time NBADraft ,19,699,3433,4132,photo
CompanyJ_6644, CamReddish reveals why CAMFAM Mama Jones TGBTG and the Norristown N make up his JCPenney Draft Day suit From B R x JCPenney ,125,221,938,1159,video
CompanyJ_6645, Underdog drehunter_ reveals why Skills Over Politics and his 215 roots grace his JCPenney Draft Day suit From B R x JCPenney ,126,74,399,473,video
CompanyJ_6646, tobias31 and joshhart are in studio chopping it up with taylorrooks on our NBA Draft show Watch Live ,102,72,305,377,link
CompanyJ_6647,Pelicans select Zion Williamson with the No 1 pick ,51,10056,45260,55316,video
CompanyJ_6648,The future is bright for the Pelicans ,38,8396,42276,50672,photo
CompanyJ_6649,The Ja Morant Show is headed to Memphis marriottbonvoy ,55,1746,5814,7560,video
CompanyJ_6650, It s a Tennessee thing ,24,1000,3758,4758,photo
CompanyJ_6651,Knicks get RJ Barrett in the 2019 draft ,40,2999,13113,16112,photo
CompanyJ_6652,Atlanta s young core gets deeper Hawks via Pels and Lakers select De Andre Hunter with the No 4 pick in the NBA draft ,118,666,2780,3446,video
CompanyJ_6653,Cleveland gets another PG Cavs select Darius Garland with the No 5 pick ,72,782,3606,4388,video
CompanyJ_6654,Culver City is headed to Minnesota Wolves via Suns select Jarrett Culver with the No 6 pick ,92,848,3221,4069,video
CompanyJ_6655,Unforgettable moment for Zion and his mom after getting picked No 1 overall via NBAonTNT ,89,2829,14647,17476,link
CompanyJ_6656,Chicago gets its point guard Bulls select Coby White with the No 7 pick ,72,1891,7738,9629,video
CompanyJ_6657,Someone get Coby White a bigger hat ,36,908,5989,6897,photo
CompanyJ_6658, I ll take a drink to that joshhart took a sip soon as NOLA drafted Zion ,73,214,1393,1607,video
CompanyJ_6659,Cam is headed to the A Hawks select Cam Reddish with the No 10 pick ,68,1035,3886,4921,video
CompanyJ_6660,Zion RJ amp Cam make history ,29,1143,4767,5910,photo
CompanyJ_6661,ATL got themselves an exciting young core Trae Young John Collins Kevin Huerter De Andre Hunter Cam Reddish ,108,4525,21671,26196,photo
CompanyJ_6662,That speed size explosion At that age JoshHart and tobias31 say LeBron is the only comparison for Zion Watch live ,114,119,834,953,video
CompanyJ_6663,Heat select Tyler Herro with the No 13 pick ,44,1476,6710,8186,video
CompanyJ_6664,Ice Trae welcomed Cam to the Hawks on FaceTime via ChrisKirschner ,66,578,3778,4356,video
CompanyJ_6665,RJ s New York state of mind ,28,622,4327,4949,photo
CompanyJ_6666,Donovan Mitchell apparently got picked high because he DESTROYED joshhart in a pre draft workout ,97,1232,7842,9074,video
CompanyJ_6667,Dame dropped the Bagley diss track ,35,2434,12472,14906,link
CompanyJ_6668,Pelicans Lakers next year When I see kylekuzma on the court I m tryna bust his ass After that we ll have a glass of wine ,121,3687,30653,34340,video
CompanyJ_6669,Nassir off the board Blazers select Nassir Little with the No 25 pick ,70,479,2835,3314,video
CompanyJ_6670,Kevin Porter Jr gets drafted by Cavs via Bucks with the No 30 pick Here s a look back at his incredible journey ,112,1861,7755,9616,video
CompanyJ_6671,Coby White reacts to his teammate Cam Johnson getting drafted at No 11 via NBATV ,81,12877,73441,86318,video
CompanyJ_6672,Still on the board ,19,571,5756,6327,photo
CompanyJ_6673,Bol Bol is headed to the Nuggets carrying on his father s legacy ,65,4233,30247,34480,photo
CompanyJ_6674,All love for Bol Bol via BenGolliver ,37,1319,11480,12799,video
CompanyJ_6675,Bol Bol has a chip on his shoulder ,35,2077,13607,15684,photo
CompanyJ_6676,Emotional night for Zion and his family via NBAonTNT ,53,1615,11059,12674,video
CompanyJ_6677,From bodybuilding to hoops Woody Belfort is a multisport star with cerebral palsy ,82,1800,10034,11834,video
CompanyJ_6678,Fernando Torres was too crafty in his prime via brfootball ,59,395,3171,3566,video
CompanyJ_6679,Ja Morant s No 1 pick Mom s spaghetti ATT ,42,214,1838,2052,video
CompanyJ_6680, Dame_Lillard vs MB3FIVE ,25,1412,10155,11567,link
CompanyJ_6681,Jordan Bone s family wanted to sympathize with him about not being drafted until it HAPPENED with the 57th pick Via 1st_blackpope ,130,9145,39026,48171,video
CompanyJ_6682,Mbappe s first World Cup goal came a year ago today At 19 he became France s youngest goalscorer at a major tournament ,119,311,2894,3205,photo
CompanyJ_6683,For Father s Day Kenjon Barner gifted his Super Bowl ring to his dad His reaction was everything via KBDeuce4 ,110,1496,9360,10856,video
CompanyJ_6684,In his 9th season LeBron won his first NBA title on this day 4 1 vs OKC s KD Russ Harden trio Finals MVP 28 6 PTS 10 2 REB 7 4 AST Opening words postgame It s about damn time ,175,1177,5855,7032,photo
CompanyJ_6685,Kawhi couldn t hold in his smile during this standing O in Toronto via MLB ,75,2795,29400,32195,video
CompanyJ_6686,Little man s bat flip was hysterical via j_c_a_1 Instagram ,59,10682,50250,60932,video
CompanyJ_6687, ,1,571,6069,6640,photo
CompanyJ_6688,Tacko Fall signs Exhibit 10 contract with Celtics per DraftExpress ,67,1978,10177,12155,photo
CompanyJ_6689,Kawhi s a fun guy at baseball games too ,40,1034,16473,17507,photo
CompanyJ_6690,Zion vs RJ NBA Summer League July 5 2019 Las Vegas NV ,54,1322,10039,11361,photo
CompanyJ_6691,Zion doesn t need much to keep him grounded via NBATV ,54,377,3752,4129,video
CompanyJ_6692,Ja Morant knows the perfect fit for any occasion From tissot x B R ,67,103,1047,1150,video
CompanyJ_6693,Zion s favorite Avengers character is Thanos Makes sense via NBATV ,67,1960,16030,17990,video
CompanyJ_6694,He called him out then dropped a bucket on his head via leyt_splash IG ,71,7059,47619,54678,video
CompanyJ_6695,New Jersey Devils select USHL center Jack Hughes No 1 overall in the 2019 NHL draft ,84,153,1250,1403,photo
CompanyJ_6696,Rangers fans Knicks fans Loving RJ Barrett via NYRangers ,57,340,2974,3314,video
CompanyJ_6697,From Bron amp D Wade Bronny amp Zaire via DwyaneWade h t brhoops ,65,751,5153,5904,video
CompanyJ_6698,When you can t dunk get yourself a ramp via edenstrickshots IG ,63,448,3750,4198,video
CompanyJ_6699,Franchise changers ,19,2824,30842,33666,photo
CompanyJ_6700,Eight years later ,18,674,8472,9146,photo
CompanyJ_6701,He wasn t ready for the nutmeg via ferjani_safi Instagram ,58,1886,12583,14469,video
CompanyJ_6702,Both 31 Hakeem Olajuwon and Patrick Ewing went at it in the 94 Finals The Dream led all scorers in every single game Pat set the Finals record for most blocks 30 Rockets secured their first chip in Game 7 on June 22 ,216,438,3084,3522,photo
CompanyJ_6703,Baker and Saquon bet a chain on the ROY race and well ,54,407,5178,5585,photo
CompanyJ_6704,The Big Easy gonna be a show this season ,41,849,10387,11236,photo
CompanyJ_6705,Two years since Liverpool signed MoSalah 71 goals in 104 games Champions League winner 2x Premier League Golden Boot via brfootball ,132,620,5668,6288,video
CompanyJ_6706,What a moment last night between Pujols and Molina in St Louis Brothers forever ,80,547,6641,7188,photo
CompanyJ_6707,Chris Paul reminisces about the court that started it all Make sure to celebrate Go Hoop Day on 6 23 From BR x StateFarm ,121,180,1214,1394,video
CompanyJ_6708, I m drawing pictures of goats Jimmy in his art bag today via JimmyButler NSFW ,79,1599,13662,15261,video
CompanyJ_6709,R J Hampton chose to go pro in New Zealand instead of attending Kansas and it could change the entire game I think I m building a new pathway ,142,157,1645,1802,photo
CompanyJ_6710,Donovan Mitchell giving his friend and Warriors draft pick Eric Paschall the motivation to make it in the NBA via CAA_Basketball ,129,958,8009,8967,video
CompanyJ_6711,Defenseman P K Subban traded from Predators to Devils per PierreVLeBrun ,72,444,2063,2507,photo
CompanyJ_6712,Raptors superfan Nav wants the people of the city to treat Kawhi the Toronto way via globalnewsto ,98,1155,8687,9842,video
CompanyJ_6713,Russ ready for date night via DangeRussWilson ,46,158,1958,2116,video
CompanyJ_6714,PUJOLS TAKES THIS ONE FOR A RIDE AT BUSCH St Louis fans still want a curtain call eight years later via FSMidwest ,114,1248,7809,9057,video
CompanyJ_6715,He pulled a bat out of his pants and then hit a homer via kaipo panui IG ,73,21600,98313,119913,video
CompanyJ_6716, USMNT dominates again Aaron Long and Gyasi Zardes score 2 goals each in their 6 0 rout over Trinidad ,102,326,2672,2998,photo
CompanyJ_6717,Shaq says he wouldn t develop a three if he played in the league today I m not gonna do what everybody else does Everyone else is gonna have to try to stop me You don t want that funk down low via SpeedyMorman ,210,5001,33437,38438,photo
CompanyJ_6718,This was pure filth from cpulisic_10 via FOXSoccer ,51,1522,9938,11460,video
CompanyJ_6719,Chris Paul crossing kids up to get ready for GoHoopDay Get out and play today statefarm ,88,220,2259,2479,video
CompanyJ_6720,AD wore a shirt that said That s all folks to his last game with the Pelicans Alvin Gentry on the Lakers trade That s a haul folks via AndrewDoak_WWL ,150,1729,13150,14879,video
CompanyJ_6721,Josh Smith and Royce White got into it last night at the thebig3 ,65,985,6207,7192,video
CompanyJ_6722,The 2011 draft changed the league eight years ago today Cavs drafted Kyrie No 1 Kawhi George Hill trade Kemba went No 9 off NCAA run Klay picked one spot after Jimmer Jimmy Butler taken 30th IT picked last 60th ,211,3596,21885,25481,photo
CompanyJ_6723,He scored a free kick from the opposite half via guardian_sport ,64,7957,37225,45182,video
CompanyJ_6724,Nick Nurse is untouchable right now Full blown rock star via arkellsmusic ,74,496,3808,4304,video
CompanyJ_6725,LaDainian Tomlinson turns 40 today One of the greatest ever HOF 2006 MVP 2x rushing leader 3x First Team All Pro Season TD record 31 Season rushing TD record 28 Season points record No 2 all time rushing TD No 6 all time rushing yards ,235,5403,26192,31595,photo
CompanyJ_6726,Bron putting up shots on the set of Space Jam 2 via James Goldstein IG ,71,5060,35840,40900,video
CompanyJ_6727,RJ s intro at the Garden will give you chills via nyknicks ,59,20152,105381,125533,video
CompanyJ_6728,Kawhi Leonard is declining his 21 3M player option with Raptors and is seriously considering re signing per ChrisBHaynes ,121,4625,25536,30161,photo
CompanyJ_6729,Back to back to back walk off HRs for the Dodgers First time ever done by three rookies via MLBPipeline ,104,1275,5544,6819,video
CompanyJ_6730,Marta s speech to the next generation of Brazilian girls is incredible via FOXSoccer ,85,1241,5060,6301,video
CompanyJ_6731,Grown man move via Raul__Alvarez__ ,35,1136,9055,10191,video
CompanyJ_6732,Udonis won t close the door on a 17th season It makes sense why most think I should retire at 39 Cause most would Cause most are average minded I ll sleepwalk into a double double ,180,2409,15579,17988,photo
CompanyJ_6733,One of a kind Happy 32nd birthday to Leo Messi via brfootball ,62,1681,10432,12113,photo
CompanyJ_6734,27 years ago today the Magic drafted Shaq No 1 out of LSU League was never the same via NBAonTNT ,97,9425,50731,60156,video
CompanyJ_6735,Kemba s got a career changing decision in front of him this summer ,67,3135,15908,19043,video
CompanyJ_6736,7 x 2 3 via Cristiano ,22,1237,10725,11962,photo
CompanyJ_6737,Dominant USWNT via brfootball ,30,175,1336,1511,photo
CompanyJ_6738,Harden s season was historic but the argument for Giannis as MVP is too strong NBAAwards ,89,723,3534,4257,video
CompanyJ_6739,Durant and Kyrie have reportedly met twice recently to discuss their desire to continue their careers on the same team League exec also says KD is really pissed off at the Warriors following his Achilles injury per RicBucher ,225,4816,21828,26644,photo
CompanyJ_6740,New favorite in the race for KD BROOOOOKLYN via br_betting ,59,1192,5508,6700,photo
CompanyJ_6741,WWWW The USWNT are through to the World Cup quarterfinals ,58,630,4183,4813,photo
CompanyJ_6742,Next Reigning champions vs the hosts via brfootball ,52,705,4490,5195,photo
CompanyJ_6743,These fifth graders got to watch USWNT vs Spain at school and went wild for the win ,84,202,2127,2329,video
CompanyJ_6744,FSU football was Clemson before Clemson under Jimbo Fisher until it all fell off the cliff Now Willie Taggart is trying to clean up his mess ,141,176,863,1039,photo
CompanyJ_6745,Ref was determined to get the ball down via ellie powell IG ,60,6504,47075,53579,video
CompanyJ_6746,Blazers are trading Evan Turner to the Hawks for Kent Bazemore per wojespn ,75,1193,7260,8453,photo
CompanyJ_6747, AaronDonald97 passing it on Nobody better to learn technique from via EdOBrien247 ,83,1265,9080,10345,video
CompanyJ_6748,Through all the struggles and comparisons Trae Young heard it all and overcame NBAAwards ,89,1078,5368,6446,video
CompanyJ_6749,Chris Paul was cooking everybody and letting them hear about it GoHoopDay x B R merch available in limited quantities Shop ,123,361,2449,2810,video
CompanyJ_6750,Luka s crazy fadeaway to tie it D Wade s absurd buzzer beater Doc calling timeout to honor Dirk D Rose s 50 point game The Russ 20 20 20 for Nipsey Who will win the HoHighlights Moment of the Year at tonight s NBAAwards ,220,1791,11402,13193,video
CompanyJ_6751,LEGO Kawhi is still clutch in Game 7 via goldyeller ,52,1577,8756,10333,video
CompanyJ_6752, WHO WANTS TO GO TO SUMMER LEAGUE Enter to win ,47,18,190,208,link
CompanyJ_6753,Giannis looking like an MVP heading into the NBAAwards via NBAonTNT ,68,993,9253,10246,video
CompanyJ_6754, Bout that time NBAAwards ,26,172,1594,1766,photo
CompanyJ_6755,Shaq wyd NBAAwards ,19,9446,43410,52856,video
CompanyJ_6756,Luka continues to rack up the hardware NBAAwards ,49,3812,18276,22088,photo
CompanyJ_6757,Spicy P stepped his game up in 2019 to get Most Improved ,57,1572,8665,10237,photo
CompanyJ_6758,Pascal Siakam pays tribute to his late father He had this crazy dream People back home never believed in him and he always believed NBAAwards ,142,2707,16316,19023,video
CompanyJ_6759,Lou Will ties up J Crossover for most 6th Man of the Year awards of all time ,77,2167,12079,14246,photo
CompanyJ_6760,They didn t have to do Shaq like that NBAAwards ,48,6957,33526,40483,video
CompanyJ_6761,D Rose s 50 point game wins the HoHighlights Moment of the Year Award ,70,5259,24792,30051,photo
CompanyJ_6762, Make your mess your message Robin Roberts wins the Sager Strong award ,71,1337,6516,7853,video
CompanyJ_6763,Back to back Rudy Gobert wins his second DPOY ,46,2332,15627,17959,photo
CompanyJ_6764,Hasan Minhaj just dunked on James Harden ,41,5227,31008,36235,video
CompanyJ_6765,Kawhi and the Clippers have a meeting tentatively scheduled for July 2nd per TheFrankIsola ,91,736,4013,4749,photo
CompanyJ_6766,Your 2019 NBA MVP Giannis Antetokounmpo ,40,16145,65370,81515,photo
CompanyJ_6767,From undiscovered gem to NBA MVP What a journey its been for Giannis ,69,8557,42441,50998,video
CompanyJ_6768, M V P BurnaBoy 34 AfricanGiant ,32,4250,11470,15720,video
CompanyJ_6769,Giannis gives his MVP speech Powerful ,38,27978,121888,149866,video
CompanyJ_6770,Challenge completed ,20,10109,61411,71520,photo
CompanyJ_6771,Incredible moment Incredible player MVP ,40,2009,15781,17790,photo
CompanyJ_6772,NBA Champion Toronto MVP Nigeria Greece MIP Cameroon ROY Slovenia DPOY France A global game ,92,19724,84100,103824,photo
CompanyJ_6773, Every day that I step on the floor I always think about my dad Giannis didn t lack any motivation to win this year s MVP ,122,6246,39564,45810,video
CompanyJ_6774, WONDER WOMEN We teamed up with eight game changing artists and designers to create their dream soccer jerseys Cop now ,119,772,3706,4478,photo
CompanyJ_6775,On to the next Mamba Mentality Challenge ,41,1046,9851,10897,photo
CompanyJ_6776,10 years ago today the 2009 class shook up the landscape of the league Blake 1st Beard 3rd Steph 7th DeMar 9th ,111,1989,12955,14944,video
CompanyJ_6777,Kyrie said he was coming back Then he said to ask him July 1 It s almost that time ,83,3029,16957,19986,video
CompanyJ_6778,This is what it s all about Gritty surprises this 7 year old who just got a custom prosthetic leg of the mascot ,112,1147,10038,11185,video
CompanyJ_6779,Magic wouldn t mind seeing D Lo return to the Lakers ,53,1308,12515,13823,photo
CompanyJ_6780,Mahomes no look Saquon s Superman Hop s cyclone The next generation has arrived brgridiron ,91,339,1976,2315,video
CompanyJ_6781,Mike Trout once flew to an Eagles game and the pilots left the cockpit just to talk to him midflight Why the superstar turned down a potential homecoming ,154,124,1091,1215,photo
CompanyJ_6782,Celtics are emerging as a stealth suitor to land Kemba Walker per TheSteinLine ,79,1447,9053,10500,photo
CompanyJ_6783,Masai shares the heartfelt moment with DeRozan in return to Toronto this season Via TSN_Sports ,95,545,5391,5936,video
CompanyJ_6784, My first jersey from a professional athlete Drew Brees welcomed Zion to the Big Easy with a special surprise brgridiron via PelicansNBA ,137,2728,16606,19334,video
CompanyJ_6785,Red Sox are slugging their way into the Wild Card race Supercuts ,65,50,293,343,video
CompanyJ_6786,Jordan Clarkson has changed agents and signed with Rich Paul and Klutch Sports per joevardon ,93,2202,16401,18603,photo
CompanyJ_6787,Mavs plan to offer Porzingis a full 5 year 158M max contract will meet on June 30th when free agency starts per ShamsCharania ,126,1935,13769,15704,photo
CompanyJ_6788,Boston and Dallas are at the front of the line for Kemba free agency sweepstakes per TheSteinLine ,98,1134,7595,8729,photo
CompanyJ_6789,There s nobody in the league like Aaron Donald He s working to keep it that way brgridiron ,91,628,4069,4697,video
CompanyJ_6790,Jimmy scored on Neymar via jimmybutler IG ,42,1355,16881,18236,video
CompanyJ_6791,Made sure to drop him before getting the bucket via khai_one2 ,62,556,4540,5096,video
CompanyJ_6792,Rockets priority for free agency is to land Jimmy Butler through a sign and trade deal with the Sixers wojespn ,111,1344,8684,10028,photo
CompanyJ_6793,Klay Thompson would be open to having a meeting with the Clippers if Warriors don t have max offer when free agency starts per wojespn ,135,3611,24693,28304,photo
CompanyJ_6794,He pressed the Y button via zacherydrake5 ,42,479,5122,5601,video
CompanyJ_6795,Jorge Soler hit the ball out of the park but it went foul via Royals ,69,505,5443,5948,video
CompanyJ_6796,Jimmy Butler wants to win and he s looking for a max after a roller coaster season This summer ,95,1346,9154,10500,video
CompanyJ_6797,One of the greatest of all time One of the most lethal scorers One of the most transcendent bigs One of the most influential guards And many important role players 16 years ago today One of the most iconic drafts in league history ,231,7668,38343,46011,photo
CompanyJ_6798,Too quick with the synchronization via PongfinityHQ ,52,280,2289,2569,video
CompanyJ_6799,KD has declined his player option and will become an unrestricted free agent this summer per wojespn ,101,8104,37144,45248,photo
CompanyJ_6800,Marcus Smart has no chill on the kids Via JoeGiza ,50,3801,21969,25770,video
CompanyJ_6801, chancetherapper came into the Chicago Sky locker room at halftime and drew up a play via wnbachicagosky ,105,1386,8115,9501,video
CompanyJ_6802,Ochocinco ordering McDonalds breakfast is jokes via ochocinco ,62,1221,8799,10020,video
CompanyJ_6803,Rings speak louder than chemistry rumors ,41,1576,13826,15402,photo
CompanyJ_6804, ,1,5006,33157,38163,photo
CompanyJ_6805,Cauliflower ear is even more gross than you think but it s also a badge of honor That s somebody I might not want to f k with He knows how to fight ,148,121,622,743,photo
CompanyJ_6806,The 1996 draft happened today WILD year for guards 76ers draft Allen Iverson with No 1 pick Bucks trade down get Ray Allen Wolves pair KG with No 4 pick Starbury Kobe gets drafted 13th by Hornets traded to LA Nash sneaks past lottery teams goes 15th to Suns ,258,1161,5837,6998,photo
CompanyJ_6807,Lakers have serious interest in acquiring D Angelo Russell this summer per ShamsCharania ,89,4507,29109,33616,photo
CompanyJ_6808,Edelman recruiting KD to Boston brgridiron ,43,570,3938,4508,photo
CompanyJ_6809,She was determined to do Aly Raisman s full Olympic routine so her dad helped make it happen via Olympics ,106,1918,11556,13474,video
CompanyJ_6810,WAYNE ROONEY OH MY GOODNESS via MLS ,36,12682,46022,58704,video
CompanyJ_6811,IT is confident he can return to his old self I m going to get back to a level that I was playing at I m excited to show what I can do again per wojespn ,153,1884,18530,20414,photo
CompanyJ_6812,Vanderbilt takes down Michigan to win their 2nd College World Series via VandyBoys ,83,400,2767,3167,video
CompanyJ_6813,Jozy Altidore with the UNREAL bicycle kick via FOXSoccer ,57,2388,13918,16306,photo
CompanyJ_6814, Giannis_An34 critiques Drake s hooping skills and compares him to Brian Scalabrine via HoHighlights ,101,1080,8436,9516,video
CompanyJ_6815,Kemba and the Hornets have sizable gaps and stalemate in talks so far ahead of free agency per ShamsCharania Competitors Celtics Knicks Mavs ,141,595,4467,5062,photo
CompanyJ_6816,Klay s put everything into the Warriors dynasty He could get a 190M reward for it this summer ,94,4007,21685,25692,video
CompanyJ_6817, All they care about is working hard and winning How the USWNT is inspiring the next generation ,96,77,671,748,video
CompanyJ_6818,Embiid was not loving the decision to go this high Via JoelEmbiid ,66,1915,15202,17117,video
CompanyJ_6819,USA vs Europe left in the World Cup knockouts via brfootball ,61,243,1764,2007,photo
CompanyJ_6820,Six years ago today the Bucks drafted a little known prospect with the No 15 pick It was his first time in America and his first time owning a suit When asked how he made it to the league Giannis said I don t really know ,221,2379,18444,20823,photo
CompanyJ_6821, Bring it back KingJames ,25,5829,34360,40189,photo
CompanyJ_6822,Why he do the kids like that via mattc3824 ,43,647,4229,4876,video
CompanyJ_6823,Anthony Davis will waive 4M trade kicker per wojespn Lakers will now have 32M in cap space ,91,3868,20749,24617,photo
CompanyJ_6824,LeBron is gifting AD his No 23 jersey per ChrisBHaynes ,55,6845,36336,43181,photo
CompanyJ_6825,Only time LeBron didn t wear No 23 in the NBA ,46,4000,30259,34259,photo
CompanyJ_6826,Kawhi intends to meet with Lakers and Clippers when free agency starts per ChrisBHaynes ,88,4848,24484,29332,video
CompanyJ_6827,Celtics are hiring former WNBA player and TV analyst Kara Lawson as an assistant coach per wojespn ,99,1596,9630,11226,photo
CompanyJ_6828,New era in the NBA Kara Lawson Celtics assistant coach Becky Hammon Spurs assistant coach Swin Cash Pels vice president of basketball ops and team development Lindsey Harding 76ers player development coach Lindsay Gottlieb Cavs assistant coach ,244,2859,9578,12437,photo
CompanyJ_6829,OBJ JuJu Tarik Lot of one handed grabs at minicamp and OTAs brgridiron ,71,285,2218,2503,video
CompanyJ_6830,The 15th anniversary of quai54wsc was a vibe Melo Russ Kemba Blake and Maya all pulled up to Paris and showed love jumpman23 BRkicks ,133,321,1482,1803,video
CompanyJ_6831,AD is taking 23 Is No 6 Bron back ,34,7017,43287,50304,photo
CompanyJ_6832,Fran Belibi out here dunking over two kids with ease via StanfordWBB ,69,562,3828,4390,video
CompanyJ_6833, I stand by the comments that I made with the exception of the expletive Megan Rapinoe on saying she s not going to the f king White House ,139,3746,19401,23147,video
CompanyJ_6834,A double up and under via JUMPMANEBIG ,38,1036,7893,8929,video
CompanyJ_6835, ,1,811,10638,11449,link
CompanyJ_6836,He really used a leaf blower to score a bucket via _milakovic_ IG ,66,1322,12200,13522,video
CompanyJ_6837,Kyrie Irving remains just as much of a target for the Lakers as Kawhi Leonard now that they have maximum cap space per TheSteinLine ,132,1593,10488,12081,photo
CompanyJ_6838,Nets not the front runners to sign Durant despite recent reports per IanBegley ,79,1223,8600,9823,photo
CompanyJ_6839,TODAY USWNT vs France in the FIFAWWC quarterfinals ,51,314,1705,2019,photo
CompanyJ_6840,Thunderstorm had Kris Bryant shook Via Cut4 ,44,760,6286,7046,video
CompanyJ_6841,GuapDad4000 knew he couldn t make a money bet that Drake liked so he made a basketball bet he was sure to win till history was made ,132,321,1973,2294,video
CompanyJ_6842,Giannis loves his new gear via Giannis_An34 ,44,1682,16651,18333,video
CompanyJ_6843,Recovery from the goalkeeper via pifen2024 IG ,46,14356,69670,84026,video
CompanyJ_6844,Kawhi proved to every critic that his championship DNA is unquestionable Can the Raptors convince him that Toronto is home in free agency ,138,627,3710,4337,video
CompanyJ_6845,LeBron on that USWNT hype via KingJames ,40,483,5535,6018,photo
CompanyJ_6846,He tried to guard Giannis 1 on 1 via MasterTes ,47,2769,21088,23857,video
CompanyJ_6847,Clayton Kershaw says his teammate Walker Buehler has the best stuff in the game He s proving it with a potential All Star appearance this year ,143,87,687,774,photo
CompanyJ_6848,Miles Bridges was getting a bucket however he wanted in the Pro Am SHEESH Via freeEGB ,86,3828,18857,22685,video
CompanyJ_6849,Reigning champions vs the hosts Come and get it via brfootball ,63,247,2348,2595,photo
CompanyJ_6850,USA fans traveling in NUMBERS to the World Cup quarterfinal vs France via AmericanOutlaws ,90,241,2026,2267,video
CompanyJ_6851,Game time for the USWNT LET S GO ,33,174,1043,1217,photo
CompanyJ_6852,Megan Rapinoe puts the USWNT up 1 0 in less than six minutes via brfootball ,76,558,2825,3383,photo
CompanyJ_6853,Warriors plan to offer Klay Thompson a 5 year 190M max contract as soon as free agency begins per wojespn ,106,1456,10466,11922,photo
CompanyJ_6854,This free kick mPinoe via FOXSoccer ,36,1311,6089,7400,photo
CompanyJ_6855, ,1,2076,15177,17253,photo
CompanyJ_6856,CP3 and D Will were drafted 14 years ago today Now they re enjoying life at the BahaMarShowdown This PG rivalry back in the day ,128,536,4941,5477,photo
CompanyJ_6857, FOR MEGAN RAPINOE Four goals in the last two games for the USWNT ,66,814,4634,5448,photo
CompanyJ_6858,Can t stop mPinoe via FOXSoccer ,32,645,3301,3946,photo
CompanyJ_6859,One step closer to the trophy The USWNT are through to the FIFAWWC semifinals via brfootball ,93,772,3276,4048,photo
CompanyJ_6860,In the semifinals for the eighth straight time The USWNT is still undefeated all time in the World Cup quarterfinals ,117,496,2825,3321,photo
CompanyJ_6861,LeBron and Anthony Davis plan to be part of Lakers free agency pitch to Kawhi per sam_amick ,92,3041,17468,20509,link
CompanyJ_6862,ICONIC via brfootball ,22,715,4741,5456,photo
CompanyJ_6863,Max Holloway just won the bottle cap challenge via BlessedMMA ,62,9529,47214,56743,video
CompanyJ_6864,Megan The Viper Rapinoe ,24,3296,20561,23857,photo
CompanyJ_6865,KD s injury won t stop him from signing wherever he wants Where will he land ,77,571,4964,5535,photo
CompanyJ_6866,That was a close one PatMcAfeeShow BahaMarShowdown ,51,689,6211,6900,video
CompanyJ_6867,Kevin Durant planning to engage Warriors Nets Clippers and Knicks at the start of free agency Sunday per wojespn ,113,658,4581,5239,photo
CompanyJ_6868,Spin made him hit the floor via Javarius_2k18 ,46,703,4927,5630,video
CompanyJ_6869,Khabib is ready for his max contract via TeamKhabib ,52,3171,21447,24618,video
CompanyJ_6870,Lakers are a true threat to sign Kawhi Leonard away from Raptors per TheSteinLine ,82,4474,26579,31053,photo
CompanyJ_6871,The goalie knew he was beat the moment he turned around to kick it via seanfatiga124 ,85,176,2418,2594,video
CompanyJ_6872, I could see Fun Guy winning an Oscar for best supporting role or lead What do you want There s space on set in Space Jam with AD here ,135,543,5239,5782,photo
CompanyJ_6873,LeBron s got a musical for this offseason Via HoHighlights Original w DaKidGowie OfficialMinks ,95,2207,7231,9438,video
CompanyJ_6874,Bronny James is really about this Fortnite life via Bronny IG ,62,4158,31443,35601,video
CompanyJ_6875,Oprah HYPE for the USWNT and can hit a solid volley via oprah ,62,284,3080,3364,video
CompanyJ_6876,Kawhi Leonard and Kevin Durant have discussed possibility of playing together per wojespn ,90,2049,15213,17262,photo
CompanyJ_6877,James Harden is enjoying his offseason via xiaxiaolou IG ,57,875,8093,8968,video
CompanyJ_6878, You coming to New York bro Kawhi has a history with fans in NY via Jerry West FB ,82,1886,11334,13220,video
CompanyJ_6879,Klay Thompson and Warriors plan to reach agreement on five year 190M max contract within the next day per ShamsCharania ,120,978,6716,7694,photo
CompanyJ_6880,Judge is a man of the people even when they re fans of the rival via MLB ,73,737,7702,8439,video
CompanyJ_6881,Teams know KD is only coming back stronger from injury even if he misses a whole season Free agency is Durant s choice afterall ,128,1303,7806,9109,video
CompanyJ_6882,England vs USA Netherlands vs Sweden The FIFAWWC semifinals are set via brfootball ,83,276,1944,2220,photo
CompanyJ_6883,The shammgod had him reaching for balance via young_salako IG ,62,11162,41129,52291,video
CompanyJ_6884,Pistons emerging as the favorite to sign Derrick Rose per TheFrankIsola ,72,1794,10534,12328,photo
CompanyJ_6885,Kemba Walker plans to commit to four year 141M max deal with Celtics at beginning of free agency per ShamsCharania ,115,6052,26586,32638,photo
CompanyJ_6886,Brazil vs Argentina and Chile vs Peru in the CopaAmerica semifinals via brfootball ,83,819,4262,5081,photo
CompanyJ_6887,Free agency is 24 hours away It s been a long time coming ,58,1536,10424,11960,photo
CompanyJ_6888,Kyrie Irving and Nets meeting in New York on Sunday motivated to move quickly towards four year 141M max deal per wojespn ,122,1364,6704,8068,photo
CompanyJ_6889,Jimmy Butler to meet with Heat on Sunday meeting with Houston likely early next week Sixers haven t ruled out sign and trade with either team per wojespn ,154,859,4746,5605,photo
CompanyJ_6890,Nets expected to renounce D Angelo Russell and allow him to become unrestricted free agent once Kyrie Irving commits to deal per wojespn ,137,1348,9004,10352,photo
CompanyJ_6891,Lakers reach out to D Angelo Russell s agent for a meeting two sides share mutual interest in a reunion per wojespn ,116,2173,14176,16349,photo
CompanyJ_6892,Happy Birthday to the late Craig Sager These moments were hysterical via NBA ,77,15552,74424,89976,video
CompanyJ_6893,Lakers fans doing their part in recruiting Kawhi via gz jr IG ,62,4532,27604,32136,photo
CompanyJ_6894,Francis Ngannou TOO DOMINANT UFCMinneapolis via ufc ,52,222,1172,1394,video
CompanyJ_6895,Nikola Vucevic plans to commit to four year 100M extension with the Magic per ShamsCharania ,92,788,6884,7672,photo
CompanyJ_6896,FREE AGENCY TONIGHT 6 p m ET ,29,8467,34790,43257,photo
CompanyJ_6897, ,1,31907,123760,155667,video
CompanyJ_6898,Brought the pingpong table onto the subway via marykarrlit ,59,1545,11830,13375,video
CompanyJ_6899, marquisegoodwin has no fear brgridiron ,40,3027,26333,29360,video
CompanyJ_6900,The USWNT breaking records off the field too via brfootball ,60,2336,15153,17489,photo
CompanyJ_6901,Had him walking away to look for it via solarjoy ,49,3308,17783,21091,video
CompanyJ_6902,76ers have very real interest in Al Horford per sam_amick ,58,661,4547,5208,photo
CompanyJ_6903,Really tried to nutmeg DwyaneWade in China Flash caught it dunked it and chucked it in the stands ,98,4813,29721,34534,video
CompanyJ_6904,Hold up ,8,1611,12378,13989,photo
CompanyJ_6905,Jimmy Butler is expected to tell MIA officials he wishes to play for the Heat tonight per ByTimReynolds ,104,2793,11544,14337,photo
CompanyJ_6906,Potential passing of the torch ,31,1897,14895,16792,photo
CompanyJ_6907,Dame is working toward a four year 196M supermax extension with Blazers per ShamsCharania ,90,1556,11682,13238,photo
CompanyJ_6908,Wolves are at the top of D Angelo Russell s wish list Minnesota is increasingly confident it can make the cap moves to land D Lo per TheSteinLine ,146,1094,6821,7915,photo
CompanyJ_6909,Celtics are showing interest in a potential three team sign and trade with the Nets and Hornets per wojespn Kemba Boston Kyrie Brooklyn Rozier Charlotte ,153,783,4361,5144,photo
CompanyJ_6910,KD S DECISION TONIGHT Durant will announce where he s going on boardroom per wojespn ,85,3968,17868,21836,photo
CompanyJ_6911,Decisions for Kawhi Leonard ,28,1506,10595,12101,video
CompanyJ_6912,The Nets seem to believe they re getting KD along with Kyrie and DeAndre Jordan tonight per TheSteinLine ,105,2924,13567,16491,photo
CompanyJ_6913,Breaking Kevin Durant is planning to sign with the Nets per wojespn ,68,16526,47573,64099,photo
CompanyJ_6914,Draymond watching KD leave ,27,59534,148781,208315,video
CompanyJ_6915, Welp ,6,26110,120460,146570,link
CompanyJ_6916,Terry Rozier has agreed to a 3 year 58M deal with the Hornets via sign and trade per ShamsCharania ,99,4223,20165,24388,photo
CompanyJ_6917,Knicks fans after the KD Kyrie announcement ,44,49736,131470,181206,video
CompanyJ_6918,It s time Let free agency officially begin ,43,3339,13169,16508,photo
CompanyJ_6919,Kemba Walker is joining the Celtics on a 4 year 141M max contract per wojespn from B R X americanexpress ,105,4151,17000,21151,video
CompanyJ_6920,JJ Redick has agreed to a 2 year 26 5M deal with the Pelicans per wojespn ,74,4854,25567,30421,photo
CompanyJ_6921,D Rose has agreed to a 2 year 15M deal with the Pistons per wojespn ,68,6971,33317,40288,photo
CompanyJ_6922,New era in Brooklyn Kyrie has officially agreed to a 4 year 142M deal with the Nets per ShamsCharania ,102,8529,33054,41583,photo
CompanyJ_6923,Mavs and Porzingis have reached agreement on a new 5 year 158 million deal per TheSteinLine ,92,2706,12083,14789,photo
CompanyJ_6924,Trevor Ariza has agreed to a 2 year 25M deal with the Kings per ShamsCharania ,78,1682,8379,10061,photo
CompanyJ_6925,Ricky Rubio has agreed to a 3 year 51M deal with Suns per ShamsCharania ,72,1843,9486,11329,photo
CompanyJ_6926,Pacers trade 1st and 2nd round picks to Bucks for Malcolm Brogdon per wojespn Brogdon has agreed to 4 year 85M contract with Indiana ,133,1200,5344,6544,photo
CompanyJ_6927,Utah could be dangerous next season Bojan Bogdanovic has agreed to a 4 year 73M deal with the Jazz per wojespn ,111,2169,12516,14685,photo
CompanyJ_6928,Damian Lillard signs a 4 year 194 supermax extension with the Blazers per ChrisBHaynes NSFW ,92,4512,22205,26717,video
CompanyJ_6929,Kawhi while everyone else is making their free agency decisions ,64,8669,44534,53203,photo
CompanyJ_6930,Tobias Harris has agreed to 5 year 180M deal to stay with 76ers per wojespn ,76,1812,10728,12540,photo
CompanyJ_6931,Knicks were not fully prepared to offer KD a full max contract with concerns over his recovery per ramonashelburne ,115,3345,17056,20401,photo
CompanyJ_6932,Knicks make a signing Julius Randle has agreed to a 3 year 63M deal with New York per wojespn ,94,2580,17097,19677,photo
CompanyJ_6933,It s too quiet out here ,24,2139,17370,19509,photo
CompanyJ_6934,D Lo and KAT have been in contact since yesterday Wolves canvassing the league to find a trade partner to open cap space per TheSteinLine ,138,746,5845,6591,photo
CompanyJ_6935,Kawhi won t meet with any teams today will ramp up the processs over the next couple days per ChrisBHaynes ,107,1702,11702,13404,photo
CompanyJ_6936,Heat are finalizing a sign and trade with 76ers for Jimmy Butler per wojespn ,77,4955,19333,24288,photo
CompanyJ_6937,Al Horford has agreed to a 4 year 109M deal with the 76ers per wojespn ,71,3813,18943,22756,photo
CompanyJ_6938,Brooklyn s Big 3 from B R x americanexpress ,44,5711,26508,32219,video
CompanyJ_6939,Goran Dragic is staying in Miami He was not included as part of the Heat Mavs deal per ShamsCharania ,101,1210,5942,7152,photo
CompanyJ_6940,Warriors have strong interest in acquiring D Lo in a sign and trade ShamsCharania ,82,1529,9000,10529,photo
CompanyJ_6941,Warriors and Nets are close to a D Lo sign and trade per ShamsCharania ,71,1636,9527,11163,link
CompanyJ_6942,D Lo is a Warrior Wow Golden State has acquired D Angelo Russell in a sign and trade deal worth 117M over 4 years per wojespn ,126,25325,79573,104898,photo
CompanyJ_6943,The rest of the NBA seeing the Warriors trade for D Lo ,55,14645,53424,68069,video
CompanyJ_6944,Andre Iguodala has been traded to the Grizzlies for future picks per wojespn ,77,3889,20411,24300,photo
CompanyJ_6945,One day can change everything ,30,4369,21985,26354,photo
CompanyJ_6946,D Lo to the Warriors What a wild Day 1 of free agency so far from B R x americanexpress ,88,2990,15670,18660,video
CompanyJ_6947,Bobby Portis has agreed to a 2 year 31M deal with the Knicks per wojespn ,73,825,6020,6845,photo
CompanyJ_6948,Murray got paid Jamal Murray and the Nuggets have agreed to a 5 year 170M max contract extension per ShamsCharania ,115,2676,17559,20235,photo
CompanyJ_6949,There s been 3 billion in new money given to players on Day 1 of NBA free agency h t jgsiegel ,94,3962,18694,22656,photo
CompanyJ_6950,Pat Beverley has agreed to a 3 year 40M deal to stay with the Clippers per wojespn ,83,945,7857,8802,photo
CompanyJ_6951,New look Indy ,14,2520,19276,21796,photo
CompanyJ_6952,That new Philly five ,21,5425,30500,35925,photo
CompanyJ_6953,KD Nets Kyrie Nets D Lo Warriors Kemba Celtics Jimmy Heat Horford 76ers Tobias 76ers Middleton Bucks Redick Pelicans Porzingis Mavs Bogdanovic Jazz Brogdon Pacers Randle Knicks Rose Pistons And now we wait for the Board Man ,224,8049,37975,46024,photo
CompanyJ_6954,This year s NBA2K cover athletes Brow Wade Legend Edition NBA2K20 ,66,10602,50504,61106,photo
CompanyJ_6955,KD never considered going to the Knicks alone Zero chance contract terms were the reason he didn t choose NYK he just decided to join Kyrie in Brooklyn per HowardBeck ,167,893,4891,5784,photo
CompanyJ_6956,KD s brother already has the Brooklyn jersey via tdurant IG ,60,1619,10948,12567,photo
CompanyJ_6957, They will trade him It s just a matter of when thesteinline gives his take on Warriors D Lo via BRlive dpshow ,111,1000,4807,5807,video
CompanyJ_6958,KD reportedly felt like a distant second fiddle to Steph in Golden State per MarcJSpearsESPN ,93,2027,13674,15701,photo
CompanyJ_6959,Seth Curry is going to the Mavs per wojespn 4 years 32M ,56,2480,17914,20394,photo
CompanyJ_6960,Portland Miami deal Heat receive Moe Harkless Meyers Leonard Blazers receive Hassan Whiteside via wojespn ,106,3901,18350,22251,photo
CompanyJ_6961,KD speaks on free agency ,25,1374,8112,9486,photo
CompanyJ_6962,Breaking Klay and the Warriors agree to a 5 year 190M max deal per multiple reports ,84,8945,52612,61557,video
CompanyJ_6963,Whiteside seems HYPED about getting traded to Portland via youngwhiteside ,74,3943,22907,26850,video
CompanyJ_6964,Kyrie linked up with KD in Brooklyn after two wild seasons in Boston ,69,371,2567,2938,video
CompanyJ_6965,Newest addition in Portland ,28,3747,26354,30101,photo
CompanyJ_6966,Four goals in the last two games mPinoe via brfootball ,55,241,3098,3339,photo
CompanyJ_6967,Will Bynum broke out a fake Shammgod at thebig3 ,48,5593,31418,37011,video
CompanyJ_6968,15 year old prodigy Coco Gauff beat one of her idols Venus Williams in straight sets at Wimbledon today After the match she was overcome with emotion and thanked Venus for inspiring her via Wimbledon ,200,5445,25099,30544,video
CompanyJ_6969,Neymar s dad and reps will be in Barcelona tomorrow to negotiate a potential transfer from PSG per marcelobechler and Esp_Interativo via brfootball ,148,636,3301,3937,photo
CompanyJ_6970,Joe Lacob says no Warrior will wear No 35 as long as he is co chairman of the team ,83,1760,12189,13949,photo
CompanyJ_6971, jaytatum0 pulled up to quai54wsc in Paris one of the world s biggest streetball tournaments and surprised these kids with a truck full of new Jumpman23 New Sneaker Shock brkicks ,179,315,1727,2042,video
CompanyJ_6972, KembaWalker in the Celtics green for the first time via Chad_Amaral ,69,3651,23554,27205,video
CompanyJ_6973,You get a bag you get a bag you get a bag NBA players signed for more than 3B on the first day of free agency ,110,2760,15671,18431,video
CompanyJ_6974,Breaking Angels announce pitcher Tyler Skaggs has passed away at the age of 27 ,79,6470,24199,30669,photo
CompanyJ_6975,Jimmy Butler trade is complete in 4 team deal with 76ers Heat Blazers and Clippers per wojespn ,95,835,5035,5870,photo
CompanyJ_6976,Jimmy Butler turned down a 5 year max offer from the Sixers to go to the Heat per tomhaberstroh ,96,2839,15195,18034,photo
CompanyJ_6977,Jordan Bell has agreed to deal with the Timberwolves per ChrisBHaynes ,70,1599,12825,14424,photo
CompanyJ_6978,Refreshing the TL waiting for Kawhi news to drop ,49,12607,45091,57698,photo
CompanyJ_6979,Isaiah Thomas has agreed to a 1 year deal with the Wizards per wojespn ,71,3096,26669,29765,photo
CompanyJ_6980, Still no Kawhi news ,21,6600,37702,44302,photo
CompanyJ_6981,TODAY England vs USWNT For a spot in the World Cup final ,57,926,6344,7270,photo
CompanyJ_6982, NEW York Knicks ,17,2041,14560,16601,photo
CompanyJ_6983,D Wade wasn t fooled in the slightest via timmartin_tx ,55,26310,132103,158413,video
CompanyJ_6984, alexmorgan13 looks to add to her resume on her 30th birthday via brfootball ,77,580,5404,5984,photo
CompanyJ_6985, Squatting 675 lbs Box jumps with 50s Myles Garrett is built different brgridiron via MylesLGarrett ,100,3486,23892,27378,video
CompanyJ_6986,Three players in England vs USA are tied for the lead in the World Cup Golden Boot race ,88,76,826,902,photo
CompanyJ_6987,Ben Simmons offered 5 year 168M max from 76ers expected to work through details per wojespn ,92,1493,11583,13076,photo
CompanyJ_6988,Megan Rapinoe is not starting vs England today She s scored four goals in the last two games ,93,181,1171,1352,link
CompanyJ_6989,Bones Jones just leveled up the bottlecap challenge via JonnyBones ,67,6808,33124,39932,video
CompanyJ_6990,30 mins to kickoff ,19,134,1258,1392,link
CompanyJ_6991,Rapinoe is not on the field warming up for match against England Via alywagner ,79,99,927,1026,video
CompanyJ_6992, USA vs ENG It s time ,22,442,3863,4305,photo
CompanyJ_6993,Press puts USA up 1 0 ,22,641,3797,4438,photo
CompanyJ_6994,Press starts in place for Rapinoe Picking up where the legend left off last game via FOXSoccer ,95,878,4792,5670,photo
CompanyJ_6995, roselavelle nutmeg via FOXSoccer ,34,292,1830,2122,photo
CompanyJ_6996,ALEX MORGAN 2 1 USA ,20,2383,15505,17888,photo
CompanyJ_6997, ,1,10781,60649,71430,photo
CompanyJ_6998,HAPPY BIRTHDAY alexmorgan13 via FOXSoccer ,42,1183,5747,6930,photo
CompanyJ_6999,What A Save via TelemundoSports ,32,585,4492,5077,video
CompanyJ_7000,NO GOAL ,8,456,3433,3889,photo
CompanyJ_7001,NAEHER SAYS NO via FOXSoccer ,29,2536,10491,13027,photo
CompanyJ_7002,The USWNT are headed back to the World Cup final ,49,5488,20679,26167,photo
CompanyJ_7003,Saved the victory Cold blooded ,31,1379,12306,13685,photo
CompanyJ_7004,Can t be stopped Alex Morgan is the first player in FIFA WWC history to score on her birthday h t FOXSoccer ,108,668,6428,7096,photo
CompanyJ_7005,Willie Cauley Stein has agreed to a deal with the Warriors per ThompsonScribe ,78,3360,16458,19818,photo
CompanyJ_7006,Megan Rapinoe had minor hamstring strain expecting to be ready to go for World Cup Final on Sunday per GrantWahl ,113,369,3523,3892,photo
CompanyJ_7007,Potent offense Two aces Clutch hitting including two walk offs last week Watch out for the red hot Astros Supercuts ,116,46,306,352,video
CompanyJ_7008,Bol Bol has a tattoo of Squidward and it s not even his favorite character from Spongebob via katywinge ,104,3835,28224,32059,video
CompanyJ_7009,Vlad Jr practicing for the HR Derby SHEESH Via baseballexis ,60,2274,12486,14760,video
CompanyJ_7010,Le Veon paid enough for a car Plax offered an outdoor kitchen Eli funded a family vacation There s no price too high for a star to get his jersey number via BRgridiron ,168,359,2233,2592,video
CompanyJ_7011,Final result was a lot to a little Via MrMet ,45,214,1753,1967,video
CompanyJ_7012, ,1,94,1488,1582,link
CompanyJ_7013,Patrick Corbin wearing No 45 to honor Tyler Skaggs writes the number on the mound for his late friend via Cut4 ,111,1601,15408,17009,video
CompanyJ_7014,RJ vs Zion This Friday via nyknicks ,36,4236,31919,36155,video
CompanyJ_7015,Angels and Rangers hold moment of silence for late pitcher Tyler Skaggs before tonight s game via FoxSportsWest ,112,905,5770,6675,video
CompanyJ_7016, I did it dad The best bottle cap challenge yet via korbin_jackson ,67,21782,98641,120423,video
CompanyJ_7017,Another missed shot at an international trophy for Messi via brfootball ,72,1648,12554,14202,photo
CompanyJ_7018,This team USWNT via brfootball ,31,1196,12071,13267,photo
CompanyJ_7019,Jimmy is gonna fit in perfectly in Miami via OmarKelly MRMiamiMarvin ,69,8668,51650,60318,video
CompanyJ_7020,Legendary alexmorgan13 via BRFootball ,38,1108,9679,10787,video
CompanyJ_7021,Drake is said to be mounting his own recruiting campaign to keep Kawhi in the 6 per TheSteinLine ,97,533,6279,6812,photo
CompanyJ_7022, wojespn says he was told not to expect a Kawhi decision until at least later today possibly tomorrow on July 4th ,114,4965,27605,32570,photo
CompanyJ_7023,Boban is signing with the Mavs per ShamsCharania ,49,1171,10629,11800,photo
CompanyJ_7024,This is gonna be fun via PelicansNBA ,37,4990,35654,40644,video
CompanyJ_7025,Messi after Argentina got knocked out of CopaAmerica via brfootball ,68,1775,6025,7800,video
CompanyJ_7026,End of an era ,14,1207,13301,14508,photo
CompanyJ_7027,Markieff Morris has agreed to a deal with the Pistons per ShamsCharania ,72,780,6455,7235,photo
CompanyJ_7028,Class of 2021 top three prospect Terrence Clarke killed it at the NBPA TOP 100 Camp Coach and former NBA player Ricky Davis thinks he was one of the best players there ,168,342,1886,2228,video
CompanyJ_7029, ,1,2559,18062,20621,photo
CompanyJ_7030,Former Giants QB Jared Lorenzen has died at the age of 38 ,58,4469,21367,25836,photo
CompanyJ_7031,Coco continues her historic run 15 year old Coco Gauff is heading to the 3rd round of Wimbledon ,96,1371,7175,8546,video
CompanyJ_7032,Suns are planning on buying out Kyle Korver per wojespn Lakers Sixers and Bucks are frontrunners to sign the sharpshooter ,122,676,5409,6085,link
CompanyJ_7033,USA vs the Netherlands Sunday s FIFAWWC final is set ,53,1511,8691,10202,photo
CompanyJ_7034, KawhiWatch Hour 72 ,20,6328,33128,39456,photo
CompanyJ_7035,Atletico Madrid have signed 19 year old Joao Felix in one of the biggest transfers ever and he s taken Antoine Griezmann s number via brfootball ,145,862,6944,7806,photo
CompanyJ_7036,Your favorite rappers are putting up buckets on the basketball court ,69,635,5052,5687,video
CompanyJ_7037,Knicks reportedly cancelled a meeting with Kawhi Leonard in fear of missing out on other free agents per NYPost_Berman ,119,5725,34411,40136,photo
CompanyJ_7038,Weston Mckennie RIGHT FROM THE JUMP via FOXSoccer ,50,488,3818,4306,photo
CompanyJ_7039,Kawhi is not expected to make free agency decision until next few days He and his reps are taking their time before deciding per JabariJYoung ,142,1700,11692,13392,photo
CompanyJ_7040, cpulisic_10 is everywhere via USMNT ,37,406,3753,4159,photo
CompanyJ_7041,We re in for a treat in the Gold Cup final via brfootball ,58,4049,18873,22922,photo
CompanyJ_7042,Chelsea has officially appointed club legend Frank Lampard as manager via brfootball ,85,931,7861,8792,photo
CompanyJ_7043,KD s decision to go to Brooklyn isn t the first time he shook up the league Three years ago today he left OKC for the Bay and the rest is history ,146,931,7718,8649,video
CompanyJ_7044, FourthOfJuly today World Cup final and Gold Cup final on Sunday Big week ,74,553,4212,4765,photo
CompanyJ_7045,Donnie Yen blindfolded in the shirt of champions The force is strong on this one via DonnieYenCT ,97,1336,7284,8620,video
CompanyJ_7046,Big man was not ready for all that from RockyTruth Via brhoops ,63,398,3048,3446,video
CompanyJ_7047,Arjen Robben has officially announced his retirement from soccer What a career Via brfootball ,94,1715,7277,8992,photo
CompanyJ_7048, Oh he in the post The dog really went for the block via iamsaucee IG ,70,19002,80186,99188,video
CompanyJ_7049,Giannis view in Greece looks like a painting via Giannis_An34 ,62,8424,59915,68339,video
CompanyJ_7050,Not sure if that s how the bottlecapchallenge goes via TheOregonDuck ,69,1815,9761,11576,video
CompanyJ_7051,Champ again 71 hot dogs for the legend Joey Chestnut ,53,2261,12504,14765,photo
CompanyJ_7052,Michael Porter Jr suffered a left knee sprain during a scrimmage unlikely to play in Vegas Summer League per msinger ,117,1608,10680,12288,photo
CompanyJ_7053,The moves on Serena Williams advances to the 3rd round of Wimbledon ,68,600,3329,3929,video
CompanyJ_7054,The Bottlecapchallenge keeps leveling up via Iamzeku ,53,5068,24648,29716,video
CompanyJ_7055,Everyone at their BBQs refreshing Twitter for Kawhi news ,57,9493,46614,56107,photo
CompanyJ_7056, SnoopDogg trying to convince Kawhi to sign with the Lakers NSFW ,65,11735,38532,50267,video
CompanyJ_7057,Five star recruit Jalen Johnson has verbally committed to Duke per EvanDaniels via brhoops ,91,775,5185,5960,photo
CompanyJ_7058, FloydMayweather always about his money ,40,8287,31869,40156,video
CompanyJ_7059,Unreal via Wade_Bright18 ,25,14517,76676,91193,video
CompanyJ_7060,Revenge of the Dreamers III mood ,33,4777,27903,32680,video
CompanyJ_7061,Four years ago today USWNT won the World Cup for the third time First time in 16 years Only team to win three FIFAWWC Carli Lloyd had fastest hat trick in World Cup history Sunday they go for No 4 ,197,194,1567,1761,photo
CompanyJ_7062,Zion vs RJ tonight in Summer League via nyknicks ,49,5050,35699,40749,video
CompanyJ_7063,Summer League always goes OFF Which rookie will tear it up this year budweiserusa ,82,318,2506,2824,video
CompanyJ_7064,Too easy for Ibra_official ,27,1718,13550,15268,video
CompanyJ_7065,Dreamville got their revenge on the rap game ,45,5842,24467,30309,photo
CompanyJ_7066, alexmorgan13 says she s disappointed at the reaction her tea celebration has gotten via brfootball ,100,3586,28176,31762,video
CompanyJ_7067,That s why AB84 s footwork and hands are elite via doctor_reef brgridiron ,74,5002,33008,38010,video
CompanyJ_7068, This where the magic happens The bucks pulled up to the ROTD3 sessions dreamville ,83,1121,6695,7816,video
CompanyJ_7069,Spida Unboxed Donovan Mitchell s first signature sneaker drops today via brkicks ,81,807,4292,5099,video
CompanyJ_7070,WHAT A COMEBACK 15 year old Coco Gauff advances to the Round of 16 Wimbledon ,77,5029,24349,29378,photo
CompanyJ_7071,15 years old Legendary ,23,6537,37173,43710,photo
CompanyJ_7072,Alex Morgan got the inspiration for her tea celebration from GOT star Sophie Turner so SophieT had some words for her critics NSFW ,131,923,7525,8448,video
CompanyJ_7073,Day 6 Still on KawhiWatch ,26,3160,14009,17169,photo
CompanyJ_7074,Zion amp RJ go head to head in the Summer League tonight Throwback to their first scrimmage at Duke ,100,760,4578,5338,video
CompanyJ_7075,Zhaire showing off his bounce ,30,801,6129,6930,video
CompanyJ_7076,Max Holloway started recruiting Kawhi back to the Raptors during his own presser via ufc ,89,270,2295,2565,video
CompanyJ_7077,Shareef got new ink of the vintage Shaq alley oop reaction via SSJreef ,71,1271,11794,13065,video
CompanyJ_7078,Summer League at its finest ,28,2289,14831,17120,video
CompanyJ_7079, KingJames has arrived via NBASummerLeague ,43,2361,22976,25337,video
CompanyJ_7080,His dog is grabbing rebounds for him via WavyTrino ,51,1560,11442,13002,video
CompanyJ_7081,Wizards have traded Dwight Howard to the Grizzlies per ShamsCharania ,69,933,6237,7170,photo
CompanyJ_7082,Zion and AD cross paths via NickFriedell ,41,1753,13153,14906,video
CompanyJ_7083,Zion vs RJ HERE WE GO ,22,1161,7969,9130,photo
CompanyJ_7084,OH MY ZION via NBA ,19,13083,73374,86457,video
CompanyJ_7085,Zion just BULLIED Kevin Knox via PelicansNBA ,45,14412,57846,72258,video
CompanyJ_7086,FLEX ON EM via NBATV ,21,7296,37286,44582,video
CompanyJ_7087, Any word on Kawhi via NBAonTNT ,32,2794,20186,22980,link
CompanyJ_7088,Zion left knee will miss the rest of game per PelicansNBA ,58,1214,7966,9180,photo
CompanyJ_7089,An earthquake happened in the middle of the Dodgers Padres game and players couldn t even feel it via Dodgers ,110,2824,15068,17892,video
CompanyJ_7090,NBA announces rest of tonight s games at Thomas amp Mack Center will be postponed after earthquake interruption ,112,406,2718,3124,photo
CompanyJ_7091,Zion did not disappoint in his summer league debut ,51,2611,14701,17312,video
CompanyJ_7092,Alley oop Block Zion Fast break dunk Mitchell Robinson takes no plays off ,74,726,4988,5714,video
CompanyJ_7093,Fun guy goes Hollywood Kawhi Leonard will join the Los Angeles Clippers per ChrisBHaynes ,89,10790,32022,42812,photo
CompanyJ_7094,The battle for LA just got real ,32,12445,41522,53967,photo
CompanyJ_7095,Thunder are sending Paul George to the Clippers per wojespn ,60,7081,24708,31789,photo
CompanyJ_7096,What it do Clippers ,20,14791,51934,66725,video
CompanyJ_7097,Kawhi Leonard reached out to Paul George about joining Clippers George immediately requested a trade from OKC per wojespn ,122,9554,38005,47559,photo
CompanyJ_7098,Every nba fan who went to bed early checking their TL tomorrow morning ,71,19235,65745,84980,photo
CompanyJ_7099,Bron gotta be sick rn ,22,2921,17492,20413,photo
CompanyJ_7100,Meanwhile Lakers added an NBA champ to the roster Danny Green plans to sign with the Lakers per ShamsCharania ,110,3178,17096,20274,photo
CompanyJ_7101,Clippers are sending Shai Gilgeous Alexander Danilo Gallinari and 4 first round picks to the Thunder in exchange for PG per BA_Turner ,134,1342,6064,7406,link
CompanyJ_7102,Kawhi s getting a 4 year 142M max contract from the Clippers per wojespn ,73,2545,13848,16393,photo
CompanyJ_7103,Lakers front office after Kawhi s decision ,43,17570,54947,72517,video
CompanyJ_7104,In My Feelings 2019 ,20,3785,16781,20566,photo
CompanyJ_7105,When you knew you were going to the Clippers all along ,55,4151,16830,20981,video
CompanyJ_7106,NBA free agency has flipped the league upside down ,51,5921,20724,26645,photo
CompanyJ_7107,Russ in OKC ,12,10410,38561,48971,photo
CompanyJ_7108,Kawhi didn t want to create a super team with the Lakers he wanted a co star on the Clippers He told Clippers front office Get PG and I m coming per wojespn ,157,6811,32770,39581,photo
CompanyJ_7109,The new dynamic duo in LA ,26,8094,42290,50384,photo
CompanyJ_7110, Kawhi s really coming to LA What ,34,2665,18842,21507,photo
CompanyJ_7111,Last man standing ,18,12581,66864,79445,photo
CompanyJ_7112,Bev and Lou Will when the Kawhi PG news dropped via patbev21 ,61,5939,32203,38142,video
CompanyJ_7113,OKC offered Westbrook and PG 13 to the Raptors with Siakam as the centerpiece of an asset crippling deal but Toronto turned it down per wojespn ,144,4026,15353,19379,photo
CompanyJ_7114, We coming HOME Cali native PG is hyped via AustinMcbroom ,58,1565,10757,12322,video
CompanyJ_7115,That Clippers defense Kawhi PG Pat Bev Trezl ,45,8368,43711,52079,photo
CompanyJ_7116,The Clippers believed Kawhi was ready to join Bron and AD if they didn t trade for Paul George per wojespn ,107,1827,12841,14668,photo
CompanyJ_7117,New title favorites after last night via br_betting ,52,1126,7711,8837,photo
CompanyJ_7118, LakeShow summer ,17,9278,49380,58658,photo
CompanyJ_7119,Westbrook and his agent are engaged with OKC GM Sam Presti about a potential trade per wojespn ,95,9020,38196,47216,photo
CompanyJ_7120,BOOGIE to LA Cousins agrees to a one year deal with the Lakers per wojespn ,75,26345,83345,109690,photo
CompanyJ_7121,Boogie Brow Coming soon to LA ,30,6162,32583,38745,video
CompanyJ_7122,Rondo s back in LA The point guard is returning to the Lakers on a two year deal per WojESPN and ramonashelburne ,113,2899,17590,20489,photo
CompanyJ_7123,Here we go ,11,3058,24215,27273,photo
CompanyJ_7124,AD was catching lobs from LBJ in 2018 while rocking the Boogie jersey Brow was honoring his Pelicans teammate who tore his Achilles All Lakers teammates now ,157,3657,22473,26130,video
CompanyJ_7125, TaylorRooks put him through the ringer but drehunter_ handled his business at this mock press conference From B R x JCPenney ,126,77,574,651,video
CompanyJ_7126,Zion bruised knee is out for the rest of Summer League David Griffin announced ,79,1535,8292,9827,photo
CompanyJ_7127,The Pacers drafted Kawhi Leonard and Paul George in back to back years but they traded the Kawhi pick to the Spurs for George Hill What could ve been is becoming reality with LAC ,179,4785,24155,28940,photo
CompanyJ_7128, Raptors dropped a tribute video for Kawhi and Danny ,53,5828,36040,41868,video
CompanyJ_7129,Kawhi Leonard is the first player in NBA history to join a new team right after winning Finals MVP ,99,3581,29025,32606,photo
CompanyJ_7130,Jerry West continues to make banner moves as an executive Helped build 1980s Lakers dynasty Traded Vlade Divac for Kobe Convinced Shaq to sign with LAL Stopped Klay for Kevin Love trade Helped recruit KD to Warriors Signed Kawhi amp PG13 in one night ,251,6349,32694,39043,photo
CompanyJ_7131,LeBron and AD greet Jerry West one day after Kawhi joins Clippers via BenGolliver ,82,2175,21791,23966,video
CompanyJ_7132,Clipper Darrell yells across the court to LeBron The Laker era is over it s Clipper town Let the games begin via TomerAzarly ,125,2752,17358,20110,video
CompanyJ_7133,Lakers and Clippers players have a chat pregame ,48,3577,26686,30263,video
CompanyJ_7134,Paul George thanks OKC via Yg_Trece ,36,1469,13476,14945,photo
CompanyJ_7135,AD trade is officially official per Lakers ,43,2827,26325,29152,photo
CompanyJ_7136,Khabib and Nate Diaz got into an altercation and had to be separated at UFC239 via mattwreford95 IG ,100,8189,31680,39869,video
CompanyJ_7137,MASVIDAL HITS KO IN 5 SECONDS via ufc ,38,1758,6446,8204,video
CompanyJ_7138,ANOTHER ONE Amanda Nunes KOs Holly Holm in the 1st round via ufc ,65,1036,4724,5760,video
CompanyJ_7139,AND STILL Jon Jones defeats Thiago Santos via split decision to retain the UFC Light Heavyweight title UFC239 ,110,3009,14391,17400,photo
CompanyJ_7140,Jon Jones had to be carried out of the octagon after his victory at UFC239 via AndreasHale ,91,495,4380,4875,video
CompanyJ_7141,IT S WORLD CUP FINAL DAY USWNT vs the Netherlands via brfootball ,65,1169,7400,8569,photo
CompanyJ_7142,Rival execs have pinpointed the Rockets as a likely suitor in a potential Russell Westbrook trade per sam_amick and BDawsonWrites Brodie Beard reunion ,151,4113,16959,21072,photo
CompanyJ_7143,Rapinoe back into the starting lineup ,38,93,1059,1152,link
CompanyJ_7144, World Cup final Gold Cup final Copa America final A lot on the line today via brfootball ,90,892,4661,5553,photo
CompanyJ_7145,Defending World Champions USWNT look to bring it home again via brfootball ,75,342,2438,2780,photo
CompanyJ_7146,WORLD CUP FINAL HERE WE GO ,27,1724,14279,16003,photo
CompanyJ_7147,SO CLOSE via FOXSoccer ,23,127,1255,1382,photo
CompanyJ_7148,All defense so far USA and the NED are both scoreless at half ,62,263,3265,3528,photo
CompanyJ_7149, NED goalkeeper Sari van Veenendaal is locked in 4 saves in the first half This is the first time the USA is scoreless in the first half ,137,199,1550,1749,photo
CompanyJ_7150,The crowd in Kansas City is SERIOUS FIFAWWC via sportingKC ,59,2230,11238,13468,video
CompanyJ_7151,WE HAVE A GOAL Megan Rapinoe scores her 50th USWNT goal 1 0 USA ,64,3643,15645,19288,photo
CompanyJ_7152,Biggest stage Rapinoe delivers via FOXSoccer ,45,805,4189,4994,photo
CompanyJ_7153,ROSE LAVELLLE 2 0 USA ,22,1959,10629,12588,photo
CompanyJ_7154, H Y P E ,9,5194,24639,29833,photo
CompanyJ_7155,That was filthy roselavelle USAWNT has now scored more goals at a single World Cup than any team ever via FOXSoccer ,116,1270,5906,7176,photo
CompanyJ_7156,THE USWNT ARE WORLD CHAMPIONS AGAIN ,36,17580,56210,73790,photo
CompanyJ_7157,Back to back champions ,23,6136,34180,40316,photo
CompanyJ_7158,Dominance ,10,2414,13781,16195,photo
CompanyJ_7159,LEGENDS ,8,1922,9492,11414,photo
CompanyJ_7160,6 goals and 3 assists in 5 games Megan Rapinoe wins the 2019 World Cup Golden Boot ,83,3432,22152,25584,photo
CompanyJ_7161,Rapinoe racking up the trophies World Cup Golden Ball winner ,61,1003,7708,8711,photo
CompanyJ_7162, TROPHIES ,10,2752,13166,15918,photo
CompanyJ_7163,The moment the USWNT took the lead You can feel the electricity via SportingKC ,79,902,6451,7353,video
CompanyJ_7164,The Warriors are retiring Andre Iguodala s No 9 jersey 3x champ 2015 Finals MVP ,80,8573,57994,66567,photo
CompanyJ_7165,That s a lot of hardware ,25,2118,18604,20722,photo
CompanyJ_7166,1991 1999 2015 2019 ,20,2408,17367,19775,video
CompanyJ_7167,What a moment via USWNT ,24,1313,15324,16637,video
CompanyJ_7168,Pinoe got a hero s welcome in the USWNT locker room ,52,1856,19271,21127,video
CompanyJ_7169,There are more rookies than just Zion These fans were struggling via br_betting ,80,181,1805,1986,video
CompanyJ_7170,Julie Ertz s World Cup Trophy photoshoot gt gt gt ,50,2818,25197,28015,photo
CompanyJ_7171,The way Jimmy threw the pen after signing via MiamiHEAT ,56,4175,28679,32854,video
CompanyJ_7172,Pinoe pays tribute to Nipsey Respect via brfootball ,52,7450,31893,39343,photo
CompanyJ_7173,JR showed up to the MLB All Star celebrity game without a shirt via Indians ,76,2772,21234,24006,video
CompanyJ_7174,Champs Brazil beats Peru 3 1 to win the CopaAmerica ,52,845,3326,4171,photo
CompanyJ_7175,Bron knows via KingJames ,25,3044,30713,33757,video
CompanyJ_7176, KyrieIrving was always ready to play for the Nets ,51,1137,9725,10862,photo
CompanyJ_7177,KD will switch to No 7 on the Nets after wearing No 35 for his whole career via KDTrey5 ,88,5380,33495,38875,photo
CompanyJ_7178,KD gave a hint back in April ,29,6064,41353,47417,photo
CompanyJ_7179,Brooklyn s new duo is official ,31,7789,37594,45383,photo
CompanyJ_7180,LeBron officially gives AD No 23 via KingJames ,47,4892,34694,39586,photo
CompanyJ_7181,Mexico wins the 2019 Gold Cup in 1 0 victory over US ,53,12427,32112,44539,photo
CompanyJ_7182,2011 Mexico breaks American hearts in the Gold Cup final 2019 Mexico breaks American hearts in the Gold Cup final ,114,1758,11558,13316,photo
CompanyJ_7183,Historic ,9,988,9285,10273,photo
CompanyJ_7184,Kamara getting creative this summer Stiff arm s about to be MEAN brgridiron via doctor_reef ,92,1282,11372,12654,video
CompanyJ_7185,The USWNT sealed their fourth World Cup in style via brfootball ,64,185,2059,2244,video
CompanyJ_7186, This fall I m gonna take my talents to South Beach Nine years ago today LeBron joined the Heat and changed the league with The Decision ,137,2074,12882,14956,photo
CompanyJ_7187,More moves for OKC Thunder are trading Jerami Grant to the Nuggets for a 2020 first rounder per wojespn ,104,1085,6956,8041,photo
CompanyJ_7188,15 year old phenom Coco Gauff has been eliminated from Wimbledon after an unbelievable run Youngest to reach main draw Beat Venus a childhood idol Advanced to Round of 16 Only the beginning ,190,2797,16888,19685,photo
CompanyJ_7189,Fans in the stadium chanted equal pay after the USWNT s win yesterday via minapark ,83,1677,13296,14973,video
CompanyJ_7190,PG 13 talking about Kawhi in September via TheOklahoman YouTube ,64,1688,9728,11416,video
CompanyJ_7191,Drinking margaritas out of the Stanley Cup via StLouisBlues ,60,554,4300,4854,video
CompanyJ_7192,Young MLB stars keep leaving money on the table so who s to blame When they know your background they ain t going to put too much money out there ,146,54,463,517,photo
CompanyJ_7193,Avery Bradley plans to sign a two year 9 7M deal with the Lakers once he clears waivers per wojespn ,100,5336,32968,38304,photo
CompanyJ_7194,PSG confirm Neymar didn t show up for preseason training today despite agreeing on the return date He s been heavily linked with a move to Barcelona ,149,798,5168,5966,photo
CompanyJ_7195,OKC is receptive toward trade calls on Russell Westbrook per ShamsCharania ,75,1591,10389,11980,photo
CompanyJ_7196,New chapter new number ,23,1779,13222,15001,photo
CompanyJ_7197,Big comebacks on the biggest stage chocolate_milk ,50,39,475,514,video
CompanyJ_7198,The Lakers plan to start LeBron at point guard this year per ChrisBHaynes SHOWTIME ,83,9377,48819,58196,photo
CompanyJ_7199,Potential Lakers starting lineup PG Bron SG Danny Green SF Kuz PF AD C Boogie ,78,10744,56360,67104,photo
CompanyJ_7200,Point Bron coming in LA ,24,8058,38708,46766,video
CompanyJ_7201,The BottleCapChallenge is taking over the sports world ,55,200,1361,1561,video
CompanyJ_7202,Harry Giles put it all on the line via SacramentoKings ,55,308,2928,3236,video
CompanyJ_7203,Westbrook is welcoming the idea of a trade from OKC after 11 years Miami has expressed interest and appeals to Russ per wojespn ,128,3809,24175,27984,photo
CompanyJ_7204,The World Champs are hype to be back home via USWNT ,52,3031,22539,25570,video
CompanyJ_7205,Dwight is ready for a fresh start ,34,470,6192,6662,photo
CompanyJ_7206,Hard to find a couple with more than Megan Rapinoe amp Sue Bird Pinoe 2x World Cup 2012 Olympic Gold 2019 World Cup Golden Ball amp Golden Boot 2012 13 Division 1 Feminine 2x NWSL Shield Sue 3x WNBA Champ 2x NCAA Champion 4x Olympic gold 4x World Champ ,253,1513,9703,11216,photo
CompanyJ_7207, QCook323 s late dad was a huge Laker fan Now Quinn Cook gets to wear the jersey for the team his dad loved ,108,7488,43300,50788,photo
CompanyJ_7208,D Lo already rocking the Dubs gear via Dloading ,48,582,5894,6476,photo
CompanyJ_7209,Throwback Amar e Stoudemire and Monta Ellis are in Vegas working out for 12 teams tonight per ChrisBHaynes Among them Lakers Warriors Knicks Thunder Bucks Pistons Wizards ,171,2700,12904,15604,photo
CompanyJ_7210,Vlad Jr is the youngest player in the HomeRunDerby He just set the record for most HRs in a single round with 29 via Sportsnet ,127,2148,9800,11948,video
CompanyJ_7211,Elijah Bonds kicked off his Summer League by dunking over a guy who s 6 10 budweiserusa ,88,83,938,1021,video
CompanyJ_7212,Tacko barely has to jump Ridiculous ,36,1310,12880,14190,video
CompanyJ_7213,29 and 29 Vlad Jr has his eyes on the HomeRunDerby crown via BlueJays ,70,402,3092,3494,video
CompanyJ_7214,JOC VLAD JR TIED WE HAVE ANOTHER SWING OFF HomeRunDerby ,56,697,3628,4325,photo
CompanyJ_7215,Best Derby ever via AllStarGame ,32,1430,12209,13639,video
CompanyJ_7216,WHAT A DERBY Pete Alonso is your HomeRunDerby Champ ,52,960,4057,5017,photo
CompanyJ_7217,Jaxson Hayes caught a BODY via NBATV ,37,11312,46358,57670,video
CompanyJ_7218,Bigger than basketball He saw a kid playing without shoes or socks so he went inside and gave him a pair of his own via where_is_ethan Instagram ,145,39308,135648,174956,video
CompanyJ_7219,Down goes Floyd Mayweather via therealpremey ,45,22543,87735,110278,video
CompanyJ_7220,Emmitt Smith Jr is following in his father s footsteps The Cowboys legend says he s been special since birth brgridiron ,120,1753,10371,12124,video
CompanyJ_7221,Whiteside s embracing Rip City New Blazers big man is giving out donuts in Portland More love we don t do the hate via youngwhiteside ,134,1023,7246,8269,video
CompanyJ_7222,13 years ago today Zidane s infamous headbutt in the World Cup final via brfootball ,84,4954,25075,30029,video
CompanyJ_7223,This fan got a champ stamp tattoo of Pat Mahomes and the QB signed it brgridiron via thecheckdown JimmyKimmelLive ,114,1036,9158,10194,video
CompanyJ_7224,James Harden working on his touch at the Emirates via ReissNelson9 ,67,917,6613,7530,video
CompanyJ_7225,Boogie is returning to 1 5 his old Kings number Lakers throwing it back this year ,82,4949,35116,40065,photo
CompanyJ_7226,Leo Messi s family restaurant in Argentina is providing hot meals to those in need while the country goes through a cold period per marca ,138,954,8131,9085,photo
CompanyJ_7227,David Griffin talking MVP for Jrue Sometimes you need to be given permission to dominate people via SiriusXMNBA ,112,689,4849,5538,video
CompanyJ_7228,Set him up for the FILTHY nutmeg via talibandcam IG NSFW ,57,589,4671,5260,video
CompanyJ_7229,Nets GM Sean Marks says he found out KD was coming to Brooklyn from his IG post there was no official meeting until after that ,127,1363,9644,11007,photo
CompanyJ_7230,Marcus Morris is re considering his 2 year 20M Spurs deal and is considering signing with the Knicks per WojESPN and MarcJSpearsESPN ,133,1336,9008,10344,photo
CompanyJ_7231,Mayweather is now 50 1 ,23,28674,102532,131206,video
CompanyJ_7232,Trout and Lindor making sure the flex is right for the pics Via Cut4 ,69,301,4618,4919,video
CompanyJ_7233,Anfernee Simons is a BUCKET 35 PTS 13 18 FG 6 7 3PT ,52,2851,15830,18681,video
CompanyJ_7234,New look for Bron in year 17 via KingJames ,43,4320,32044,36364,photo
CompanyJ_7235,Warriors are waiving Shaun Livingston Livingston is determined to continue playing elsewhere per wojespn ,105,1699,12546,14245,photo
CompanyJ_7236,For Rose Lavelle the celebration begins after the USWNT trophy parade when she s reunited with her English Bulldog Wilma Jean via brfootball ,141,198,2291,2489,video
CompanyJ_7237,Kanter s cheat day could feed a family of 7 via EnesKanter ,59,2864,23750,26614,video
CompanyJ_7238,Take a charge from Tacko Fall at your own risk ,47,2809,18339,21148,video
CompanyJ_7239,Seven straight All Star game wins for the American League AL tops the NL 4 3 to continue their ASG dominance ,109,300,2245,2545,photo
CompanyJ_7240,Rapinoe is ready for the USWNT parade Via USWNT ,48,1497,14037,15534,video
CompanyJ_7241,9 years ago today LeBron and Bosh joined Wade in Miami and the Heatles were born From AmericanExpress x B R ,108,1939,9176,11115,video
CompanyJ_7242,Globetrotters made sure to deliver for the BottleCapChallenge via Globies ,74,1932,13169,15101,video
CompanyJ_7243, alexmorgan13 broke out the via USWNT ,38,930,10833,11763,video
CompanyJ_7244,Kawhi is signing a three year 103M max deal with the Clippers including a player option for the third season per ShamsCharania ,127,1684,12406,14090,photo
CompanyJ_7245,Deal back home is official 2K needs this baybee ,48,4163,28792,32955,photo
CompanyJ_7246,This mPinoe entrance was level via FOXSoccer ,45,1245,6021,7266,video
CompanyJ_7247, ,1,1260,6256,7516,photo
CompanyJ_7248,2021 free agency market could be stacked Kawhi Bron PG Giannis ,63,2415,15193,17608,photo
CompanyJ_7249,6 6 235 pounds Bigger hands than any NFL starting QB 38 inch vertical 17 years old Germany s Alexander Honig wants to be the first European QB in the NFL ,154,908,6728,7636,photo
CompanyJ_7250,Pinoe s victory dance gt gt gt ,31,1427,9814,11241,video
CompanyJ_7251,Russ liked ,11,3114,25042,28156,photo
CompanyJ_7252, That was the whole field Odell LAUNCHED this ball NSFW via brgridiron jpqz IG ,79,3634,22117,25751,video
CompanyJ_7253,James Ennis III on why he re signed with the Sixers We had a good chance last year Kawhi is gone So we are going to walk to the Finals in the East per PompeyOnSixers ,166,1037,8850,9887,photo
CompanyJ_7254,Drew Brees kids matched with Zion via drewbrees h t brgridiron ,63,1778,19851,21629,photo
CompanyJ_7255,Tyler Herro has taken Summer League by storm ,45,6255,33987,40242,video
CompanyJ_7256,Windmill Bronny via brhoops ,28,5548,36502,42050,video
CompanyJ_7257,Knicks young core found their groove tonight RJ 21 PTS 10 REB amp 3 AST Knox 25 PTS 7 REB amp 3 AST Mitch Rob 13 PTS 11 REB amp 5 BLK ,134,1602,10804,12406,video
CompanyJ_7258,On this day in 2014 KingJames announced he was coming home to Cleveland ,72,2609,17677,20286,video
CompanyJ_7259,RB Melvin Gordon has told the Chargers he will demand a trade and skip camp if he doesn t receive a new contract per AdamSchefter ,130,1662,9536,11198,photo
CompanyJ_7260,Whatever it takes ,18,1786,15864,17650,photo
CompanyJ_7261,Barcelona will pay Antoine Griezmann s release clause tomorrow per sergisoleMD h t brfootball ,94,398,2472,2870,photo
CompanyJ_7262,The Lakers had to sacrifice a haul for AD but his game has proven it ll be worth it for years to come ,102,795,4516,5311,video
CompanyJ_7263,Serena Williams advances to the Wimbledon final with straight sets win over Barbora Strycova ,93,795,4410,5205,photo
CompanyJ_7264,KD initially balked at being traded for D Lo straight up in Nets deal because he didn t think it was fair leveraged Warriors into including a first round pick per WindhorstESPN ,177,712,5145,5857,photo
CompanyJ_7265, x ,3,3766,35106,38872,photo
CompanyJ_7266, MoneyLynch and marcuspeters put on a free carnival for kids in Oakland Real ones brgridiron via JodiHernandezTV ,113,2114,8875,10989,video
CompanyJ_7267, I m the next Floyd I m the next Sugar Ray Shakur Stevenson is being held back but at 11 0 he wants the title now ,114,269,1504,1773,photo
CompanyJ_7268,Another angle of obj s throw LAUNCH CODES brgridiron via CommonVisuals ,71,398,3095,3493,video
CompanyJ_7269,Friends who get drafted together stick together ,48,739,8931,9670,photo
CompanyJ_7270,Twitter ,8,1065,5195,6260,photo
CompanyJ_7271,Three years ago today Tim Duncan announced his retirement with a press release from the Spurs which didn t even include any comments from the Big Fundamental A quiet end to an iconic career ,190,1467,9661,11128,photo
CompanyJ_7272, WNBA All Star Captains Elena Della Donne amp A ja Wilson Starters ecambage brittneygriner Natasha Howard jus242 cgray209 jewellloyd kaymac_2123 KayNurse11 ,156,166,1269,1435,photo
CompanyJ_7273,Got this goal on loop via NYCosmos h t brfootball ,50,606,4571,5177,video
CompanyJ_7274,Spurs pull their offer on Marcus Morris and have agreed to sign Trey Lyles per wojespn ,87,299,2549,2848,photo
CompanyJ_7275,NBA players were asked Who is the best player of all time NBASummer ,68,780,5238,6018,video
CompanyJ_7276,Breaking Thunder trade Russell Westbrook to Houston for Chris Paul and 2024 2026 first round picks pick swaps in 2021 and 2025 per wojespn ,139,28338,54083,82421,photo
CompanyJ_7277,Brodie and Beard in Houston ,28,6251,20449,26700,photo
CompanyJ_7278,,0,5526,19839,25365,photo
CompanyJ_7279,Live look at CP3 ,17,3255,14160,17415,photo
CompanyJ_7280,OKC was never the same after this ,34,7476,27131,34607,video
CompanyJ_7281,The moment we all knew ,23,2055,12658,14713,photo
CompanyJ_7282,Russ is now on the Rockets One of the coldest dudes in the league CoorsLight ,77,2300,10214,12514,video
CompanyJ_7283,OKC GM Sam Presti worked with Russ to deliver him to his preferred destination a reunion with James Harden per wojespn ,119,1656,11658,13314,photo
CompanyJ_7284,This potential new Rockets starting five Russ Harden Eric Gordon PJ Tucker Clint Capela ,88,2678,12503,15181,photo
CompanyJ_7285,End of an era in OKC ,21,3619,16947,20566,photo
CompanyJ_7286,A look back at Russ and Harden in OKC via NBA ,46,3774,14187,17961,video
CompanyJ_7287,Houston hoped to find third team destination preferable to Chris Paul Miami remains possibility for CP3 per wojespn ,116,1112,7766,8878,photo
CompanyJ_7288,OKC turned Russ and PG into ,28,2602,11824,14426,photo
CompanyJ_7289,Russ was at his comedy show in Tulsa Oklahoma when he got traded via JD0432 ,76,1461,9804,11265,video
CompanyJ_7290,CP3 heads to OKC ,17,981,8388,9369,photo
CompanyJ_7291,BRODIE x BEARD are BACK ,24,3629,14406,18035,video
CompanyJ_7292,Harden joined Russ who was practicing by himself before the 2017 All Star game Brodie and Beard always had each other s back via ArashMarkazi ,142,1175,10250,11425,video
CompanyJ_7293,The 2nd half of the MLB season is underway SuperCuts ,53,164,1681,1845,video
CompanyJ_7294,Breaking Barcelona have officially signed Antoine Griezmann from Atletico Madrid via brfootball ,96,2357,12896,15253,photo
CompanyJ_7295,Barcelona s attacking options are serious Via brfootball ,57,1590,9276,10866,photo
CompanyJ_7296, When s my transfer going through ,34,1144,7541,8685,photo
CompanyJ_7297,Nothing but love for Westbrook Russ thanks OKC fans at his show after news broke about Houston trade via ScoopB ,112,2071,12714,14785,video
CompanyJ_7298,Wade needs to make some phone calls after free agency is over ,62,2983,20866,23849,photo
CompanyJ_7299,Beckham s Wimbledon fits gt gt gt ,34,955,6839,7794,photo
CompanyJ_7300,6 2 4 6 6 3 6 2 Defending champ Djokovic advances to the Wimbledon final ,73,394,3369,3763,photo
CompanyJ_7301,Plan for OKC is that CP3 doesn t play a game in a Thunder uniform looking to move him soon per wojespn ,103,5153,24516,29669,photo
CompanyJ_7302, ArtistHBTL x B R We re pulling up to Vegas this weekend with B R Jump Off Register and come through ,101,34,318,352,video
CompanyJ_7303,Vlad Jr should be primed for a strong second half after a remarkable All Star weekend experience ,97,202,2223,2425,video
CompanyJ_7304,7 6 1 6 6 3 6 4 Roger Federer defeats Rafael Nadal Will face Novak Djokovic in the Wimbledon final ,99,1719,8352,10071,photo
CompanyJ_7305,The next generation is coming Which HS player NBA dad duo would you take via brhoops ,85,3866,23344,27210,photo
CompanyJ_7306,Former Clemson QB Kelly Bryant was in a real bad place when he lost his spot to Trevor Lawrence after having already been stuck behind Deshaun Watson With a fresh start he has one season to prove he has an NFL future ,217,357,3016,3373,photo
CompanyJ_7307,This reaction to Russ getting traded is priceless via opolisclothing IG ,72,5376,33162,38538,video
CompanyJ_7308,Harden ready to get that old thing back ,40,3257,23221,26478,photo
CompanyJ_7309,Classic Zlatan Via brfootball ,30,551,4484,5035,photo
CompanyJ_7310,Russ historic 11 seasons in OKC will never be forgotten MINI MOVIE ,67,2892,14052,16944,video
CompanyJ_7311,Federer vs Nadal never disappoints via Wimbledon ,49,948,6110,7058,video
CompanyJ_7312,Russ says goodbye to OKC via russwest44 ,40,9167,49088,58255,photo
CompanyJ_7313,One last Thunder hype tape for Russ via okcthunder ,51,5571,20148,25719,video
CompanyJ_7314,LeBron s plan to gift AD his No 23 jersey will be postponed for a season due to production issues per ChrisBHaynes ,115,2187,10507,12694,photo
CompanyJ_7315,Dipo couldn t sit courtside without getting a shot up via Pacers ,65,1751,17693,19444,video
CompanyJ_7316,Debbie Skaggs Tyler s mom threw out the first pitch and it was right down the middle via gregbeacham ,101,2924,21080,24004,video
CompanyJ_7317,The celebration continues for mPinoe via WNBA ,46,377,3887,4264,video
CompanyJ_7318,Trout sends it into the stands with No 45 on his back via Angels ,65,988,8761,9749,video
CompanyJ_7319,All for Tyler Combined no hitter 13 0 win No 45 on every jersey Mom with perfect strike first pitch Angels left it all on the field ,132,8146,39848,47994,photo
CompanyJ_7320,No words What a moment via FoxSportsWest ,41,11946,57848,69794,video
CompanyJ_7321,AD announces he ll be wearing No 3 next season after plans for taking No 23 falls through via AntDavis23 ,105,2913,17143,20056,photo
CompanyJ_7322,The moment the Angels no hitter was completed What sports are all about via Cut4 ,81,2721,19463,22184,video
CompanyJ_7323,Serena is 2 8 when she loses the first set in the wimbledon final Will she make a comeback on Halep ,100,113,909,1022,photo
CompanyJ_7324,Flip off the board SPLASH via official sauceyy IG ,50,407,3667,4074,video
CompanyJ_7325,Simona Halep defeats Serena Williams in straight sets to win her first Wimbledon title ,87,370,2087,2457,photo
CompanyJ_7326, It was my mom s dream The day came so thanks to my parents Simona Halep made history against Serena Crowned first ever Romanian Wimbledon singles champion ,156,486,3052,3538,photo
CompanyJ_7327,Victory speech Simona_Halep is just humbled to be on this stage Via Wimbledon ,78,254,1941,2195,video
CompanyJ_7328,Jaxson Hayes was an absolute game breaker at summer league this year POWERADE ,78,825,4623,5448,video
CompanyJ_7329,Serena was asked about whether she should stop fighting for equality and focus on tennis Her response The day I stop fighting for equality and for people that look like you and me will be the day I m in my grave ,212,10020,42891,52911,photo
CompanyJ_7330,He seasoned his meat off the kickflip via luke_hampton IG ,58,3290,21085,24375,video
CompanyJ_7331,Ice Trae really is cold blooded even against kids via TheTraeYoung ,67,1686,12778,14464,video
CompanyJ_7332,AD was watching a movie when he was traded He sent his agent to voicemail and had to check Instagram to find out what happened via NBAonTNT ,140,2037,12104,14141,video
CompanyJ_7333,AD3 LakeShow ,13,2555,17723,20278,photo
CompanyJ_7334,Giannis continues to achieve beyond what he thought was possible via brkicks ,77,153,1610,1763,photo
CompanyJ_7335,RJ Barrett had himself a game vs the Wizards 21 PTS 10 AST 8 REB ,65,2636,16274,18910,video
CompanyJ_7336,Jaxson Hayes JAM Zion approved via NBA ,39,728,7738,8466,video
CompanyJ_7337,Svi DROPPED HIM via NBA ,24,6494,37466,43960,video
CompanyJ_7338,All of Carsen Edward s 3PTs from NBASummer ,43,3104,16130,19234,video
CompanyJ_7339, Help mama out Carsen Edwards always keeps his motivation on his wrist ,71,5283,39760,45043,photo
CompanyJ_7340,One of Neymar s favorite memories as a player is when Barcelona came back against PSG via brfootball ,101,202,2148,2350,photo
CompanyJ_7341,Giannis wants to be around for the long haul ,45,1343,11935,13278,photo
CompanyJ_7342,15 years ago today the Lakers traded Shaq to the Heat for Caron Butler Lamar Odom Brian Grant and picks Ended Shaq Kobe era Diesel promised a title Signed for 100M in 2005 Heat won 2006 championship ,199,1836,10712,12548,photo
CompanyJ_7343,This rivalry on the biggest stage gt gt Wimbledon ,50,264,2309,2573,photo
CompanyJ_7344,Caught it after the backflip via pedroliveirafs IG ,51,4834,27874,32708,video
CompanyJ_7345,Antoine Griezmann is officially Barcelona s new No 17 via FCBarcelona ,70,835,5042,5877,video
CompanyJ_7346,This match Wimbledon ,21,1026,5671,6697,photo
CompanyJ_7347,Instant classic Wimbledon ,26,994,6379,7373,photo
CompanyJ_7348,WHAT A MATCH DjokerNole defeats Roger Federer in a fifth set tiebreak for his 5th Wimbledon title 16th Grand Slam overall ,122,997,4694,5691,photo
CompanyJ_7349,Djokovic s winning moment via Wimbledon ,40,1260,6671,7931,video
CompanyJ_7350,Taste of victory Wimbledon ,27,734,4757,5491,photo
CompanyJ_7351, I hope I give some other people a chance to believe that at 37 it s not over yet rogerfederer s not done via Wimbledon ,120,2737,16579,19316,video
CompanyJ_7352,What via uzoma_obilor IG ,25,935,6946,7881,video
CompanyJ_7353, All year at Staples Center AD s already loving life as a Laker via guynirofficial IG ,86,5468,34967,40435,video
CompanyJ_7354,Giannis asked Bucks fans to stop calling him the MVP until I win it again next year via Bucks ,94,2688,22551,25239,video
CompanyJ_7355,Giannis giving fans orders of his new sneaker via Bucks ,56,1038,10420,11458,video
CompanyJ_7356,Can t forget these classics via brfootball ,43,1744,11319,13063,photo
CompanyJ_7357,Miles Bridges broke out a special move out in Vegas POWERADE ,61,875,6898,7773,video
CompanyJ_7358,Zion hitting from anywhere via NBASummerLeague BenGolliver ,59,1065,10965,12030,video
CompanyJ_7359,Steph sums up the time he hit a 3 in Kobe s face via OmarHoH ,61,4603,29127,33730,video
CompanyJ_7360,Anthony Davis will not participate in USA Basketball training camp and FIBA World Cup to focus on championship quest per ChrisBHaynes ,134,986,9389,10375,photo
CompanyJ_7361,Drizzy getting in the trick shot game via Drake ,48,1746,16920,18666,video
CompanyJ_7362,This year s rookie class is showing out at Summer League POWERADE ,66,459,3186,3645,video
CompanyJ_7363,Icons via brfootball ,21,340,3202,3542,photo
CompanyJ_7364,Cavs expected to waive JR Smith today barring a last minute trade per joevardon ,80,988,7682,8670,photo
CompanyJ_7365,Boxing legend Pernell Whitaker has died at age 55 after being hit by a vehicle ,79,2398,8833,11231,photo
CompanyJ_7366,Balance via amazingkideche ,27,2991,19196,22187,video
CompanyJ_7367,Players aren t totally on board with robot umpires Baseball needs the human element This isn t MLB The Show This is MLB real life ,130,167,1398,1565,photo
CompanyJ_7368,In the past year Dame_Lillard Made his fourth ASG Hit a legendary buzzer beater Reached the conference finals Got a supermax deal Today he turns 29 What s next ,160,1137,8903,10040,photo
CompanyJ_7369,Zlatan doesn t even flinch via Ibra_official ,45,1884,18086,19970,video
CompanyJ_7370, 170M Five years Ben Simmons just got paid per ShamsCharania ,61,3761,26828,30589,photo
CompanyJ_7371,Zaire getting via brhoops ,26,1006,9625,10631,video
CompanyJ_7372,TB 12 s speed rating on Madden is 60 He s trying to change that via TomBrady brgridiron ,88,469,4109,4578,video
CompanyJ_7373,Dubs are in on D Lo ,20,769,6923,7692,photo
CompanyJ_7374,Former No 1 pick Anthony Bennett could be returning to the NBA for the first time since 2017 ,93,709,6837,7546,video
CompanyJ_7375,Everyone was jumping out of the gym during the statefarm dunk contest at B R Jump Off ,86,114,775,889,video
CompanyJ_7376,Cavs have waived JR Smith per ShamsCharania ,44,1259,8989,10248,photo
CompanyJ_7377,JR will always have 2016 ,25,3097,22021,25118,photo
CompanyJ_7378,OKC had a potential dynasty Then they had a contender Now they re headed toward a rebuild ,90,720,4421,5141,video
CompanyJ_7379,Ja was not ready for this training session ATT ,47,630,5900,6530,video
CompanyJ_7380,Looks like Bron is ready for next season via KingJames ,55,1363,9892,11255,photo
CompanyJ_7381,That best 2KRatings duo in the game feeling Average OVR between LeBron and AD 95 5 ,83,722,5566,6288,photo
CompanyJ_7382,99 3PT 2KRatings for Steph ,27,4099,31797,35896,photo
CompanyJ_7383,Ben just got PAID One of the coldest passers in the NBA will be in Philly for five more years CoorsLight ,105,541,3522,4063,video
CompanyJ_7384,Gonna need a new driver after this via hunterprice_ ty_morley4 haydenchrist11 IG ,81,374,4298,4672,video
CompanyJ_7385,This moment between SkyDigg4 and a young fan named after her What it s all about via DorothyJGentry ,100,521,3710,4231,video
CompanyJ_7386,Arsenal brought James Harden out for their away kit release via brfootball ,75,2109,15816,17925,photo
CompanyJ_7387,Why jump with him via craytonjay ,33,2181,12000,14181,video
CompanyJ_7388,Christian Pulisic trains with Chelsea for the first time ,57,490,4961,5451,photo
CompanyJ_7389,Chuck s advice for Zion ,24,591,5531,6122,photo
CompanyJ_7390,Old Kevin Love Popovich ,24,971,12549,13520,photo
CompanyJ_7391,Stranger Things all grown up via AntoGriezmann ,47,896,8887,9783,photo
CompanyJ_7392,DeMar is fed up with the old face filter NSFW via DeMar_DeRozan ,64,1779,12248,14027,video
CompanyJ_7393,Ten players received max contracts this summer including Kawhi D Lo and Klay Thompson But six NBA executives and GMs told B R they don t think any fully deserved it ,165,206,1699,1905,photo
CompanyJ_7394,Kid s got MOVES via hudsonhogsett d_aybar1988 IG ,49,897,6433,7330,video
CompanyJ_7395,Championships never get old ,28,533,4309,4842,photo
CompanyJ_7396,How d he pull that off via hamblow ,35,2243,12241,14484,video
CompanyJ_7397,FILTHY via brfootball ,22,2499,12944,15443,video
CompanyJ_7398,19 year old Matthijs de Ligt has arrived at Juventus to complete his move from Ajax via brfootball ,99,880,5441,6321,video
CompanyJ_7399, I m getting back to playing the style I ve played my whole life Zo s ready for the Pels via PelicansNBA ,105,2871,22992,25863,photo
CompanyJ_7400,Who was harder to stop Bo or Barry via brgridiron ,50,244,2312,2556,photo
CompanyJ_7401,Today in 2008 Brandon Jennings became the first American player to go straight from high school to Europe signing with Italian pro team Virtus Roma ,148,2073,14795,16868,photo
CompanyJ_7402,Summer League s over but a new season is coming soon What s the coldest moment from last season CoorsLight ,107,275,1854,2129,video
CompanyJ_7403,OKC GM Sam Presti calls Russell Westbrook the most important player in brief history of Thunder ,96,2855,24138,26993,photo
CompanyJ_7404,The precision via coach_rusty IG ,33,2131,17507,19638,video
CompanyJ_7405,Bron brought AD over for Taco Tuesday via KingJames ,52,33603,138617,172220,video
CompanyJ_7406,2018 Juventus sign Cristiano Ronaldo the summer after he knocks them out of the UCL 2019 Juventus sign Matthijs De Ligt the summer after he knocks them out of the UCL ,167,757,6704,7461,photo
CompanyJ_7407,Baker s hyped for OBJ ,22,546,4726,5272,photo
CompanyJ_7408, Look at Tacko s legs via tackofall99 ,38,6036,40238,46274,video
CompanyJ_7409,CR7 s control through the gauntlet on another level via juventusfcen ,69,2505,18584,21089,video
CompanyJ_7410, SHAQ on superteams today I m from the era where guys wanted to compete and beat each other I d go on the team that needs a superstar and teach them guys how to beat the superteams via JimmyKimmel ,197,1011,7811,8822,photo
CompanyJ_7411, KingJames opened the I Promise School to help at risk students One year since it opened 90 of students have met or exceeded their growth goals and the school hopes to set a blueprint for others across the country ,214,5777,25580,31357,photo
CompanyJ_7412,Giannis is too big for NYC cabs via mike_juice14 IG ,52,1413,12895,14308,video
CompanyJ_7413, I wanna be the reason no one else will Enes Kanter used Kyrie s exact line on why he chose to wear No 11 in Boston via NBCSCeltics ,132,2894,19340,22234,video
CompanyJ_7414, Last question Kemba how much you gonna pass me the ball via celtics ,69,2126,19887,22013,video
CompanyJ_7415,Peach Jam proved why JalenRomande could be a top five pick in 2021 via brhoops ,79,363,1994,2357,video
CompanyJ_7416,Saquon is inspired by Kobe and says he wants to leave a lasting legacy That s why he writes MambaMentality on his cleats before games brgridiron via uninterrupted ,163,788,6397,7185,photo
CompanyJ_7417,AD in full Lakers uni for the first time via NBA2K ,51,2378,18579,20957,photo
CompanyJ_7418,Pete Alonso just went 474 via Mets ,35,403,3068,3471,video
CompanyJ_7419,There s an increased expectation that CP3 will start the season with the Thunder per wojespn ,93,521,5416,5937,photo
CompanyJ_7420,Will the Greek Freak repeat as MVP via br_betting ,50,249,3039,3288,photo
CompanyJ_7421, Ibra_official s thoughts on what s in Area51 Probably there s not another Zlatan via LAGalaxy h t brfootball ,110,1326,7498,8824,video
CompanyJ_7422,Dame on his Game 5 winner against OKC What can I say That was for Seattle via SBRadio ,86,6738,37139,43877,photo
CompanyJ_7423,Bron getting in some early practice with Boogie and AD on 2K via KingJames ,75,2321,20506,22827,video
CompanyJ_7424,Bheem Goyal an 8 year old battling Acute Lymphocytic Leukemia gets the start and the save via SoundersFC ,105,1159,6430,7589,video
CompanyJ_7425,Love to see this via Cut4 ,26,5065,34496,39561,video
CompanyJ_7426,On this day in 2002 Kobe pulled up at Rucker Park fresh off a three peat Mamba balled and was dubbed Lord of the Rings but the second half got rained out Vintage ,162,3391,15308,18699,photo
CompanyJ_7427,Dwight s perspective has changed ,33,1165,8838,10003,video
CompanyJ_7428,Penny s game was pure magic Happy birthday to Iam1Cent ,55,6003,23698,29701,video
CompanyJ_7429, My end goal is not to be better than Giannis My end goal is to be the best version of my own self With help from his brother Alex Antetokounmpo is on the path to NBA greatness ,177,324,3251,3575,photo
CompanyJ_7430,JR Smith will have a free agent meeting with the Bucks today per ShamsCharania ,79,903,9059,9962,photo
CompanyJ_7431,A year ago today Raptors traded for Kawhi Rested 22 regular season games Game 7 game winner vs 76ers in semis Dunked on MVP twice in ECF Led Raps to 3 straight road wins in Finals Finals MVP for Toronto s first title Next chapter in LA will be wild ,249,1383,9487,10870,photo
CompanyJ_7432,Pat Bev got a career payday this summer 40M One of his first moves Buying mom a house via patbev21 ,99,4750,39156,43906,photo
CompanyJ_7433,Barcelona have offered PSG 112M two players in exchange for Neymar according to SkySports Philippe Coutinho and Ousmane Dembele are among those being offered by Barca for the deal h t brfootball ,195,1972,7636,9608,photo
CompanyJ_7434,Blake s demonstration of postgame interviews via FallonTonight ,63,3199,18287,21486,video
CompanyJ_7435,Ronaldinho was a magician via brfootball ,41,1235,6241,7476,video
CompanyJ_7436,Giannis has big dreams for his little brother ,46,439,5245,5684,photo
CompanyJ_7437,Dog s playing solid defense though via danielrainge ,52,1993,14288,16281,video
CompanyJ_7438,Get used to this Boston ,24,888,9729,10617,photo
CompanyJ_7439,Kanter played a pickup game against a ton of kids in his full Celtics uniform via ByJayKing ,92,737,7972,8709,video
CompanyJ_7440,Recovery time with Rocco via KlayThompson ,42,481,5918,6399,photo
CompanyJ_7441,17 years ago today the Spurs signed Manu Ginobili after taking him with the 57th pick in the 1999 NBA draft 4 NBA titles 2x All Star 2008 Sixth Man of the Year No 20 retired by Spurs What a story ,196,5659,30523,36182,photo
CompanyJ_7442,Road to recovery via KDTrey5 iamomeez IG ,41,4896,33991,38887,photo
CompanyJ_7443,Wade s daughter isn t even one and she s swimming already via DwyaneWade ,73,2095,19343,21438,video
CompanyJ_7444,NFL will not suspend WR Tyreek Hill following investigation into child abuse allegations ,89,2436,11315,13751,photo
CompanyJ_7445,Christian Pulisic finally breaking a sweat in his new Chelsea threads Via brfootball ,85,291,3634,3925,photo
CompanyJ_7446,Bronny Shareef Bryce and Shaqir in the backyard LeBron is just a proud dad watching the kids become stars from afar via KingJames ,130,4689,33143,37832,video
CompanyJ_7447,Lance Stephenson s daughter reenacts her dad s poster and guitar celebration and it s on point via StephensonLance ,115,4561,27454,32015,video
CompanyJ_7448,Bron is raising a winner via brhoops ,37,1007,10783,11790,photo
CompanyJ_7449, shaiglalex putting in the work in open runs OKC is going to be fun via corey__porter ,86,1369,8442,9811,video
CompanyJ_7450, AaronRodgers12 CP3 BrettFavre mconley11 and more The 2nd annual BahaMarShowdown is Saturday at 3pm ET on CBS theshowdowngolf ,126,84,733,817,video
CompanyJ_7451,James Harden will not be with USA Basketball this summer to prepare for changes with Rockets per Jonathan_Feigen ,113,651,5475,6126,photo
CompanyJ_7452,Shaq is always with the vibes Via killthenoise ,47,20731,82624,103355,video
CompanyJ_7453,Harden isn t worried about playing with Brodie again When you have talent like that it works itself out You got guys that are willing to sacrifice it always works itself out via MarkBermanFox26 ,194,1192,8264,9456,video
CompanyJ_7454,What about Patrick ,19,1184,11013,12197,photo
CompanyJ_7455,Harden is comedy via kennooodeeezz ,35,7814,45897,53711,video
CompanyJ_7456,16 years ago today Ronaldinho joined Barca and reached another level via brfootball ,84,1938,11522,13460,video
CompanyJ_7457,23 years ago today Muhammad Ali shocked the world by lighting the torch at the 1996 Olympics in Atlanta after getting diagnosed with Parkinson s disease in 1984 Forever legend ,176,1864,12308,14172,photo
CompanyJ_7458,Kid called out Harden saying his step back is a travel The Beard had the perfect response via KellyIkoNBA ,106,3233,19068,22301,video
CompanyJ_7459,What kind of challenge is this via JordanClarksons ,51,619,4653,5272,video
CompanyJ_7460,Landed so many shots he fell out of the ring Surgical via trboxing ,67,8210,30280,38490,video
CompanyJ_7461,Zlatan is inevitable THAT GOAL via MLS ,39,5250,22196,27446,video
CompanyJ_7462, Zlatan is in a class of his own via MLS ,41,3200,18216,21416,video
CompanyJ_7463,Reds lost 12 11 to the Cardinals after leading 7 0 so fans had to find another way to occupy their attention via drewzilla94 IG ,128,415,3579,3994,video
CompanyJ_7464,Mike Leake took his perfect game bid into the 9th inning losing it to the first batter up Mariners beat Angels 10 0 behind his one hit performance ,147,151,1724,1875,photo
CompanyJ_7465,Zlatan after his hat trick vs LAFC I am LA via brfootball ,58,1371,10297,11668,photo
CompanyJ_7466,Dad wasn t playing around via b racks10 IG ,43,20502,108105,128607,video
CompanyJ_7467,Sierra Canyon promises to be a show next season after adding 5 star recruits Brandon Boston Jr and Ziaire Williams in the past two days via brhoops ,148,1196,7311,8507,photo
CompanyJ_7468,JR Smith Scottie Pippen and Aaron Rodgers took their talents to the golf course in a Team NBA vs Team NFL battle for charity CDWCorp ,133,186,1378,1564,video
CompanyJ_7469,Shaq really had the time of his life in the moshpit via killthenoise ,69,3427,23586,27013,video
CompanyJ_7470,Kyle Korver has agreed to 1 year deal with Bucks per wojespn Korver was choosing between Milwaukee and 76ers ,109,1506,13013,14519,photo
CompanyJ_7471,Christen Press out here ending defenders in her first game back via NWSL ,73,702,4731,5433,video
CompanyJ_7472,Elbow dunk over Donovan Mitchell in his jersey via julienrath IG ,65,1312,13981,15293,video
CompanyJ_7473,Brooks Koepka almost drove this one to the moon NEARLY 400 YARDS via GolfChannel ,81,393,4180,4573,video
CompanyJ_7474,Zlatan s always been special via brfootball ,44,1352,9173,10525,video
CompanyJ_7475,Who you got Team AaronRodgers12 or CP3 2nd annual BahaMarShowdown starts NOW on CBS theshowdowngolf ,100,45,403,448,video
CompanyJ_7476,No ankles are safe at James Harden s camp via HoustonRockets ,61,2903,16605,19508,video
CompanyJ_7477,No look no problem Throw was on the money via LMcKnightQBA ,59,335,2469,2804,video
CompanyJ_7478,This is what happens when you re Team No Shoes PatMcAfeeShow BaHaMarShowdown theshowdowngolf ,93,268,2709,2977,video
CompanyJ_7479,James Harden says there s nothing negative between him and Chris Paul It was a lot of false talk via ChronBrianSmith ,117,407,3759,4166,video
CompanyJ_7480,Bounced it off his head and then drained it in his face via manonrehaume99 11reasonzz IG ,89,1705,15118,16823,video
CompanyJ_7481,Mech vs Monster showdown on Fortnite was WILD via Ninja h t BRGaming ,69,327,3032,3359,video
CompanyJ_7482, ScottiePippen hitting from DEEP BaHaMarShowdown theshowdowngolf ,65,214,1827,2041,video
CompanyJ_7483, TheRealJRSmith ran off the course after winning the Tech Fore challenge BaHaMarShowdown ,89,229,1978,2207,video
CompanyJ_7484,Javy Báez keeps going into his bag of tricks via NBCSCubs ,58,808,5127,5935,video
CompanyJ_7485,Shane Lowry sits on top of The Open s leaderboard and it s easy to see why via GolfChannel ,91,41,639,680,video
CompanyJ_7486,Bam sent him FLYING via jeremyrabin IG ,39,604,4499,5103,video
CompanyJ_7487,Just like dad Kiyan looking like young Melo out here via lala ,62,1690,9962,11652,video
CompanyJ_7488,1st career grand slam for Vlad Jr via BlueJays ,47,954,7781,8735,video
CompanyJ_7489,Darren Sproles has been a PROBLEM since day 1 via Eagles ,57,1198,7617,8815,video
CompanyJ_7490,The Amazing Spida Mitchell via brkicks ,39,1132,8635,9767,photo
CompanyJ_7491,Fun Guy is ringside at PacquiaoThurman ,39,4278,24518,28796,photo
CompanyJ_7492,Manny pulled up to Eye of the Tiger PacquiaoThurman ,52,877,6674,7551,photo
CompanyJ_7493,Paul Pierce in the house for PacquiaoThurman ,45,373,4916,5289,photo
CompanyJ_7494,MANNY DROPPED THURMAN IN THE FIRST ROUND PacquiaoThurman ,57,6990,28681,35671,photo
CompanyJ_7495,Manny Pacquiao wins the WBA World Welterweight Title at 40 years old and hands Keith Thurman his first pro loss PacquiaoThurman ,128,31262,92035,123297,photo
CompanyJ_7496,Manny still has power PacquiaoThurman via PBConFOX ,51,5823,29092,34915,video
CompanyJ_7497,Zinedine Zidane confirmed Real Madrid are looking to sell Gareth Bale He ll leave the team having done it all Via brfootball ,125,1457,8311,9768,photo
CompanyJ_7498,Awards were named after Mo and Edgar well before they were on HoF ballots Now they ll be Cooperstown forever Mariano Rivera American League Reliever of the Year Award Edgar Martinez Outstanding Designated Hitter Award ,218,125,879,1004,photo
CompanyJ_7499,6 legends will be added to rare company in Cooperstown ,55,406,2722,3128,photo
CompanyJ_7500,Wade wasn t allowing any easy buckets after he got pickpocketed via ari portnoy Instagram ,90,1182,15893,17075,video
CompanyJ_7501,Mariano Rivera gets enshrined in the Hall today 652 career saves 1st all time 2 21 career ERA 0 70 postseason ERA 5 Rings Cop the MarianoRivera x B R x peraltaprjct merch collab ,178,348,1602,1950,photo
CompanyJ_7502,Trae Young dropped 31 PTS in his debut at DrewLeague via brhoops ,65,1423,11020,12443,video
CompanyJ_7503, If you re only making yourself better then you don t stand a f king chance to ever play in the NBA That s real via ricohinesbball ,131,3574,16021,19595,video
CompanyJ_7504,Roy Halladay is one of the greatest pitchers of his generation First to throw perfect game and no hitter in same season Threw no hitter in postseason debut only 2nd in playoff history One of six pitchers to win Cy Young in both leagues A legend in Cooperstown forever ,268,1192,7740,8932,photo
CompanyJ_7505,GAME Brandon Rush dropped him before hitting the three Via CBSSports ,69,1577,9683,11260,video
CompanyJ_7506,He got rolled up in the tarp Via RandyWesleySD ,47,1141,8381,9522,video
CompanyJ_7507,Mo began his career as a starter 3 3 with a 5 94 ERA in 10 games He became an elite setup man in Yanks 96 run to the WS their first chip in 18 years Retired in 2013 with a record 652 saves Legendary come up by Cooperstown s newest member ,238,419,2788,3207,photo
CompanyJ_7508,White Mamba still got it Scalabrine out here blocking Stephen Jackson via thebig3 ,82,846,7666,8512,video
CompanyJ_7509,Pete Alonso is going to need a new bat via MLB ,47,622,6575,7197,video
CompanyJ_7510,Going and between the legs before sinking the full court shot via sb_rv_11 ,75,462,4260,4722,video
CompanyJ_7511,This interaction between Liz Cambage and a young fan will be the sweetest thing you see all day via LVAces ,107,318,3567,3885,video
CompanyJ_7512, KingJames watching film for his film ,38,910,12462,13372,photo
CompanyJ_7513,Acuña knew it was gone with the sound of the ball off the bat via Braves ,73,689,4248,4937,video
CompanyJ_7514,A bettor put 150 down on Shane Lowry to win The Open at 105 1 odds and won nearly 16 000 via lsuslick h t br_betting ,117,356,4506,4862,photo
CompanyJ_7515,LSU s new locker room is CRAZY via LSUfootball ,47,5703,35031,40734,video
CompanyJ_7516,This kid ran into Messi on the beach then got to play soccer with him and his son via mcc111000 IG ,99,4529,41331,45860,video
CompanyJ_7517,USWNT star Rose Lavelle met a young fan named Rose Lavelle via bmcnally14 ,74,683,7951,8634,video
CompanyJ_7518,Darius Leonard was 17 when his brother was murdered and the killer was never convicted He says he knows who did it but never retaliated in order to keep making his brother proud ,178,2767,17053,19820,photo
CompanyJ_7519,Sideways pull ups via manvelmamoyan IG ,39,302,3342,3644,video
CompanyJ_7520,Bradley Beal to receive full max offer from Wizards at the very first moment allowed per wojespn ,97,646,5817,6463,photo
CompanyJ_7521,Opposing players aren t going to be the only ones coming at LB JoshAllen41_ Adam Lefkoe coaches him on how to handle the social media gauntlet From B R x MbyMStrahan x JCPenney ,177,33,358,391,video
CompanyJ_7522,Zion Williamson has withdrawn from USA Basketball s select team for FIBA World Cup training per ShamsCharania Zion is fully focused on getting integrated with the Pelicans ,172,672,5895,6567,photo
CompanyJ_7523,Cristiano Ronaldo won t face criminal charges after prosecutors say allegations of 2009 sexual assault cannot be proven beyond a reasonable doubt ,146,661,2953,3614,photo
CompanyJ_7524,At 8 years old Ashlynn was told girls shouldn t be playing baseball But now she s headed to Nationals via baseballfor_all BaseballDadof6 ,137,1919,12750,14669,video
CompanyJ_7525,Tim Duncan has joined the Spurs as an assistant coach ,54,16899,93969,110868,photo
CompanyJ_7526,Pop approved ,13,2351,20694,23045,photo
CompanyJ_7527,Can t wait to see these fits on the Spurs sideline ,51,2128,12870,14998,photo
CompanyJ_7528,Timmy can teach the Spurs a thing or two Timeless via JabariJYoung ,67,1449,10091,11540,video
CompanyJ_7529,Basketball s next generation has been getting some help from courtside stars like LeBron D Wade and Blake Griffin brhoops ,122,776,5881,6657,video
CompanyJ_7530,Tyler Herro is AUTOMATIC 15 16 from behind the arc via MiamiHEAT ,65,2750,19905,22655,video
CompanyJ_7531,He overcame his fears and landed a 20 box jump This is awesome via BradVinyard NubAbility ,90,44481,210482,254963,video
CompanyJ_7532,Ben Simmons putting in work via swishcultures_ ChrisJHoops ,59,2406,14366,16772,video
CompanyJ_7533,He hit The Beard with his own step back via bigg_jett ddwongg Instagram ,72,6561,55978,62539,video
CompanyJ_7534,Pulisic dropped Pique ,22,773,7401,8174,photo
CompanyJ_7535,Windmill too easy off the bounce via I_AMCV ,44,1290,9615,10905,video
CompanyJ_7536,Antoine Griezmann s first game out for Barcelona ,49,276,2489,2765,photo
CompanyJ_7537,Soccer is for everyone via arianadossantos10 IG ,48,1070,8785,9855,video
CompanyJ_7538,Breaking Zion Williamson signs multiyear deal with Jordan Brand brkicks ,72,11361,53466,64827,photo
CompanyJ_7539,Boxer Maxim Dadashev has died at age 28 from injuries suffered in a fight this past Friday ,91,2950,9277,12227,photo
CompanyJ_7540,Bron knows the feeling of a fresh cut via KingJames ,52,1102,10955,12057,video
CompanyJ_7541,The Las Vegas Aces went all in on building a WNBA superteam but struggled to start the year An inside look at the superteam that s still learning to be super ,158,174,1088,1262,photo
CompanyJ_7542,NBA is reviewing early free agency deals and investigating the timing on some of the earliest reported deals per ZachLowe_NBA WindhorstESPN ,140,490,3636,4126,photo
CompanyJ_7543, ,1,1946,9846,11792,photo
CompanyJ_7544,Kostas Antetokounmpo to LA got the internet talking about Giannis free agency in 2021 ,86,864,7682,8546,video
CompanyJ_7545,Giannis working on his shooting with Korver via bigsack42 IG ,61,4827,38729,43556,video
CompanyJ_7546,The Giants have dominated MLB in July From B R x Supercuts ,59,337,1369,1706,video
CompanyJ_7547,Bron gives us a sneak peak of the new Toon Squad uniforms on Taco Tuesday via KingJames ,88,7189,39875,47064,video
CompanyJ_7548,Things are earned in Ray Allen s house via trayfour IG ,55,8606,37741,46347,video
CompanyJ_7549, What it do Mannyyyy via MannyPacquiao ,39,6032,50196,56228,photo
CompanyJ_7550,Team Elena and Team A ja are set for WNBAAllStar EDD Brittney Griner Jonquel Jones Kia Nurse Jewel Loyd Diamond DeShields Liz Cambage Natasha Howard Chelsea Gray Kayla McBride A ja out for ASG ,193,174,969,1143,photo
CompanyJ_7551,MJ is ready to see Zion change the game via brkicks ,52,689,6811,7500,photo
CompanyJ_7552,Whole crowd was going along with Baby Shark via Cut4 ,53,1857,10504,12361,video
CompanyJ_7553,Tatum thought he was gonna get at least an 87 OVR via NBA2K ,60,860,7228,8088,video
CompanyJ_7554,Yankees with multiple four hit and seven RBI games with team Lou Gehrig Joe DiMaggio Didi Gregorius Unparalleled company ,121,575,4048,4623,photo
CompanyJ_7555,AARON HICKS TO SAVE THE GAME YANKEES WIN 14 12 via MLB ,55,4350,21480,25830,video
CompanyJ_7556,Yankees came out on top vs Twins in an instant classic 35 hits 26 runs 17 strikeouts 14 walks 10 innings Six home runs One hero ,128,731,5565,6296,photo
CompanyJ_7557,11 years ago today Leo Messi took Barcelona s iconic No 10 shirt via brfootball ,80,1147,9464,10611,photo
CompanyJ_7558,Ronaldo with the no look pass via IntChampionsCup ,50,2384,13139,15523,video
CompanyJ_7559, ,1,188,1940,2128,photo
CompanyJ_7560,97 year old grandma s a baller via paulkuo ,43,1000,7767,8767,video
CompanyJ_7561,Bron s still the record holder for rookie shoe deals but Zion s the new king of Jordan ,87,616,5837,6453,video
CompanyJ_7562,Inside the 49ers dysfunction draft misses and losses and why they re still thinking Super Bowl ,95,105,813,918,photo
CompanyJ_7563,Board man comes out on top again Kawhi Leonard voted NBA s best player by 20 coaches and execs ahead of Giannis and Harden per TimBontemps ,139,670,5262,5932,photo
CompanyJ_7564,It s about to be a fun season ,30,825,5958,6783,photo
CompanyJ_7565,Steve Ballmer is hyped ,23,5255,30116,35371,video
CompanyJ_7566,No social media paragraph thank you from Kawhi but he still has love for Raps fans ,83,2420,16773,19193,video
CompanyJ_7567,Kawhi says the Clippers haven t been in the Lakers shadow these past couple years The Clippers have been better ,112,3053,16194,19247,video
CompanyJ_7568,Doc had them switch spots for that Cali area code ,50,4090,30830,34920,video
CompanyJ_7569,A new PG Kawhi mural for the Clippers via jovanbuha ,52,506,4361,4867,video
CompanyJ_7570,Cali connection ,16,4277,28337,32614,photo
CompanyJ_7571,Kawhi couldn t help but smile talking about Toronto s Ka Wine amp Dine ,71,735,6701,7436,video
CompanyJ_7572,PG couldn t hold back his love for Kobe ,40,1091,10463,11554,photo
CompanyJ_7573,A Laker fan was protesting the mural unveiling of Kawhi PG13 via RyanWardLA ,76,944,6104,7048,video
CompanyJ_7574,Browns got two players in the top 5 via brgridiron ,51,176,1808,1984,photo
CompanyJ_7575,Kawhi says he was very close to choosing Lakers or Raptors before Clippers per Rachel__Nichols ,95,529,4623,5152,photo
CompanyJ_7576,Earl Thomas stands by his actions via brgridiron ,49,814,6302,7116,photo
CompanyJ_7577,CP3 thanks Houston and looks forward to returning to OKC via CP3 ,65,349,3340,3689,photo
CompanyJ_7578,DSJ between the legs alley in slow mo via harrington1313 IG ,60,4169,26436,30605,video
CompanyJ_7579,Back in May Georgia freshman QB D Wan Mathis underwent brain surgery to remove a cyst Now he s on his way back to recovery and even dunking a basketball via FootballUGA ,169,656,5175,5831,video
CompanyJ_7580,Kevin Byard went from Deion Sanders mistaking him for a fan to becoming the highest paid safety in NFL history via brgridiron ,126,1815,11452,13267,photo
CompanyJ_7581,Summer hoop sessions in full effect featuring Donovan Mitchell Trae Young Dennis Smith Jr amp Melo via Cbrickley603 ,116,7424,37304,44728,video
CompanyJ_7582,Doc Rivers doesn t want to compare this Clippers team to Lob City It s a different energy This group is new This is our creation per ramonashelburne ,149,521,5048,5569,photo
CompanyJ_7583, Second most expensive teenager ever Youngest to score Europa League hat trick One of the world s most hyped young stars Atletico Madrid s Joao Felix will be answering your questions TODAY at 12 45 pm ET on the B R app ,219,75,703,778,photo
CompanyJ_7584,Shareef O Neal got support from LeBron Kobe and T Mac during his recovery from open heart surgery The Comeback of Zipper Boy ,125,553,3470,4023,photo
CompanyJ_7585, Last Chance U star Ronald Ollie is getting his shot at the NFL ,64,7880,38033,45913,video
CompanyJ_7586,Baker to OBJ looking via Browns brgridiron ,43,4735,31982,36717,video
CompanyJ_7587,OBJ showing off the hands via dan_labbe brgridiron ,51,874,6886,7760,video
CompanyJ_7588,Superman passed down the hero genes to Shareef BRHoops ,55,204,2344,2548,photo
CompanyJ_7589,deGrom sat him down via snytv ,30,574,4057,4631,photo
CompanyJ_7590,The Atleti phenom is here and ready Join Joao Felix s AMA now ,62,189,2160,2349,video
CompanyJ_7591,Security guard just pulled up and benched multiple reps via jalilkuku IG ,73,4283,31217,35500,video
CompanyJ_7592,Messi free kicks are a cheat code via brfootball ,49,809,4675,5484,video
CompanyJ_7593,He really went under BOTH legs via brhoops ,43,10209,49114,59323,video
CompanyJ_7594,Kyler and Larry looking ready for next season via AZCardinals h t brgridiron ,77,1396,10706,12102,video
CompanyJ_7595,Zo gets a 79 rating on 2K via NBA2K ,36,919,14057,14976,photo
CompanyJ_7596,J Cole was holding his own against Trae Melo and JR via Cbrickley603 ,69,15984,67846,83830,video
CompanyJ_7597,Clippers GM Lawrence Frank put potential targets on the board during free agency pitch to Kawhi Leonard saw Paul George s name and said That s my guy per BenGolliver ,166,394,4381,4775,photo
CompanyJ_7598,Red Sox demolish Yankees 19 3 in their biggest rivalry win ever ,64,1152,7660,8812,photo
CompanyJ_7599,Beal vs Tatum vs CP3 via DrewHanlen ,36,5829,27852,33681,video
CompanyJ_7600,Mbappe makes it look too easy via PSG_inside ,45,2817,23293,26110,video
CompanyJ_7601,Eden Hazard has been named the cover athlete of FIFA20 ,55,1417,10042,11459,photo
CompanyJ_7602,YouTube saving QuinnenWilliams a lot of money on personal coaches Via SNYtv ,76,2061,13957,16018,video
CompanyJ_7603,Always an uphill battle to status ,34,1020,7119,8139,photo
CompanyJ_7604,From Houston to Arsenal Harden s been everywhere for world football via brfootball ,83,337,2887,3224,video
CompanyJ_7605,Kid is never going to forget this basketball camp via thejelloshow_ IG ,71,2455,15109,17564,video
CompanyJ_7606,AB showed up to his first Raiders training camp in a hot air balloon via Raiders h t brgridiron ,96,907,4711,5618,video
CompanyJ_7607, We both understand that we have one common goal and that s to win a championship I don t have to touch the ball to impact the game Russ ,137,1431,7758,9189,video
CompanyJ_7608,Thoughts on Houston Russ It s hot as hell ,42,5865,33490,39355,video
CompanyJ_7609,Nothing but love from Russ for OKC ,35,951,5493,6444,video
CompanyJ_7610,Why not New era officially begins in Houston ,45,4922,27311,32233,video
CompanyJ_7611,Brodie and Beard already have experience together ,50,429,4286,4715,photo
CompanyJ_7612,Bikini Bottom got the exclusives KyrieIrving via brkicks ,57,8183,32874,41057,video
CompanyJ_7613, Jaygup23 is taking any and all ankles via brhoops h t tiphoops ,64,1364,7142,8506,video
CompanyJ_7614,Bobby Wagner and Seahawks agree to terms on 3 year 54M contract extension per TaylorRooks 40 2M fully guaranteed for the All Pro inside linebacker brgridiron ,158,655,4408,5063,photo
CompanyJ_7615,1 Real 0 1 Atleti 7 Real 0 2 Atleti 18 Real 0 3 Atleti 27 Real 0 4 Atleti 44 Real 0 5 Atleti First half was unfair ,115,1234,9199,10433,photo
CompanyJ_7616,PLAY OF THE NIGHT via Mariners ,31,4140,23790,27930,video
CompanyJ_7617,Pablo Sandoval homered BUT THE FAN CAUGHT IT WITH A BABY IN HIS ARM via NBCSGiants ,83,1020,6414,7434,video
CompanyJ_7618,Cambage x Pinoe All Star energy ,32,228,2788,3016,photo
CompanyJ_7619,At 19 years old Neymar split an entire defense for the Puskas winning goal of 2011 He did it on this day brfootball ,116,1050,8695,9745,video
CompanyJ_7620,OBJ got STICKY hands Via H_Grove ,33,3962,26622,30584,video
CompanyJ_7621,MLB executives wonder if Bryce Harper will ever live up to his 330M mega contract I see a good player but not a great one ,122,262,1817,2079,photo
CompanyJ_7622,Liz stops by Kobe and Gigi to show love WNBAAllStar ,52,864,9627,10491,video
CompanyJ_7623,For mom EWeezy_For3eezy s speech was unforgettable as she becomes the first undrafted player to win WNBAAllStar MVP via NBATV ,126,1095,5720,6815,video
CompanyJ_7624, SHAQ went head to head against WWETheBigShow ten years ago today via WWE ,74,3290,13918,17208,video
CompanyJ_7625,Bron had to jump in the warm up line real quick via qwik11hoops IG ,67,5751,37502,43253,video
CompanyJ_7626,Hakeem Dawodu with a MEAN KO KICK via ufc ,42,364,1838,2202,video
CompanyJ_7627,Christian Yelich always ready for the big stage via MLB ,56,271,3020,3291,video
CompanyJ_7628,Gervonta is relentless DavisNunez via SHOsports ,48,14485,41919,56404,video
CompanyJ_7629, I made the three more famous than Steph chancetherapper TheBigDay ,67,2973,27137,30110,photo
CompanyJ_7630,Cris Cyborg defeats Felicia Spencer via UD UFC240 ,50,173,1480,1653,photo
CompanyJ_7631, MambaMentality ,16,328,4913,5241,photo
CompanyJ_7632,Max Holloway retains the Featherweight championship belt vs Frankie Edgar via UD UFC240 ,88,531,2776,3307,photo
CompanyJ_7633,Last Sunday Zidane confirms Real Madrid wants to sell Gareth Bale Friday Bale close to joining a club in China Today Real Madrid cancels Bale s move ,149,341,2207,2548,photo
CompanyJ_7634,Jeremy Lin opens up ,20,3715,30122,33837,photo
CompanyJ_7635,Manu Ginobili turns 42 today Entered the league as 57th pick Complete unknown Left as 4x champ 2x All Star One of the GOAT sixth men One of two players to win NBA EuroLeague Olympic titles ,189,2588,13205,15793,photo
CompanyJ_7636,Didn t see that coming via Jaimynho10 streetsoccerbelgium IG ,61,2194,14128,16322,video
CompanyJ_7637,Never underestimate grandpa via gurpreetdhillon ,48,1085,9034,10119,video
CompanyJ_7638,OBJ gifted his cleats to this kid at camp via 1stladyofsports brgridiron ,73,842,7655,8497,video
CompanyJ_7639,This battle NY streetball is electric via MANILOVE24 ,53,8902,37590,46492,video
CompanyJ_7640,More lefty Mahomes this year brgridiron via ChiefsReporter ,59,273,2878,3151,video
CompanyJ_7641,Bronny s team won the tournament so pops celebrated with them via osbournell c IG ,82,5572,39600,45172,video
CompanyJ_7642,One hand No gloves Reportedly 67 straight grabs Odell is not fair per H_Grove brgridiron ,89,3858,26938,30796,video
CompanyJ_7643,What a pass via brfootball ,27,2136,16969,19105,video
CompanyJ_7644,Blue Jays and Mets in agreement on Marcus Stroman trade pending medical review per jonmorosi ,93,297,1329,1626,photo
CompanyJ_7645,Jimma Gatwech warm ups are NEXT LEVEL via CourtsideFilms ,57,2889,14145,17034,video
CompanyJ_7646,Antonio Brown s son on the route Derek Carr s son with the dime Most adorable connection in the NFL via AB84 h t brgridiron ,124,2848,24852,27700,video
CompanyJ_7647,Little man SWUNG that via RawBenz ,34,483,5824,6307,video
CompanyJ_7648, Five pairs of shoes each Grab whatever ya ll want Dame is a real one brkicks via jrdup21 ,90,9715,48339,58054,video
CompanyJ_7649,Ice Trae too smooth with it at AEBLHOOPS via brhoops ,53,1118,8227,9345,video
CompanyJ_7650, His mother was evicted for the eighth time the week he was drafted Deion Sanders mistook him for a fan on Twitter Now the highest paid safety in history at 14 1M per year Kevin Byard s come up is truly survival mode ,217,1293,7448,8741,photo
CompanyJ_7651,This 13 year old came in fifth place at the Fortnite World Cup and could only hug his father after winning 900K k1nGOD h t BRGaming ,132,5340,43576,48916,video
CompanyJ_7652,Real Madrid was down 7 3 so this fan pulled out the Barca jersey and the stadium wasn t having it Via MelissaMOrtiz h t brfootball ,131,2803,14100,16903,video
CompanyJ_7653,Steph amp D Lo in the gym together ,35,1645,16127,17772,photo
CompanyJ_7654,AD putting in work with Jrue while rocking that purple and gold via yungsalt IG ,80,1223,13928,15151,video
CompanyJ_7655,Baited him into every inch till he was ready to drop him via wiz thekid IG ,75,1118,8517,9635,video
CompanyJ_7656,Carmelo s trainer Chris Brickley says Melo is better than 70 percent of NBA players and wants one more farewell season to do what D Wade did via breakfastclubam ,161,3486,22356,25842,photo
CompanyJ_7657,Dad had to wait for the next pitch via dadandbloated IG ,56,20929,94799,115728,video
CompanyJ_7658,How fast would you fall down via twardusfitness IG ,51,183,1804,1987,video
CompanyJ_7659,Still driving it down the range at 90 years old via jonpaullong bob rowe 39 IG ,79,306,5015,5321,video
CompanyJ_7660,One year ago today KingJames opened the I Promise School Changing lives BRkicks ,80,3580,18573,22153,video
CompanyJ_7661,Ronaldo knows via brfootball ,29,274,2628,2902,photo
CompanyJ_7662,From Brink s trucks to Supreme cleats to head tattoos NFL training camp has been wild this season via brgridiron ,113,258,2213,2471,video
CompanyJ_7663,Hawks getting creative Trae and Bembry playing tag in practice via ATLHawks ,76,1570,15589,17159,video
CompanyJ_7664, InternationalFriendshipDay ,28,381,3425,3806,photo
CompanyJ_7665,First look at Zionwilliamson in NBA2K ,38,425,4212,4637,photo
CompanyJ_7666,Dropped him Thielen is surgical with it brgridiron via KSTPSports Vikings ,74,2364,17419,19783,video
CompanyJ_7667,Five years after EA stopped making NCAA Football the game is thriving thanks to superfans and someone called vikesfan059 And the franchise might be making a comeback ,166,841,3688,4529,photo
CompanyJ_7668, Last Chance U star Ronald Ollie has been cut by the Raiders ,61,748,4585,5333,photo
CompanyJ_7669,USWNT s Jill Ellis is stepping down as coach per JeffKassouf Ellis won back to back World Cups with the team ,109,204,1231,1435,photo
CompanyJ_7670,CJ McCollum has agreed to a 3 year 100M contract extension His deal is now 5 years 157M per wojespn ,100,1078,7266,8344,photo
CompanyJ_7671,Dame 196M supermax CJ 100M extension Blazers going all in on their backcourt this summer ,89,1633,15835,17468,photo
CompanyJ_7672,17 years ago today the legend LisaLeslie threw down the first dunk in WNBA history via LA_Sparks ,97,4408,22573,26981,video
CompanyJ_7673,Gruden s in on Peterman via brgridiron ,39,287,2568,2855,photo
CompanyJ_7674,Thirteen 3s in a row Lonnie Walker cashing out from range via GeorgeLangberg ,77,880,6315,7195,video
CompanyJ_7675,Boogie getting after it in rec league via ultimatehoops ,56,368,3805,4173,video
CompanyJ_7676,Shai Norwood is in remission for lymphoma She was brought to tears when she was suprised by her idol De11eDonne via GMA ,120,498,4397,4895,video
CompanyJ_7677,Held it all the way through via jsaito93 ,41,1000,8521,9521,video
CompanyJ_7678,Got creative with the takedown via RC3zus ,42,1118,9937,11055,video
CompanyJ_7679,Cleveland trades RHP Trevor Bauer to Reds as part of 3 team deal with Padres per JeffPassan ,92,388,1696,2084,photo
CompanyJ_7680,Amir Garrett went at the Pirates all alone Yasiel Puig still came to his defense after being traded to Cleveland Madness in Cincinnati via FOXSportsOH ,151,9547,33569,43116,video
CompanyJ_7681,Keeper stood NO chance via remythe3rd IG ,41,864,9766,10630,video
CompanyJ_7682,Michael Thomas just got PAID 5 years 100M Highest paid receiver in NFL history per RapSheet brgridiron ,103,8870,41315,50185,photo
CompanyJ_7683,12 years ago today Kevin Garnett was traded to the Celtics completing Boston s Big 3 ,85,1454,8007,9461,video
CompanyJ_7684,FIFA announce TheBest men s player nominees Cristiano Ronaldo Frenkie de Jong Matthijs de Ligt Eden Hazard Harry Kane Sadio Mane Kylian Mbappe Lionel Messi Mohamed Salah Virgil van Dijk via brfootball ,201,319,2497,2816,photo
CompanyJ_7685,Ohio State freshman Ibrahima Diallo hasn t seen his family in over three years So he went to Senegal to surprise them via ChrisHoltmann ,136,6871,52263,59134,video
CompanyJ_7686,Too easy for WayneRooney via MLS ,33,510,4295,4805,video
CompanyJ_7687,Trae Young has gained 12 to 16 pounds of muscle this offseason and plans to work on his midrange game with Kobe in August per ChrisKirschner ,141,3266,25660,28926,photo
CompanyJ_7688,This Ronaldinho assist via brfootball ,38,815,6518,7333,video
CompanyJ_7689,KD has built a total of 19 courts around the world His latest A court for the Bay Area before he left the Warriors apexer ,122,2245,15173,17418,photo
CompanyJ_7690,20 28 cpulisic_10 gets his first goals for Chelsea ,51,396,3764,4160,photo
CompanyJ_7691,New York planned to consider bringing back Melo if they landed two big free agents this summer per ShamsCharania ,113,764,7171,7935,photo
CompanyJ_7692,Zack Greinke has been traded to the Astros per Ken_Rosenthal ,61,1182,4761,5943,photo
CompanyJ_7693,Pedro really scored like this ,30,297,2657,2954,photo
CompanyJ_7694,Two Washington legends going at it Kelseyplum10 holding her own against nate_robinson in some shooting drills via ChrisHyppa ,125,390,3128,3518,video
CompanyJ_7695,D Rose has a new tattoo added to the collection a neck tat that says God Speed via Killer_tattoos ,98,2240,18099,20339,video
CompanyJ_7696,Greinke and Bauer trades shook up the MLB this deadline ,56,161,1441,1602,video
CompanyJ_7697,Gucci Mane playing pickup with Michael Vick and Lonnie Walker IV via gucci1017 ,79,3544,18663,22207,video
CompanyJ_7698, MeekMill was getting buckets at the gym ,41,1473,9515,10988,video
CompanyJ_7699,Aaron Donald is ranked No 1 overall in the NFLTop100 Top 5 1 Aaron Donald 2 Drew Brees 3 Khalil Mack 4 Pat Mahomes 5 Todd Gurley via nflnetwork ,144,1235,7659,8894,photo
CompanyJ_7700,It s August 1st WE HAVE NFL FOOTBALL ON TONIGHT ,48,3626,16132,19758,photo
CompanyJ_7701,Lance Stephenson has reached a 1 year 4M agreement with Liaoning of the Chinese Basketball Association per ChrisBHaynes ,120,2130,15234,17364,photo
CompanyJ_7702,Eight years ago today KD pulled up at Rucker Park during the lockout and dropped 66 EASY MONEY via tnas04 freshfocusports ,122,8708,37016,45724,video
CompanyJ_7703,DROPPED him via brhoops PoshAlexander ,38,1012,6046,7058,video
CompanyJ_7704,Arsenal break their transfer record to sign Nicolas Pepe from Lille brfootball ,79,133,1505,1638,photo
CompanyJ_7705,Neymar is back with his PSG squad at training brfootball ,57,278,2618,2896,photo
CompanyJ_7706,This is what it s all about brgridiron via JamesConner_ ,56,765,7116,7881,video
CompanyJ_7707,DeMar had to show love after this kid beat him in knockout via MambaSportsHQ ,77,902,9690,10592,video
CompanyJ_7708,Klay on people who say the Warriors dynasty is over It s a little ignorant because I m going to come back better and even more athletic It would not be smart to count the Dubs out per Rachel__Nichols ,200,1685,12766,14451,photo
CompanyJ_7709,Grizzlies bringing back the Vancouver throwbacks via memgrizz ,62,3046,15722,18768,video
CompanyJ_7710,Tony Hawk and Shaun White getting major air time via tonyhawk ,62,7036,50783,57819,video
CompanyJ_7711,Ed Reed is ready for Hall of Fame weekend brgridiron ,53,526,5773,6299,photo
CompanyJ_7712,They started playing ping pong after the TD via NFL ,52,1151,12904,14055,video
CompanyJ_7713,Had to let him know how bad he missed Via brlive ,49,592,5189,5781,video
CompanyJ_7714,Pogba didn t know how to act after the lineup via astarbarbers h t brfootball ,78,631,5278,5909,video
CompanyJ_7715,DBook was in the lab with Wade Via DwyaneWade ,46,1312,11254,12566,video
CompanyJ_7716,Melo just wants answers ,24,7864,41672,49536,photo
CompanyJ_7717,The kick sent him flying Via brlive ,36,438,3000,3438,video
CompanyJ_7718,Mahomes is launching passes and the season hasn t started yet via TomKCTV5 h t brgridiron ,90,2295,19184,21479,video
CompanyJ_7719,Nathan Patterson signed an MLB contract with the A s after he threw multiple pitches over 95 MPH in a Coors Light pitch challenge via cpatterson_7 ,147,1501,10723,12224,video
CompanyJ_7720,LA could make it happen via brhoops ,36,1940,14904,16844,photo
CompanyJ_7721, Learned from D Wade YouTube highlights Born in Fla but grew up in France Went pro at 16 Scouts say Killian Hayes is a future first round pick ,143,87,681,768,photo
CompanyJ_7722,Everyone s coming for SEN Bugha after he won 3M playing Fortnite over the weekend via bugha h t BRGaming ,105,482,4698,5180,video
CompanyJ_7723,Lonzo with a new look via ZO2_ ,31,802,8275,9077,video
CompanyJ_7724,Superstars returning to their old stomping ground this upcoming season Nov 27 AD in New Orleans Kyrie in Boston Dec 11 Kawhi in Toronto Jan 9 Russ in OKC H T ShamsCharania ,172,491,2827,3318,photo
CompanyJ_7725,Hawks are keeping a spot reserved for Vinsanity if he chooses Atlanta per ChrisKirschner Where would you like to see Carter spend his final season ,147,488,4572,5060,photo
CompanyJ_7726,Unlimited splash The kids are automatic buckets via brotherswhoball ,68,2746,13913,16659,video
CompanyJ_7727,Pat Mahomes has a new cereal called Magic Crunch that s selling in Kansas City area grocery stores eBay is selling them for 33 each or a 12 pack for 315 per adamteicher h t brgridiron ,184,300,2459,2759,photo
CompanyJ_7728,Mahmoud Abdul Rauf trolling everyone via ahmibrahimm kothawalaa shaikh andbake IG ,82,6379,31752,38131,video
CompanyJ_7729,When all bases are loaded Gleyber will take you home via YESNetwork ,68,308,1847,2155,video
CompanyJ_7730,14 year old calder_Qb7 is trying to become the first ever double amputee QB in the NFL Lions gave him a shot today and he delivered via Lions ,142,874,6852,7726,video
CompanyJ_7731,He s 89 years old and did a 405 lb deadlift via gymnationtoccoa IG ,67,8327,49112,57439,video
CompanyJ_7732,Khalil Iverson ENDED HIM via thetournament ,43,2718,12881,15599,video
CompanyJ_7733,Happy 42nd birthday to TomBrady The league s oldest QB is still out here winning rings ,87,931,5880,6811,video
CompanyJ_7734,From Ed Reed to Tony Gonzalez yesterday s stars become legends today in Canton ,79,615,4197,4812,photo
CompanyJ_7735,Boogie couldn t believe how hard this poster was via 7xmedia AlexKoblenz ,73,1164,8141,9305,video
CompanyJ_7736,Draymond Green agrees to four year 100M maximum extension with Warriors per wojespn ,84,2799,18209,21008,photo
CompanyJ_7737,Jayson Tatum was a walking bucket at RumphClassic via brhoops ,62,2441,12537,14978,video
CompanyJ_7738,Canton Ohio is where NFL legends go to rest These Hall of Fans Honorees experienced football heaven From B R x Ford ,116,55,449,504,video
CompanyJ_7739,October 22nd is opening night and it should be a show Battle of LA in Clippers vs Lakers Zion s debut in Raptors vs Pelicans H T ShamsCharania ,143,2690,13247,15937,photo
CompanyJ_7740,He blocked the shot into the other hoop via _kdot_10 IG ,56,3639,25512,29151,video
CompanyJ_7741,Quinnen Williams was just trying to talk about his Madden rating Via snyjets ,77,2996,14647,17643,video
CompanyJ_7742, If you ain t been a part of it at least you got to witness ,60,1490,13716,15206,photo
CompanyJ_7743,Last time Lakers Clippers played on Christmas it was Kobe s last season ,72,1313,8990,10303,video
CompanyJ_7744, Assist Goal Jadon Sancho goes off as Borussia Dortmund win the German Super Cup against Bayern Munich via brfootball ,118,228,1728,1956,photo
CompanyJ_7745,Joakim Noah s dad went for a swim and caught a fish with his hands via stickity13 Instagram ,92,6844,42510,49354,video
CompanyJ_7746,The Dawg Pound fully embracing OBJ via Browns ,46,2949,20369,23318,video
CompanyJ_7747,Hall of Famer Ed Reed One of the best to ever do it PFHOF19 via NFL ,68,5538,30483,36021,photo
CompanyJ_7748,Astros throw a combined no hitter behind Aaron Sanchez Will Harris Joe Biagini and Chris Devenski Houston beat the Mariners 9 0 ,128,410,2337,2747,photo
CompanyJ_7749,Ed Reed had to thank his barbers in his PFHOF19 speech via NFL brgridiron ,74,342,3424,3766,photo
CompanyJ_7750,40 Pro Bowls 16 All Pro teams 4 Hall of Famers Ed Champ Ty and Tony all set Hall of Fame standards in their careers PFHOF19 ,124,493,3829,4322,photo
CompanyJ_7751,Only 16 and looking BOUNCY via spidadmitchell ,46,6381,37400,43781,video
CompanyJ_7752, x ,3,981,11717,12698,photo
CompanyJ_7753,Imagine a poster dunk contest in the NBA via thetournament PUMAHoops ,69,1227,6239,7466,video
CompanyJ_7754,THIS GOAL LINE CLEARANCE via FA ,32,2604,12813,15417,video
CompanyJ_7755,Manchester City wins the Community Shield via brfootball ,57,341,1653,1994,photo
CompanyJ_7756,Freshman Devontes Cobbs hit his head on the backboard catching the lob via brhoops inspirecourts ,97,370,2930,3300,video
CompanyJ_7757,19 year old double amputee Felipe Nunes shredding at the X Games via felipenunesskate davisonbob IG ,100,2030,10800,12830,video
CompanyJ_7758,Tom Brady is signing a two year extension with New England that will pay him 23M this year per AdamSchefter He becomes the sixth highest paid QB in the league ,159,915,5206,6121,photo
CompanyJ_7759,When Messi addressed Barcelona fans last year he promised them the Champions League One year later he has no regrets and is ready to go again via FCBarcelona brfootball ,169,2072,11020,13092,video
CompanyJ_7760,The Bills nailed that via BuffaloBills ,39,2324,14440,16764,video
CompanyJ_7761,Number neighbors ,17,2592,23161,25753,photo
CompanyJ_7762,Keenan Allen s route running brgridiron via Chargers ,53,8163,43775,51938,video
CompanyJ_7763,When Ozil chipped the keeper and took out two defenders before scoring via brfootball ,86,2098,12841,14939,video
CompanyJ_7764,ISO JOE 4 PT SHOT FTW via CBSSports ,36,4986,23141,28127,video
CompanyJ_7765,OBJ really pulled over his car to sign this Browns fan s license plate Real one brgridiron via cantstick 2 IG beautifullu13 IG ,127,5228,34612,39840,video
CompanyJ_7766,ANOTHER DODGERS WALKOFF via MLB ,32,803,5166,5969,video
CompanyJ_7767,Alejandro Bedoya scored a goal then ran to the on field mic to send a message ,78,2265,13274,15539,photo
CompanyJ_7768,After his dad passed away his girlfriend got him an elephant wearing Alabama Football gear It had one of the last voicemails his dad left him after a football game via xo_haven ,177,8449,61629,70078,video
CompanyJ_7769,She was so excited to meet PatrickMahomes via Chiefs ,53,437,6177,6614,video
CompanyJ_7770,Nobody is out dunking Jimma Gatwech right now via brhoops ,58,4881,22606,27487,video
CompanyJ_7771,Can t catch this 7 year old sprinter on the track or the football field via blaze_813 ,86,1638,9170,10808,video
CompanyJ_7772,NBA Jam in real life via thetricky10 ,37,2146,11466,13612,video
CompanyJ_7773,Boobie Williams left school early to go pro but went undrafted Now he can t land on a team You thought you knew football but I came in here like Oh God I don t know anything ,174,249,1724,1973,photo
CompanyJ_7774,SMOKED HIM via nesha082 ,24,2339,17243,19582,video
CompanyJ_7775,When Eagles WR nelsonagholor gave this kid his gloves via XavierDyer9 ,70,1430,11330,12760,video
CompanyJ_7776,PRECISION via brlive ,21,1790,15518,17308,video
CompanyJ_7777,Vince Carter has agreed to a deal to return to Hawks per wojespn ,65,1714,15013,16727,photo
CompanyJ_7778,Giannis wants the glory for his country ,40,1125,12258,13383,photo
CompanyJ_7779,Tatum Swipa Jaylen Bam All going at it at Team USA practice via NBA ,68,2993,20125,23118,video
CompanyJ_7780,Isan Diaz s dad was being interviewed when his son took Jacob deGrom deep for his first career MLB hit His reaction was amazing via Marlins ,140,1952,9576,11528,video
CompanyJ_7781,Wisconsin WR Aron Cruickshank went full OBJ via BadgerFootball ,63,2543,18197,20740,video
CompanyJ_7782,Drake really has Meek performing in front of a giant Larry O Brien trophy at OVO Fest He s gonna be celebrating the championship all season via laurenonizzle ,158,1339,7814,9153,video
CompanyJ_7783,C DY CRUSHED IT via Dodgers ,28,533,4245,4778,video
CompanyJ_7784,Put the curve on that via ty smith11 IG ,40,411,5240,5651,video
CompanyJ_7785,Arsenal are close to signing Philippe Coutinho from Barcelona on loan this season per BilelGhazi ,97,735,3300,4035,photo
CompanyJ_7786,The James family reminding us what day it is ,45,12581,51406,63987,video
CompanyJ_7787,That Baker Odell connection is looking CLEAN via Browns ,56,1897,15368,17265,video
CompanyJ_7788,IT was cash from deep dropping buckets at Zeke End 2019 Via brhoops ,68,761,6144,6905,video
CompanyJ_7789,John Wall thinks Melo should sign with the Nuggets to close out his career It has to be a franchise you built something with per ChaseHughesNBCS ,145,1580,11132,12712,photo
CompanyJ_7790,Cop walked into the gym and put 20 bets on one on one matchups and then he went to work via jaaassonn_ IG ,106,20212,87420,107632,video
CompanyJ_7791,Kevin Porter Jr was the last pick of the first round but his game might just be the biggest steal via brhoops ,110,1644,11026,12670,video
CompanyJ_7792,Browns were called off the field but Baker wouldn t leave until he took a photo and signed autographs for every soldier who wanted one Respect brgridiron via H_Grove ,166,4065,33330,37395,video
CompanyJ_7793,Sluggers Nelson Cruz and Max Kepler have the Twins looking like legit AL contenders Supercuts ,94,70,460,530,video
CompanyJ_7794, LeVeonBell wants to see Zeke eat brgridiron ,45,506,3410,3916,photo
CompanyJ_7795,David Robinson turns 54 today One of the most underrated legends 2x champ MVP ROY DPOY 71 point game 8x All Def 10x All Star 10x All NBA Quadruple double Never missed playoffs healthy Trails only MJ Bron AD Shaq in PER ,219,2070,13153,15223,photo
CompanyJ_7796,Damion has Cerebral palsy and he just overcame his fear of swimming by himself via DamionG_ ,92,1402,14537,15939,video
CompanyJ_7797,Thoughts ,9,604,7529,8133,link
CompanyJ_7798,7 footer Chet Holmgren put the moves on Steph via brhoops ,58,2079,15849,17928,video
CompanyJ_7799,Steph s head was almost at the rim via 957thegame ,50,958,10234,11192,video
CompanyJ_7800,D Wade was struggling to resist some mini velvet cakes via DwyaneWade ,70,651,6358,7009,video
CompanyJ_7801,12 years ago today BarryBonds hit his 756th home run breaking Hank Aaron s record via Cut4 ,91,1226,6019,7245,video
CompanyJ_7802,Drake really got his own celebration pics with the Larry O Brien Via Drake ,75,1149,9483,10632,photo
CompanyJ_7803,RKO d by his wife via randyorton ,33,17538,75441,92979,video
CompanyJ_7804, Batting 336 Could be first to win batting title in AL amp NL Doesn t try to hit HRs How the Yankees DJ LeMahieu became an MVP candidate ,137,149,842,991,photo
CompanyJ_7805,Steph had to pull out the moves for the top HS players at his camp brhoops ,75,634,5614,6248,video
CompanyJ_7806, This is how you get buckets Kobe dropping knowledge for the next generation of hoopers via MambaSportsHQ ,106,6708,28537,35245,video
CompanyJ_7807,Manchester United and Inter have reached a verbal agreement for Romelu Lukaku per DiMarzio h t brfootball ,106,285,1764,2049,photo
CompanyJ_7808,Hang time amazing Freestyle better via arthurrbaillyy IG jaydensharmann IG ,75,652,4147,4799,video
CompanyJ_7809,Eden Hazard scores his first goal for Real Madrid ,50,218,2097,2315,photo
CompanyJ_7810,NBA will require every team to have a licensed mental health professional on retainer this year per sam_amick ,110,9320,50554,59874,photo
CompanyJ_7811,Kap is still game ready via Kaepernick7 ,40,4772,18398,23170,video
CompanyJ_7812,Simone Biles caught air on this triple double Via USAGym ,57,959,7362,8321,video
CompanyJ_7813,Pop might mess around and throw himself into the starting lineup via usabasketball ,83,4309,31972,36281,video
CompanyJ_7814,Wild via tumi_pitbull IG ,25,3853,18803,22656,video
CompanyJ_7815,KD sets the record straight ,28,1732,11628,13360,photo
CompanyJ_7816,Forever young Happy Birthday to the one and only TurnerSportsEJ via NBAonTNT ,77,583,4939,5522,video
CompanyJ_7817,These kids started trolling Trent Grisham via Cut4 ,51,348,3598,3946,video
CompanyJ_7818,Why d he chuck the ball out the ball park like that via Cut4 ,61,1083,12375,13458,video
CompanyJ_7819,Jalen Suggs 360 windmill via brhoops ,37,520,5014,5534,video
CompanyJ_7820,This RJ Davis cross got Steph shook via brhoops ,48,1267,9894,11161,video
CompanyJ_7821,He caught it while holding a baby via Cut4 ,43,446,4373,4819,video
CompanyJ_7822,Zaire and Bronny banging out via zaire IG ,42,7659,45795,53454,video
CompanyJ_7823,The nominees for the best of the Champions League via brfootball ,65,127,1051,1178,photo
CompanyJ_7824,Twenty seven years ago today the Dream Team featuring NBA players for the first time won gold at the 92 Olympics The team Magic Charles Barkley Chris Mullin John Stockton Karl Malone Clyde MJ Scottie Pippen Larry Bird Patrick Ewing Christian Laettner David Robinson ,266,1730,10579,12309,photo
CompanyJ_7825,The Lakers got AD and the Clippers got Kawhi but the Pelicans really won this NBA offseason ,92,1176,6628,7804,video
CompanyJ_7826,Inter Milan have officially signed Romelu Lukaku from Manchester United via brfootball ,87,799,7756,8555,photo
CompanyJ_7827,USA will pass on the opportunity to add Melo to the FIBA World Cup team ,72,390,3461,3851,photo
CompanyJ_7828,Moneyball Dame_Lillard Big D O L L A drops on 8 9 ,50,5125,20475,25600,video
CompanyJ_7829,Patrick Mahomes no looks gt gt via TomKCTV5 h t brgridiron ,59,1038,9504,10542,video
CompanyJ_7830,Happy birthday to a hoops legend in the making _ajawilson22 2018 No 1 pick 2018 ROY 2x All Star Led South Carolina to their first NCAA hoops title Future is bright ,164,452,2727,3179,photo
CompanyJ_7831,Twenty three To Zero via brfootball ,36,758,4662,5420,photo
CompanyJ_7832,Jadakiss out here in New York doing pull ups on scaffolding in Timbs via Therealkiss ,85,1299,5953,7252,video
CompanyJ_7833,Backheel nutmeg had him slipping via brfootball ,48,652,4880,5532,video
CompanyJ_7834,HOW via domitrick mikechival IG ,32,3184,19667,22851,video
CompanyJ_7835,The Premier League returns Come on down via brfootball ,55,373,1617,1990,video
CompanyJ_7836,Kuz and Swipa having a dunk off via NBA ,40,5883,35859,41742,video
CompanyJ_7837,New pregame routine for Baker brgridiron via Browns ,52,1330,10436,11766,video
CompanyJ_7838,Daniel Jones caps off a perfect drive with a perfect throw via Giants ,70,1054,6149,7203,photo
CompanyJ_7839,Baker was feeling DANGEROUS on his first drive via thecheckdown ,64,2719,21506,24225,video
CompanyJ_7840, I think the system is s t Zlatan goes in on the MLS playoff system via DelmyBarillas ,86,615,4542,5157,video
CompanyJ_7841,Sierra Canyon gonna be special this year via bronny IG h t brhoops ,67,2353,14972,17325,video
CompanyJ_7842,Kyler Murray couldn t miss on his first drive via NFL ,54,622,6197,6819,photo
CompanyJ_7843,Damon Sheehy Guiseppi slept outside a 24 hour gym during Browns tryouts Now he scored his first NFL TD Can t make this up via thecheckdown ,139,21771,92667,114438,video
CompanyJ_7844,Leo Messi wins UEFA Goal of the Season for THAT free kick via brfootball ,73,2751,16814,19565,video
CompanyJ_7845,Kyrie s latest sneaker collab is inspired by his love for Spongebob brkicks ,76,1820,10627,12447,video
CompanyJ_7846,Bron got jokes for Chris Paul and Melo in the gym via CP3 ,58,2371,15565,17936,video
CompanyJ_7847,Tiger Woods withdraws from first round of the FedEx Cup Playoffs due to an oblique strain ,90,108,857,965,photo
CompanyJ_7848,Premier League back today via brfootball ,41,1138,6748,7886,photo
CompanyJ_7849,Eden Hazard has officially been given number 7 at Real Madrid via brfootball ,77,1600,11034,12634,photo
CompanyJ_7850,A new era ,10,656,4362,5018,photo
CompanyJ_7851,AG vs Vinsanity would be a blockbuster Aaron Gordon built his dream dunk contest with 15 ,89,459,3365,3824,video
CompanyJ_7852,DBook DeRozan and Beal were handing out buckets to some college hoopers at the Nike Basketball Academy brhoops ,111,4816,30264,35080,video
CompanyJ_7853,Warriors new backcourt looking like a cheat code ,49,1126,9404,10530,photo
CompanyJ_7854,OBJ got a whole handshake with the little guy via Browns brgridiron ,68,1377,18184,19561,video
CompanyJ_7855,New season same Mo Salah via NBCSportsSoccer ,45,355,2919,3274,video
CompanyJ_7856, obj took off his game shoes and gave them to Damon Sheehy Guiseppi ahead of his NFL debut damon015 who slept outside a 24 hour gym the Browns facility and a beach during tryouts returned his first punt to the house against the Redskins via RichEisenShow brlive ,262,2586,11299,13885,video
CompanyJ_7857,Antonio Brown has told Raiders officials that he will not play again if he doesn t get to wear his old helmet per AdamSchefter ,127,2732,13375,16107,photo
CompanyJ_7858,AB s caption on his latest IG post brgridiron ,46,563,3940,4503,photo
CompanyJ_7859,How AB feels in the new helmet via brgridiron ,46,2252,11558,13810,video
CompanyJ_7860,Wait for it via GolfGuyBo ,26,335,3037,3372,video
CompanyJ_7861,Donovan Mitchell giving his shoes to a couple young fans is what it s all about via NBAKicks ,93,515,7198,7713,video
CompanyJ_7862,Raheem Sterling scores his 50th Premier League goal for Manchester City via NBCSportsSoccer ,92,95,880,975,video
CompanyJ_7863,Just got out in the middle of traffic and started dribbling via abc7 Sokesss ,77,4350,24287,28637,video
CompanyJ_7864,Kofi Kingston s 11 year quest for WWE stardom was about more than a belt Now he s their first ever African born champion It s so important to see someone that looks like you doing incredible things ,198,989,5612,6601,photo
CompanyJ_7865,Simone Biles is the first person EVER to land a dismount with two flips and two twists via NBCOlympics ,103,9045,43883,52928,video
CompanyJ_7866,This chip from neymarjr via psg_english ,40,695,5331,6026,video
CompanyJ_7867,Joao Felix is worth the hype brfootball ,40,543,3473,4016,photo
CompanyJ_7868,Tottenham Hotspur summer signing Tanguy Ndombele with a sensational strike to level things vs Aston Villa via NBCSportsSoccer ,126,334,2010,2344,video
CompanyJ_7869,Heckler Overrated Bryce Harper via Cut4 ,40,6048,35304,41352,video
CompanyJ_7870,Real Madrid are more likely than Barcelona to sign Neymar per le_Parisien ,74,925,5279,6204,photo
CompanyJ_7871,Kyrie took Mike Miller s son s ankles in basement ball via MikeMiller_13 ,73,4585,31880,36465,video
CompanyJ_7872,OKAY BRONNY via bronny IG ,26,2871,20411,23282,video
CompanyJ_7873,THE AUDACITY Jaygup23 via brhoops ,34,2230,11708,13938,video
CompanyJ_7874,Derrick Jones Jr is constantly in flight via debo4real IG dannycasvnova ,72,2641,13208,15849,video
CompanyJ_7875,James Harden gifted a group of family and friends 10K after he saw them fishing for food Incredible via tpizzzle IG ,116,12166,64085,76251,video
CompanyJ_7876,Carlos Correa went 4 7 4 That s the longest HR in Camden Yards history via MLBONFOX ,84,521,3259,3780,video
CompanyJ_7877,Ja Morant turns 20 today Never forget this poster ,50,4607,31991,36598,video
CompanyJ_7878,Derrick Rose and Michael Beasley are now teammates They went No 1 amp No 2 overall in the 2008 draft ,101,3090,23262,26352,photo
CompanyJ_7879,The ref doesn t even flinch via zenit_spb ,42,796,8107,8903,video
CompanyJ_7880,Nate Robinson dropped Big Baby and then buried the game winner via JustinWaltersTV thebig3 ,91,4504,26589,31093,video
CompanyJ_7881,Young fan Louis ran into a lamp post chasing down Mo Salah so Salah came back to meet him and his brother and make sure he was ok via joecooper93 brfootball ,157,615,7186,7801,photo
CompanyJ_7882, JoshAllen41_ was impressive in his pro debut but is he just as good on the golf course From B R x MbyMStrahan x JCPenney ,122,29,301,330,video
CompanyJ_7883,Poster sent him flying via 2fleeTv ,35,720,3303,4023,video
CompanyJ_7884,JUMPMAN 2019 ,13,1128,10652,11780,photo
CompanyJ_7885,Pogba s assist Rashford s touch and finish via NBCSportsSoccer ,63,790,3714,4504,video
CompanyJ_7886,This is what an NFL receiver sees during practice via Raiders brgridiron ,73,3529,22194,25723,video
CompanyJ_7887,Manchester United 4 0 Chelsea Two goals from Rashford Two assists from Pogba Debut goal from 21 year old Daniel James What a start to the season brfootball ,156,2069,8994,11063,photo
CompanyJ_7888, I know he is looking down on me now still driving me on Daniel James father died suddenly three weeks before he joined Manchester United Today he scored on his debut for his new club ,184,709,5165,5874,photo
CompanyJ_7889,Defender wasn t expecting that via ricozulkarnain9 IG ,54,500,3889,4389,video
CompanyJ_7890, I watched you your whole career You re a f king beast Serena Williams had to retire from the Rogers Cup with an injury and her opponent Bianca Andreescu came over to comfort her Respect via Sportsnet ,201,16266,81853,98119,video
CompanyJ_7891,Really got this shot off via playoffmo IG ,42,3508,23358,26866,video
CompanyJ_7892,First game of the season Mbappe goal Of course via brfootball ,62,171,2145,2316,photo
CompanyJ_7893,She s automatic with it via leah_church3 ,41,2330,16393,18723,video
CompanyJ_7894,UNBELIEVABLE via isaiahrivera1 IG ,34,5397,27872,33269,video
CompanyJ_7895,No look Bounced between two defenders Candace Parker with an absolute DIME via LA_Sparks ,89,857,5967,6824,video
CompanyJ_7896,This dude might actually have as much bounce as Zach LaVine via _nickbriz IG ,77,11186,59048,70234,video
CompanyJ_7897, Simone Biles makes history AGAIN Simone_Biles becomes the first woman to land a triple double in competition on floor via NBCOlympics ,135,4994,21251,26245,video
CompanyJ_7898,The half court game has been changed via themoroccanmamba IG ,61,2775,21788,24563,video
CompanyJ_7899,The HEIGHT on Simone Biles historic triple double via NBCOlympics ,66,1348,9653,11001,video
CompanyJ_7900,Raheem Sterling is considering a 121M endorsement deal with Jordan Brand He d be the first soccer player to partner with Air Jordan ,132,2191,13670,15861,photo
CompanyJ_7901,Jah is evolving his game via swishcultures_ MambaSportsHQ ,58,1806,14767,16573,video
CompanyJ_7902,Simone Biles in the past 3 days 1st woman to land double double dismount 1st woman to do triple double in competition on floor Tied for most U S all around titles 6 Unreal ,172,4569,22731,27300,photo
CompanyJ_7903,Rich Paul wants kids to be able to follow his footsteps ,56,759,4613,5372,photo
CompanyJ_7904,16 years ago today Cristiano Ronaldo signed for Manchester United The start of an incredible six seasons brfootball ,116,576,4246,4822,photo
CompanyJ_7905, Son of a former pro Good friends with Vlad Jr Machado calls him incredible Fernando Tatis Jr is electrifying baseball Most exciting young player I ve seen since Ken Griffey Jr ,177,252,1683,1935,photo
CompanyJ_7906,She went around the world in less than a minute and Steph LOVED it via warriorscamp ,84,1431,13608,15039,video
CompanyJ_7907,Turned on the WHEELS via brfootball ,36,4069,20921,24990,video
CompanyJ_7908,The NCAA has removed the bachelor s degree requirement for agents looking to represent players testing the NBA process per InsidetheNCAA Agents must only be certified by the NBPA ,179,7266,26964,34230,photo
CompanyJ_7909,The start of the NBA season Zion debut vs Raptors battle of LA on opening night Celtics vs 76ers on Oct 23 Clippers vs GSW Bucks vs Rockets on Oct 24 Luka vs Zion on Oct 25 ,173,1071,4709,5780,photo
CompanyJ_7910,Can t wait for X Mas day These matchups are cold CoorsLight ,60,729,3909,4638,video
CompanyJ_7911,He got Tacko Fall to sign a picture of a taco via gregorybuono IG ,66,860,10125,10985,video
CompanyJ_7912,Dak Prescott has turned down a 30M year deal and is seeking 40M year per SlaterNFL ,83,2556,12256,14812,photo
CompanyJ_7913,An arbitrator has ruled against AB in his grievance to wear his old helmet per AdamSchefter ,92,446,3000,3446,photo
CompanyJ_7914,Giannis showing out in FIBA exhibitions via FIBAWC ,51,2682,18567,21249,video
CompanyJ_7915,A Rod s car robbed in San Francisco 500k worth of jewelry and electronics stolen per EvanSernoffsky ,100,392,2313,2705,photo
CompanyJ_7916,Brady s been doing this forever brgridiron ,43,890,9363,10253,photo
CompanyJ_7917,It s been a fun MLB season on and off the diamond this year ,60,158,1431,1589,video
CompanyJ_7918,That s tough via TeamJacksonKick ,33,2675,23791,26466,video
CompanyJ_7919,Stephortless via warriorscamp ,30,838,8259,9097,video
CompanyJ_7920,Reigning MVP and WNBA champion Breanna Stewart tore her Achilles playing overseas right before the season started Now 4 months post surgery she s running again via breannastewart ,179,990,10540,11530,video
CompanyJ_7921,Lonzo s new sleeve features MLK Rosa Parks Jackie Robinson Malcolm X Harriet Tubman Barack Obama The Marathon Continues at the top of the arm via stevebutchertattoos IG ,169,17225,83265,100490,video
CompanyJ_7922,CR7 on Messi via brfootball ,28,1111,6363,7474,photo
CompanyJ_7923,Stars vs their former teams in 2019 20 Thread ,46,976,7181,8157,photo
CompanyJ_7924, It s hard for me to see my wife that way and not react Life on fight night can be dangerous and emotional for professional fighters and for their loved ones ,158,17,223,240,photo
CompanyJ_7925,Giants owner John Mara only wants to see Eli at QB1 this season Via SNYGiants brgridiron ,89,123,1061,1184,video
CompanyJ_7926,NFL is forming an entertainment and social justice partnership with Jay Z and Roc Nation per MarkMaske Roc Nation becomes a co producer of the Super Bowl halftime show brgridiron ,179,8237,27300,35537,photo
CompanyJ_7927,Russell Wilson and Ciara have been added to the MLS Seattle Sounders ownership group This is the QB s first stake in a sports ownership brgridiron ,147,1505,9556,11061,photo
CompanyJ_7928,What if dating was like the NBA Via HoHighlights ,49,4333,17839,22172,video
CompanyJ_7929,This is just awesome MoSalah via LFC ,37,737,5627,6364,video
CompanyJ_7930,Pour one out for the one that she accidentally poured out via Cut4 ,67,1395,9957,11352,video
CompanyJ_7931,Bron had the kids join in on Taco Tuesday via KingJames ,56,7088,37168,44256,video
CompanyJ_7932,Champions League winners vs Europa League winners The Super Cup is today brfootball ,84,239,1980,2219,photo
CompanyJ_7933,Magic Johnson turns 60 today Happy birthday to a legend ,56,2938,18638,21576,video
CompanyJ_7934, Are you sure you wanna see it AB showed off his injured feet last night NSFW brgridiron HardKnocks is every Tuesday on HBO ,124,269,1791,2060,video
CompanyJ_7935,This is high school football in Texas via JGriedl ,50,1031,5809,6840,video
CompanyJ_7936,When Sadio Mane left Neuer for dead ,36,237,2036,2273,video
CompanyJ_7937,Terry Rozier says his fallout in Boston had nothing to do with Kyrie Irving A lot of people think that me and Kyrie not cool but we text ,137,194,1717,1911,photo
CompanyJ_7938,Porzingis is putting on muscle Via kporzee ,43,1427,13004,14431,photo
CompanyJ_7939,This Chelsea free kick vs Liverpool was WILD via brlive ,56,185,1761,1946,video
CompanyJ_7940,Jalen Rose says he plays in a high stakes star studded fantasy football league brgridiron 10K buy in Seven years running Mav Carter Draymond play KD got upset and left Bron finished last and stopped playing via GetUpESPN ,221,1778,12721,14499,photo
CompanyJ_7941,Clippers are closing in on hiring Ty Lue to be the top assistant to Doc Rivers per TheSteinLine ,96,1153,7011,8164,photo
CompanyJ_7942,Zion never wants to fall out of love with basketball ,53,226,2618,2844,photo
CompanyJ_7943,Stephanie Frappart becomes the first woman to officiate a major UEFA men s game ,80,226,1744,1970,photo
CompanyJ_7944,Pulisic s assist Giroud s finish via brlive ,44,507,3321,3828,video
CompanyJ_7945,What a goal this would ve been from Pulisic via brfootball ,59,1286,10118,11404,video
CompanyJ_7946,When the believes in you you can t pass it up ,46,133,1416,1549,photo
CompanyJ_7947,DOUBLE SAVE via brfootball ,27,247,2022,2269,video
CompanyJ_7948,K Love amp Liz Cambage want to keep the conversation about mental health going ,79,372,2520,2892,photo
CompanyJ_7949,LeBron gives a tour of his I Promise School via KingJames ,58,2107,11053,13160,video
CompanyJ_7950,J Cole is money from long range via Cbrickley603 ,49,12941,57602,70543,video
CompanyJ_7951,Liverpool win the Super Cup via brfootball ,43,405,1915,2320,photo
CompanyJ_7952,Liverpool s winning save via brlive ,36,292,1752,2044,video
CompanyJ_7953,Sadio Mane gave the ball boy his shirt and a hug ,49,502,5204,5706,video
CompanyJ_7954, JaMorant gets a 79 NBA2K rating High or low ,45,237,5105,5342,photo
CompanyJ_7955,3 years ago today this legendary photo was taken ,49,6912,44124,51036,photo
CompanyJ_7956,Albert Pujols 3 167 passes Adrian Beltre for most hits by a foreign born player in MLB history via Angels ,106,464,5288,5752,video
CompanyJ_7957,The UEFA Player of the Year nominees via brfootball ,52,117,1150,1267,photo
CompanyJ_7958,20 20 20 Nipsey would ve been 34 today russwest44 ,50,15183,48403,63586,video
CompanyJ_7959,5 6 N Golo Kante was marking 6 4 Virgil van Dijk on a corner brfootball ,72,281,3387,3668,video
CompanyJ_7960,Sierra Canyon s whole starting five is Big Tyme brhoops RickRoss ,65,1953,9342,11295,video
CompanyJ_7961,Iso Joe is still a bucket The 7 time All Star can t be stopped in thebig3 ,74,1138,7645,8783,video
CompanyJ_7962,DeMarcus Cousins will undergo testing on possible knee injury had to leave court during Las Vegas workout per wojespn ,118,715,3858,4573,photo
CompanyJ_7963,Breaking DeMarcus Cousins has suffered a torn ACL per ShamsCharania ,68,6414,22158,28572,photo
CompanyJ_7964,Three serious injuries in the last two years Stay strong and get better soon Boogie The game needs you ,103,3621,18692,22313,photo
CompanyJ_7965, 20k custom Chuck Taylors for OBJ Street artist kaiaspire hooked Odell up brgridiron via brkicks ,97,380,2470,2850,video
CompanyJ_7966, He s that good Back from injury Carson Wentz is ready to put his stamp on Philly and become a top five QB ,107,403,1974,2377,photo
CompanyJ_7967,Why d he cross up that child like that Via jamal_ellick IG ,59,5789,28498,34287,video
CompanyJ_7968,Brady keeping his rookies in check brgridiron ,46,1645,17640,19285,photo
CompanyJ_7969,Brotherhood Players around the league send their best wishes to Boogie ,71,1270,8646,9916,video
CompanyJ_7970,22 years ago today the Houston Comets legend Sheryl Swoopes became the first player signed to the WNBA 4x Champion 6x All Star 3x MVP 3x DPOY That s a lot of hardware ,167,1278,6222,7500,photo
CompanyJ_7971,Dale Earnhardt Jr his wife and child are safe after being onboard plane that crashed at an airport in Tennessee per fox8news ,125,557,3657,4214,photo
CompanyJ_7972,The KIDS from Akron via KingJames IPROMISESchool ,49,5585,34668,40253,photo
CompanyJ_7973,That DBook layup DLo Taj Gibson Noah Justise Winslow and more getting a run in via swishcultures_ ,98,3857,23119,26976,video
CompanyJ_7974,Talks of equal pay between the USWNT and the U S Soccer Federation have broken down ,84,212,1530,1742,photo
CompanyJ_7975,Lamar went Madden on this run via thecheckdown ,47,12627,58583,71210,video
CompanyJ_7976,BRYCE HARPER WALK OFF GRAND SLAM via NBCSPhilly ,48,6732,28485,35217,video
CompanyJ_7977,Bronny from the sidelines STEPH via Ballislife ,47,1685,14351,16036,video
CompanyJ_7978, 9 58s Ten years ago today usainbolt set the world record in the 100M dash ,75,1667,9598,11265,photo
CompanyJ_7979,This kid s reaction to getting AB84 s glove via Raiders ,56,1610,13593,15203,video
CompanyJ_7980, If Dolan needs a feature from me I got a hook I got a bridge I ll do his ad libs Whatever you need Just let my people go Bas will do anything to fix the Knicks ,161,283,1462,1745,video
CompanyJ_7981,A heckler told Bryce Harper he was 330M 0 for 3 Harper told him to shut the f k up and then hit a walk off grand slam via schettino10 Edd Barcia ,145,5265,32679,37944,video
CompanyJ_7982,Alabama s WR corps could go down as the greatest group ever assembled They always refer to us as these really fast cars Ferraris Lamborghinis ,142,570,2927,3497,photo
CompanyJ_7983,Cooked them with the footwork via CPFC ,39,417,2971,3388,video
CompanyJ_7984,K Love making 10 reps of 500 pounds look easy via guadango ,59,529,7252,7781,video
CompanyJ_7985,Philippe Coutinho s loan move from Barcelona to Bayern Munich has been agreed per rac1 h t brfootball ,102,497,2474,2971,photo
CompanyJ_7986,Devin Booker handing out lessons to all his defenders via swishcultures_ ChrisJHoops ,85,7248,31376,38624,video
CompanyJ_7987,They were showing off big time via titi_kone arturo6 national IG ,65,1747,10708,12455,video
CompanyJ_7988,Fernando Tatis Jr likely done for the season with back injury per sdutKevinAcee ,80,214,1353,1567,photo
CompanyJ_7989,NFL is reinstating Patriots WR Josh Gordon per AdamSchefter brgridiron ,71,5037,20097,25134,photo
CompanyJ_7990,Jay Z is going to have significant ownership interest in an NFL team per TMZ_Sports brgridiron ,95,470,2618,3088,photo
CompanyJ_7991,Looking forward to more Brady to Gordon this season via thecheckdown brgridiron ,80,1944,12941,14885,photo
CompanyJ_7992,SHEESH SPIDA via NBA ,21,1097,9845,10942,video
CompanyJ_7993,Bill Walton thought this one was gone It wasn t via Cut4 ,57,718,7060,7778,video
CompanyJ_7994,Tyson Fury announces rematch with Deontay Wilder is set for February 22 as long as they both win their next fight per noworneverespn ,133,2304,9005,11309,photo
CompanyJ_7995,Threw himself a MEAN alley via iam_melquan IG NSFW ,51,3785,24066,27851,video
CompanyJ_7996,Shook one nutmegged the other WILD via nbcsportssoccer ,55,990,6700,7690,video
CompanyJ_7997,Sadio Mane with a ROCKET via NBCSportsSoccer ,45,454,3088,3542,video
CompanyJ_7998,Cormier vs Miocic II TONIGHT UFC241 ,36,678,3787,4465,photo
CompanyJ_7999,Kevin De Bruyne s assist is unreal via NBCSportsSoccer ,55,1123,6067,7190,video
CompanyJ_8000,Pizza delivery turned surprise scholarship for a walk on Incredible via Utah_Football ,86,1125,6995,8120,video
CompanyJ_8001,The pitcher really caught that Via SportsTimeOhio ,50,297,2728,3025,video
CompanyJ_8002,Man City vs Tottenham Last minute winner disallowed IT HAPPENED AGAIN ,70,176,1660,1836,photo
CompanyJ_8003,Chris Brown was COOKING em NSFW via chrisbrown ,47,3281,14454,17735,video
CompanyJ_8004,Eli and Daniel Jones on the same wave length via thecheckdown h t brgridiron ,77,1037,12058,13095,video
CompanyJ_8005,Guitar Lance at Rucker via StephensonLance ,43,1291,9341,10632,video
CompanyJ_8006,Drumline obj via djmystro IG brgridiron ,40,4201,27453,31654,video
CompanyJ_8007,Giannis euro was too quick via FIBAWC ,38,1421,12313,13734,video
CompanyJ_8008,This touchdown will make you flip via NFL h t brgridiron ,57,509,5284,5793,photo
CompanyJ_8009,First fight in three years Dominant victory for Nate Diaz UFC241 ,65,5224,21423,26647,photo
CompanyJ_8010, NateDiaz209 wants GamebredFighter Book it now ,47,1215,4505,5720,photo
CompanyJ_8011,IT S TIIIIIIIIIIIIIIIME UFC241 ,31,208,1367,1575,photo
CompanyJ_8012,Stipe Miocic gets his belt back with a KO victory over Daniel Cormier UFC241 ,77,2738,8606,11344,photo
CompanyJ_8013,First fight DC Second fight Stipe Give us the trilogy ,54,1130,6531,7661,photo
CompanyJ_8014,Gotta dance when you get your belt back stipemiocic UFC241 via ufc ,67,444,2077,2521,video
CompanyJ_8015,Stipe got the best of DC tonight UFC241 ,40,725,4939,5664,photo
CompanyJ_8016, JonnyBones calls stipemiocic the heavyweight after beating DC ,63,322,2014,2336,photo
CompanyJ_8017,Lakers and Dwight Howard have mutual interest following Boogie s ACL injury per ShamsCharania ,94,1720,12455,14175,photo
CompanyJ_8018,Nate Diaz says fatherhood hasn t changed him I been a father for years Fatherin all kinds of these little motherf kers NSFW via ufc ,132,4731,20614,25345,video
CompanyJ_8019,On this day last year Cristiano made his Serie A debut 31 games 21 goals Serie A title via brfootball ,102,361,3778,4139,photo
CompanyJ_8020,Former Texas star and NFL running back Cedric Benson has died at age 36 in a reported motorcycle crash R I P ,109,6414,23871,30285,photo
CompanyJ_8021,Happy Birthday ecambage Most points in a single WNBA game 53 PTS 3x WNBA All Star 2011 No 2 overall pick Gold Medal at 2018 Commonwealth Games Keep getting buckets ,164,559,3441,4000,photo
CompanyJ_8022,Maddy Freking is making history She s the first 1st girl since Mo ne Davis to pitch in a Little League World Series and the 19th girl to ever play in LLWS ,155,396,3929,4325,photo
CompanyJ_8023,On this day in 1992 Larry Bird retired at 35 as one of the greatest and most influential to ever play via NBAHistory ,117,4843,26056,30899,video
CompanyJ_8024,Giannis game is even meaner in Greece via FIBAWC ,49,2339,17823,20162,video
CompanyJ_8025,That move via titi_kone Instagram ,34,5775,28000,33775,video
CompanyJ_8026,Most home runs by an NL rookie in MLB history Pete Alonso 40 and counting via Mets ,83,303,2217,2520,video
CompanyJ_8027,Joao Felix already out here ending people in La Liga via LaLigaEN ,66,7257,36177,43434,video
CompanyJ_8028, From our perspective it s time for him to be all in or all out Raiders GM says AB is not at practice because he s still upset about helmet issue via VicTafur h t brgridiron ,174,494,2798,3292,video
CompanyJ_8029,Hit him with the quick 1 2 via trboxing ,40,2782,13588,16370,video
CompanyJ_8030,Denzel Perryman HIT STICK via NFL brgridiron ,45,4268,21469,25737,photo
CompanyJ_8031,Grizzlies are granting Lakers permission to speak with Dwight Howard per ShamsCharania ,87,527,4771,5298,photo
CompanyJ_8032, ZO2_ getting ready via PelicansNBA h t ProsVision1 ,52,2442,14399,16841,video
CompanyJ_8033,James Harden gets up a one legged 3 pointer YooInMedia OneLegChallenge via ricohinesbball ,90,1288,10402,11690,video
CompanyJ_8034,Everyone went wild after he juked him out via LaurierFootball ,62,4249,29125,33374,video
CompanyJ_8035,No one beats The Fridge Via MiLB ,33,1367,9986,11353,video
CompanyJ_8036,Caught him slipping too many times via bilal_dzhabrailov IG ,60,3508,20893,24401,video
CompanyJ_8037,Stephen Curry will sponsor the reboot of Howard University s golf programs for the next six years per CandaceDBuckner ,118,752,4517,5269,photo
CompanyJ_8038,NBA rookies voted on their favorite player in the league LeBron 38 KD 20 Kawhi 8 Dame 8 Book 5 Harden 5 via johnschuhmann ,122,1995,13394,15389,photo
CompanyJ_8039, At guard 6 1 from Serbia Coach Pop staying warm for the FIBA tournament in case USA needs it via spidadmitchell ,113,2353,18081,20434,video
CompanyJ_8040,UH OH brgridiron ,17,2486,13877,16363,photo
CompanyJ_8041,Barcelona plans to make a loan move to PSG for Neymar with obligation to buy per RMCsport brfootball ,101,407,2609,3016,photo
CompanyJ_8042,Louisville s new Muhammad Ali themed uniforms via adidasFballUS UofLFootball ,77,1222,7035,8257,photo
CompanyJ_8043, saquon s elusiveness is next level via kgmadeit1 ,50,1521,14257,15778,video
CompanyJ_8044,8 months after tearing his Achilles Emmanuel Sanders is back and doing this via NFL ,84,1285,12531,13816,photo
CompanyJ_8045,Antonio Brown filed a new grievance against the NFL in an attempt to wear his preferred helmet per AdamSchefter ,112,378,2924,3302,photo
CompanyJ_8046,AD showing out against Jrue Holiday and Jahlil Okafor in front of head coach Frank Vogel via swishcultures_ mrdoitmoving mikepenber3 IG ,136,1607,11429,13036,video
CompanyJ_8047,Got up so high he broke the Big Mac sign via Cardinals ,55,387,4805,5192,video
CompanyJ_8048,Indians pitcher Carlos Carrasco was diagnosed with Leukemia two months ago He returned to action tonight and even got a strikeout Incredible via MandyBell02 ,157,808,8088,8896,video
CompanyJ_8049,16 years ago today an 18 year old Cristiano debuted for Portugal brfootball ,76,359,2248,2607,photo
CompanyJ_8050,Baker s not sold on Daniel Jones brgridiron ,44,264,2204,2468,photo
CompanyJ_8051,Booker We not doubling in open gym I get that s t all season Let s work on our game bro Joakim Yeah we are It s part of the game via swishcultures_ ,148,4812,31480,36292,video
CompanyJ_8052,At Union Berlin s first ever Bundesliga_EN game in their 113 year history fans held up pictures of supporters who died before getting to see the club get there via brfootball ,175,509,2518,3027,video
CompanyJ_8053,Lakers are planning individual workouts for a few big men this week per wojespn Joakim Noah Dwight Howard Mo Speights ,118,773,5465,6238,photo
CompanyJ_8054,Sam Ehlinger became the man of his house at 14 Now he might become the Tebow of Texas Not only same type of player but more important same type of person You only get those players every so often ,196,404,2542,2946,photo
CompanyJ_8055,They burned EVERYONE via brfootball ,36,651,5287,5938,video
CompanyJ_8056,Russ foundation is starting an initiative to promote tech job skills for at risk young adults Programs include coding computer literacy computer engineering robotics 3 D printing drone piloting and more via people ,214,3003,12861,15864,photo
CompanyJ_8057,Today Kawhi announced that every student in three SoCal school districts will receive new backpacks for the school year That s one million backpacks for the kids via LAClippers ,177,2287,14135,16422,photo
CompanyJ_8058,55 yard field goal from Carli Lloyd NAILED IT via CarliLloyd ,61,1281,10193,11474,video
CompanyJ_8059,Little man broke out his dance mid game and his dad wasn t feeling it via brotherswhoball_valentinoluca IG ,107,1865,14115,15980,video
CompanyJ_8060,Stewie out here draining 3s off one leg after rupturing her Achilles just 4 months ago Wow via breannastewart ,110,1282,10172,11454,video
CompanyJ_8061,Squirrel must have season tickets for Twins games via Cut4 ,59,351,3005,3356,video
CompanyJ_8062, TheRealJRSmith hit CJ with a blatant travel and J Cole couldn t help but laugh via Cbrickley603 HoHighlights ,110,3940,23108,27048,video
CompanyJ_8063,Never ever jump NSFW via k_getsbuckets ,39,3793,18739,22532,video
CompanyJ_8064,Why did he scream like that after the shot Via ykOsiris ,56,1614,12035,13649,video
CompanyJ_8065,This is how controllers get broken via u tompalainan h t BRGaming ,66,4062,20913,24975,video
CompanyJ_8066,He dropped them both on one move via FCBmasia ,46,274,2161,2435,video
CompanyJ_8067,LB Jaylon Smith got five years 64M from the Cowboys Been a long road brgridiron Projected top five pick Tore ACL LCL in Fiesta Bowl Drafted in 2nd round Sat rookie year Completed comeback Became defensive star 35 5M guaranteed ,227,1797,12404,14201,photo
CompanyJ_8068,Relax spidadmitchell via daanteee ,34,457,6093,6550,video
CompanyJ_8069,Melvin Gordon s holdout is expected to continue into the season contract talks haven t progressed as he hoped per RapSheet ,123,305,2020,2325,photo
CompanyJ_8070,The NBA had never seen a force like Wilt 100 point game Only player to average more than 40 PTS in a season Seven scoring titles 11 rebounding titles Assists leader 1967 68 2x NBA champion 4x NBA MVP 1972 NBA Finals MVP The Big Dipper would have been 83 today ,260,1052,6419,7471,photo
CompanyJ_8071,He made a huge painting using only a basketball via boubou_design ,66,2320,11121,13441,video
CompanyJ_8072,Thoughts on the double team debate ,35,982,8642,9624,photo
CompanyJ_8073,KD s siding with Book on the double team debate ,48,2142,13404,15546,photo
CompanyJ_8074,Harden says last season was one for the books despite losing MVP race ,70,717,4878,5595,photo
CompanyJ_8075,Why do the Raiders keep doing Hunter Renfrow like this brgridiron HardKnocks is every Tuesday on HBO ,101,1071,6961,8032,video
CompanyJ_8076,Ben gonna break out this 3 point shot during the season via swishcultures_ ,75,5432,29900,35332,video
CompanyJ_8077,Norman Powell bought his mom a 2020 Range Rover for her birthday Is this not the bomb dot com via npowell2404 ,110,746,7701,8447,video
CompanyJ_8078,Carlos Vela is now the owner of the San Jose Earthquakes Too much skill via MLS ,80,4460,20172,24632,video
CompanyJ_8079,LaMelo Ball went off at the Drew League all summer Shout out to the youngest Ball brother on his 18th birthday via brhoops ,123,1683,9216,10899,video
CompanyJ_8080,All respect between Ronaldo and Messi via brfootball ,53,576,4472,5048,photo
CompanyJ_8081,Patrick Mahomes gets surprised with his dream sneaker closet googlenest ,72,130,1278,1408,video
CompanyJ_8082,On this day in 2017 the Kyrie era ended in Cleveland when the Cavs traded Uncle Drew to Boston That run was timeless ,117,1892,10198,12090,video
CompanyJ_8083,You can really get posterized anywhere via johnniewalterr IG ,61,768,5867,6635,video
CompanyJ_8084,Johnny Manziel says he s been to Vegas with Drake and never saw anyone play roulette like him He played the 1K chips like I did the dollar chips via br_betting ,160,434,4178,4612,video
CompanyJ_8085,JR s team is down 10 5 Three possessions later JR s team wins 11 10 via Cbrickley603 ,85,6145,35978,42123,video
CompanyJ_8086,Messi was back in training and dicing everybody up via FCBarcelona ,67,1053,7892,8945,video
CompanyJ_8087,New coach Manny Diaz is trying to bring Miami back through the transfer portal Eight scholarship players are transfers Landed six of the top 22 players in portal ,162,99,597,696,photo
CompanyJ_8088,Unstoppable run via Andrew_Ivins ,33,1108,7456,8564,video
CompanyJ_8089,Browns hype is getting out of hand brgridiron via KolerRyan ,60,342,2574,2916,photo
CompanyJ_8090, ZachLaVine is a whole bucket ,30,2414,12539,14953,video
CompanyJ_8091, No 1 QB in the nation gets buckets Minnesota s No 2 player is top 20 in hoops Mikey Williams can throw 65 yards These young stars aren t held to one sport ,156,529,3613,4142,video
CompanyJ_8092,Bronny is a rock star in China via Ballislife ,46,1016,7395,8411,video
CompanyJ_8093,Carmelo s 12 year old son Kiyan got game via Cbrickley603 ,58,2072,13365,15437,video
CompanyJ_8094,Melvin Gordon pulled up to Popeyes for the new chicken sandwich but they ran out via Melvingordon25 ,100,776,6484,7260,video
CompanyJ_8095,Cam Newton leaves Gillette Stadium in a walking boot on his left foot via NBC10_FrankCarp ,90,598,4228,4826,video
CompanyJ_8096, Everything that these guys protest I ve lived it I ve experienced it Dolphins coach Brian Flores opened up about Kenny Stills and player protests via 7SportsXtra ,163,1508,7208,8716,video
CompanyJ_8097,He was salty Pop didn t give him an interview via 7AFL ,55,742,5941,6683,video
CompanyJ_8098,Kobe turns 41 today 4 1 5 Happy birthday to the 5x champion ,60,7838,34497,42335,photo
CompanyJ_8099,Eli Manning takes young QBs under his wing while Joe Flacco views everything as a competition Inside the complicated QB mentorship dynamic ,139,89,841,930,photo
CompanyJ_8100,Gai Chol stands 7 feet tall from Sudan Hooping like this he s gonna be a problem down the line brhoops ,103,500,3766,4266,video
CompanyJ_8101,She was handing out buckets and the kid recording couldn t help but commentate via Jamaaad ,91,15876,61241,77117,video
CompanyJ_8102,Tua and Trevor Lawrence enter the season as Heisman favorites Will one of them be holding the hardware at the end of the season CaesarsPalace ,142,32,254,286,video
CompanyJ_8103, Kris Breezy about to hit a bomb This fan called Bryant s HR before the pitch via egsports05 ,93,547,5092,5639,video
CompanyJ_8104,Dwight Howard is finalizing buyout with Grizzlies and plans to sign with Lakers per ShamsCharania ,98,3831,16177,20008,photo
CompanyJ_8105,Lakers fans rn ,15,3640,13403,17043,video
CompanyJ_8106,Updated look at the Lakers roster Rajon Rondo Danny Green LeBron James Anthony Davis Dwight Howard Kyle Kuzma KCP JaVale McGee Avery Bradley Quinn Cook Jared Dudley Alex Caruso Talen Horton Tucker ,197,5065,22099,27164,photo
CompanyJ_8107, antrelrolle26 and Santana Moss both played at Miami so loser of their NCAA football game had to bet on Florida for tomorrow s game NSFW via br_betting ,152,322,1897,2219,video
CompanyJ_8108,Jacob deGrom becomes first pitcher in the modern era 1900 to record 13 K s and hit a HR multiple times in a season ,115,467,3266,3733,photo
CompanyJ_8109,Ronald Acuña Jr joins Mike Trout as the only players to record a 30 HR and 30 SB season under age 22 ,101,1068,6440,7508,photo
CompanyJ_8110,MICHAEL IRVIN IS READY FOR MIAMI VS FLORIDA via MikeCugnoCBS4 ,62,3814,18747,22561,video
CompanyJ_8111,Didi Gregorius makes it a grand trip to the West Coast for the Yankees via Yankees ,83,680,3476,4156,video
CompanyJ_8112,From 8 to 24 Kobe s killer instinct was unmatched Happy MambaDay ,65,9252,32399,41651,video
CompanyJ_8113,Bronny out at 5am working on his dunk via KingJames ,52,3490,30633,34123,video
CompanyJ_8114,Chelsea legend Frank Lampard gets his first Premier League win as manager brfootball ,85,603,6926,7529,photo
CompanyJ_8115,Team USA s final FIBA World Cup roster Harrison Barnes Jaylen Brown Joe Harris Brook Lopez Khris Middleton Donovan Mitchell Mason Plumlee Marcus Smart Jayson Tatum Myles Turner Kemba Walker Derrick White ,204,544,3794,4338,photo
CompanyJ_8116,Russ and YG feeling it at James Harden weekend in Houston via Power106LA NSFW ,78,1899,8425,10324,video
CompanyJ_8117,The poster in jeans sent him stumbling via Derond4 ,51,619,4431,5050,video
CompanyJ_8118,THIS STRIKE WOW via NBCSportsSoccer ,36,622,4676,5298,video
CompanyJ_8119,Mohamed Sanu was Dwayne Haskins coach in Pop Warner Mentor and mentee swapping jerseys via NBCSRedskins h t brgridiron ,119,1071,7695,8766,video
CompanyJ_8120,OH NO DE GEA Manchester United lose to Crystal Palace in the Premier League for the first time via NBCSportsSoccer ,115,346,2527,2873,video
CompanyJ_8121,Gilbert Arenas changed the game says Jason Richardson Then injuries and the gun incident sent his legacy into a free fall The former point guard reflects on his career and where he is now from the BIG3 to training with Bronny Jr ,229,288,1379,1667,photo
CompanyJ_8122,Jrue Holiday is 1st team defense But Quincy didn t want to listen to Rondo Via swishcultures_ ,94,1819,10322,12141,video
CompanyJ_8123,They used to call Julio Jones Waffle House in high school via AtlantaFalcons h t brgridiron ,92,1518,8808,10326,video
CompanyJ_8124,After training with Bronny Gilbert Arenas sees something special ,65,1079,7066,8145,photo
CompanyJ_8125,MO SALAH UNSTOPPABLE via NBCSportsSoccer ,41,822,4559,5381,video
CompanyJ_8126,Liverpool vs Arsenal at Anfield since 2017 LFC 3 1 Arsenal LFC 5 1 Arsenal LFC 4 0 Arsenal LFC 3 1 Arsenal 15 3 aggregate brfootball ,133,808,2474,3282,photo
CompanyJ_8127,Won t be long before MambaDay is dedicated to Kobe and Gigi Bryant ,67,459,3049,3508,video
CompanyJ_8128,Thompson x Harrier Baecation Klay is a vibe ,44,2826,20115,22941,photo
CompanyJ_8129,Alabama Clemson rematch coming br_betting CaesarsPalace ,56,32,272,304,video
CompanyJ_8130,Throwing out garbage Adding to the laundry If there s a shot to take maxisnicee knows it s time to yell Kobe MambaDay ,118,957,5265,6222,video
CompanyJ_8131,Kobe dishes out new challenges for MambaDay ,44,2773,8983,11756,video
CompanyJ_8132,Six fans were injured after a lightning strike hit the PGA Tour Championship at East Lake Golf Club in Atlanta per NBCPhiladelphia ,131,95,538,633,photo
CompanyJ_8133,TURNOVER CHAIN IS BACK ,23,1549,7337,8886,photo
CompanyJ_8134, TOUCHDOWN RINGS Miami is the iciest team in college football via CanesFootball ,80,2022,9144,11166,video
CompanyJ_8135,Miami s Turnover Chain through the years via CanesFootball ,59,1045,4735,5780,photo
CompanyJ_8136,Lights turned out as soon as the right hand connected via ScottCoker ,69,348,1993,2341,video
CompanyJ_8137,Breaking Andrew Luck has informed the Colts he is retiring from the NFL per AdamSchefter h t brgridiron ,104,10695,30196,40891,photo
CompanyJ_8138,Andrew Luck is retiring after seven seasons 2012 No 1 overall NFL draft pick 171 touchdown passes 23 671 yards 4 Pro Bowls 2018 NFL AP Comeback Player of the Year 53 33 record Made the most of his time in the NFL brgridiron ,224,4703,19283,23986,photo
CompanyJ_8139,Andrew Luck gets booed walking off the field as fans learn about his reported retirement via RichNye13 h t brgridiron ,118,3307,13383,16690,video
CompanyJ_8140,Retiring wasn t easy for Luck brgridiron ,41,430,3599,4029,photo
CompanyJ_8141, It hurt Luck spoke on Colts fans booing him after his retirement h t brgridiron ,81,1854,16299,18153,link
CompanyJ_8142, SnoopDogg reflects on kobebryant s final game and what he means to the Lakers amp Los Angeles MambaDay ,104,749,3314,4063,video
CompanyJ_8143,Luck always knew when to give props via thecheckdown h t brgridiron ,68,4612,28473,33085,video
CompanyJ_8144,29 years old Still wild ,24,1686,19880,21566,photo
CompanyJ_8145,Patty Mills dropped 30 for Australia in Team USA s first loss in nearly 13 years Pop s had enough via OlgunUluc ,112,788,6681,7469,video
CompanyJ_8146,James Harden is making a 240K donation to renovate Houston basketball courts in underserved communities H T BenDuBose ,118,1551,10158,11709,photo
CompanyJ_8147,Filthy from Firmino via LFC ,28,512,3945,4457,video
CompanyJ_8148, paulpogba via brfootball ,26,440,2333,2773,photo
CompanyJ_8149,Colts have reached financial settlement with Andrew Luck and will not take back any of the money they are owed per AdamSchefter Indy could ve recouped 24 8M ,157,1696,12692,14388,photo
CompanyJ_8150, Dame_Lillard s first iconic buzzer beater wasn t even drawn up for him Saw an opportunity and took it via HoHighlights ,120,1825,10416,12241,video
CompanyJ_8151,No easy buckets with Lance on the blacktop NSFW via bridgeblanco IG ,68,2314,14939,17253,video
CompanyJ_8152,Beard wants the step back to become part of his legacy Mike has his fadeaway and Dirk has his one leg and Kareem Abdul Jabbar had the sky hook I want my step back to be one of those moves that last forever via espn_macmahon ,224,1889,11861,13750,video
CompanyJ_8153,GRIEZMANN First Barcelona goal via brfootball ,46,502,5893,6395,photo
CompanyJ_8154,BROWNS 3 16 Baker to Stone Cold is a dangerous duo brgridiron via Browns ,73,4086,24279,28365,video
CompanyJ_8155,The love between Iverson and Philly is so real You can feel it in this speech via NatalieEgenolf ,97,1343,7539,8882,video
CompanyJ_8156,Griezmann went KingJames after scoring twice in his Barca home debut via brfootball ,84,796,7698,8494,photo
CompanyJ_8157,James Harden hits an RBI single at his celebrity baseball game in Houston via ashleeonair ,90,207,2135,2342,video
CompanyJ_8158,Crowd in San Diego thought they were getting Sweet Caroline via Padres ,71,2530,12604,15134,video
CompanyJ_8159,Aaron Judge A promised a home run tonight B hit a home run tonight C has a home run in every game this series D all of the above via Yankees ,141,1139,6705,7844,video
CompanyJ_8160,Arm strength Accuracy Wow via ev_eis0812 addisoncoquillard IG ,62,803,7114,7917,video
CompanyJ_8161,Aaron Gordon and Dennis Smith Jr decided to start their own dunk contest via ManVsParty ,88,3115,21232,24347,video
CompanyJ_8162,Zlatan wasted no time opening ElTraffico with a goal for the Galaxy via MLS ,76,1272,8161,9433,video
CompanyJ_8163,Child s play for Zlatan 5th goal in his last 2 games vs LAFC via MLS ,69,615,3539,4154,video
CompanyJ_8164,Steph played streetball and traded buckets with the guy he was guarding via wet paint IG ,89,3034,21891,24925,video
CompanyJ_8165,Celebrations inspired by the NBA via brfootball ,48,764,5619,6383,photo
CompanyJ_8166,T Y s gonna ball for his old QB via brgridiron ,47,792,10545,11337,photo
CompanyJ_8167, InternationalDogDay ,21,565,4089,4654,photo
CompanyJ_8168,This bicycle kick is unreal via Esp_Interativo ,47,938,5540,6478,video
CompanyJ_8169,James Harden turns 30 today He s coming off one of the greatest scoring seasons ever 36 1 PPG Leader in FGs 3s PTs FTs 28 40 point games Nine 50 point games Two 60 point games Scoring champ by 8 1 PPG Highest PPG ever besides MJ and Wilt ,238,3809,17234,21043,photo
CompanyJ_8170,Spida s biggest fan got to rebound for him via NBA ,51,724,7742,8466,video
CompanyJ_8171,To the top of the minivan via haydenriggs_2 IG ,47,369,4010,4379,video
CompanyJ_8172,Little man played with a heavy heart and dedicated his championship to his late sister Respect to him via yenkee060606 IG ,122,6743,38950,45693,video
CompanyJ_8173,KD in the comments NSFW H T TheWarriorsTalk ,44,3727,28286,32013,photo
CompanyJ_8174,Mayweather vs McGregor was two years ago today Mayweather won by TKO in the 10th round Mayweather took home 275M McGregor took home 85M ,136,1838,8871,10709,photo
CompanyJ_8175,Boogie married longtime girlfriend Morgan Lang over the weekend Matt_Barnes22 He s been through a lot of late so I m happy to see him smile be able to take his mind off his injury and enjoy his day via TMZ_Sports ,213,3809,28510,32319,video
CompanyJ_8176,Romelu Lukaku scores on his Inter Milan debut via brfootball ,61,330,3935,4265,photo
CompanyJ_8177,Dwight has cleared waivers and is signing his Lakers contract He plans to wear No 39 per ShamsCharania ,103,938,7552,8490,photo
CompanyJ_8178,Jon Jones puts rivalry with Daniel Cormier aside to offer his condolences ,74,2250,20474,22724,photo
CompanyJ_8179,Zlatan has dominated LAFC in El Trafico via brfootball ,55,247,2154,2401,photo
CompanyJ_8180,DSJ put on a show and went off for 50 at the Crawsover via brhoops ,67,1285,7618,8903,video
CompanyJ_8181, Drake rocking a Bronny jersey in the Money in the Grave video ,63,1169,9605,10774,photo
CompanyJ_8182,Serena Williams defeats Maria Sharapova in the first round of the US Open Serena moves to 20 2 all time vs Sharapova in head to head matches ,141,3111,9474,12585,photo
CompanyJ_8183,Melo teaching his son Kiyan his ways Gotta listen up when dad has one of the best scoring arsenals in NBA history via Cbrickley603 ,131,5031,26209,31240,video
CompanyJ_8184, KingJames had to give it up to Ken Griffey Jr for his iconic swing ,68,743,7970,8713,photo
CompanyJ_8185,It was unlikely Ryan Shazier would ever walk again after his injury Now he s not only walking but throwing and catching the football Inspiration via TDavenport_NFL brgridiron ,175,2144,16041,18185,video
CompanyJ_8186,Jeremy Lin announces he ll play for the Beijing Ducks in China next season ,75,2303,21740,24043,photo
CompanyJ_8187,PSG are willing to sell Neymar to Barcelona in exchange for Ousmane Dembele Nelson Semedo and 111M per le_Parisien h t brfootball ,130,529,2969,3498,photo
CompanyJ_8188,NBA stars were turning out highlight reels at pickup runs all summer ,69,1072,7388,8460,video
CompanyJ_8189,Reporter was going to get the job done no matter what via MatchTV ,66,1497,8944,10441,video
CompanyJ_8190, All for you coach Their coach had cancer so the O line shaved their heads with him Powerful via michaelhullett3 ,113,7378,36686,44064,video
CompanyJ_8191,USWNT star CarliLloyd is seriously considering pursuing a career as an NFL kicker per MrogersFOX Hit 55 yard FG at Eagles practice Several NFL teams have been in touch One team offered her a preseason spot ,206,1821,12262,14083,video
CompanyJ_8192,D Eriq King s dad warned him At 5 10 or 5 11 you have to prove you can play quarterback Then he scored 50 TDs at Houston last season after coaches tried to make him a WR ,170,880,4473,5353,photo
CompanyJ_8193,TMZ leaks audio of DeMarcus Cousins allegedly threatening to shoot ex GF for not letting their son attend his wedding ,118,1933,7727,9660,photo
CompanyJ_8194,Aaron Gordon was doing much more than just dunking at the Seattle Crawsover Via brhoops ,88,672,5667,6339,video
CompanyJ_8195,Happy Birthday to a legend in the making breannastewart Reigning WNBA MVP WNBA Champion Finals MVP 2016 ROY 2x WNBA All Star 4x NCAA champ 4x NCAA tourney MOP Olympic gold 2x World Champion That s a lot of hardware for a 25 year old ,233,638,4215,4853,photo
CompanyJ_8196,Gator didn t stop him golfing via steellafferty ,48,1425,11258,12683,video
CompanyJ_8197,This weekend 16 year old Ansu Fati became the youngest player to play for Barcelona in 78 years Living the dream leomessi IG ,125,582,5382,5964,photo
CompanyJ_8198,Bat flip was necessary after launching it like this via dancanobbio IG ,71,1649,11443,13092,video
CompanyJ_8199,It was just business for AB brgridiron ,39,699,4881,5580,photo
CompanyJ_8200,Falcons WR Mo_12_Sanu can throw harder than league MVP PatrickMahomes Ditch the Playbook with AdamLefkoe premieres Sept 4 ,122,401,2358,2759,video
CompanyJ_8201,U S tennis player Nicole Gibbs comeback is incredible Had to withdraw from French Open after dentist discovered rare form of cancer Targeted comeback at Wimbledon qualifiers but opted out after post surgery complications Made U S Open cut after another player withdrew ,269,118,1362,1480,photo
CompanyJ_8202,Kansas City Royals owner David Glass is negotiating sale of team to Cleveland Indians minority owner John Sherman for over 1 billion per JeffPassan ,148,213,866,1079,photo
CompanyJ_8203,COMEBACK COCO The 15 year old takes care of business in the opening round to move on in the US Open ,100,1216,7955,9171,photo
CompanyJ_8204,Pete Alonso now has the Mets single season record for home runs with 42 He s only a rookie via SNYtv ,101,433,3228,3661,video
CompanyJ_8205,100 for 99 Aaron Judge is the third fastest player to reach 100 home runs in MLB history via Yankees ,101,821,5347,6168,video
CompanyJ_8206,Baby Fournette runs just like dad via _fournette ,49,817,4384,5201,video
CompanyJ_8207,There must be a trampoline on the court via teamflightbros ,59,3171,23607,26778,video
CompanyJ_8208, NickKyrgios got the crowd on its feet after this one USOpen via usopen ,72,143,1193,1336,video
CompanyJ_8209,Set the World Record for consecutive half court shots 7 via bigscrip76 ,71,312,2898,3210,video
CompanyJ_8210, Knock on wood if you re with me Gruden putting out bangers HardKnocks airs Tuesday nights on HBO ,98,208,1790,1998,video
CompanyJ_8211,One arm Still balling via hanselenmanuel IG ,44,1411,8614,10025,video
CompanyJ_8212, I should be first round talent Ke Shawn Vaughn is the best RB in the SEC so he decided to stay in school another year when he heard he d be drafted third round ,161,137,815,952,photo
CompanyJ_8213, RedWineDay ,12,533,4707,5240,photo
CompanyJ_8214,Jazz announce they re bringing back the mountain unis ,54,8163,71865,80028,photo
CompanyJ_8215,J R s not on the team anymore but he still wants the shorts ,60,525,6619,7144,photo
CompanyJ_8216,Kobe sets the record straight ,30,595,5315,5910,photo
CompanyJ_8217,Texans running two on two games on garbage cans in the locker room brgridiron via JJWatt ,89,1829,16217,18046,video
CompanyJ_8218,,0,1742,13633,15375,photo
CompanyJ_8219,This back heel goal via brfootball ,35,209,1844,2053,video
CompanyJ_8220,Jags DC Todd Wash says Jalen Ramsey will shadow Tyreek Hill in Week 1 Last year Ramsey called Hill a return specialist via APMarkLong ,134,1681,8446,10127,video
CompanyJ_8221,How d he make that via themoroccanmamba IG ,43,725,6564,7289,video
CompanyJ_8222,Burned him twice via brlive ,28,193,1992,2185,video
CompanyJ_8223,Can t touch MJ brkicks ,23,1098,7195,8293,photo
CompanyJ_8224,ISO Joe making his NBA return Joe Johnson will work out for 76ers tomorrow expected to work out for Clippers Bucks amp Nuggets as well per MarcJSpearsESPN ,155,2253,10404,12657,photo
CompanyJ_8225,Popeyes or Chick fil A Chick fil A seems to be the true meal of choice for athletes ,84,153,1454,1607,video
CompanyJ_8226,After announcing he was diagnosed with Leukemia last month Indians are expected to activate pitcher Carlos Carrasco this Sunday per MLBNetworkRadio ,148,660,5332,5992,photo
CompanyJ_8227,Andrew Luck s NFL career was a rollercoaster of events h t brgridiron ,70,90,664,754,video
CompanyJ_8228, The_ColeAnthony gonna be special at UNC this year via Cbrickley603 ,68,1850,9738,11588,video
CompanyJ_8229,Dominique Wilkins daughter JoJo is an inspiration to all via DWilkins21 ,72,3026,27554,30580,video
CompanyJ_8230,Chad Johnson literally in tears describing tae15adams route running NSFW via ochocinco ,87,4136,18436,22572,video
CompanyJ_8231,Barcelona and PSG are close to agreeing a deal for Neymar per DiMarzio h t brfootball ,86,800,4249,5049,photo
CompanyJ_8232, SHAQ is way too big for the Smart car via adamglyn ,52,4095,19539,23634,video
CompanyJ_8233,The opening of the new Champions League season the UCLDraw via brfootball ,74,480,1997,2477,video
CompanyJ_8234,The original goal for JJWatt s Hurricane Harvey relief fund was 200K He just posted a two year update 40M raised 239M meals served 1 183 homes rebuilt 971 childcare centers rebuilt 108 731 kids brgridiron ,205,3387,20680,24067,photo
CompanyJ_8235,Patrick Mahomes used to be scared of dogs now he s got two that are 70 lbs googlenest ,86,171,2148,2319,video
CompanyJ_8236,Nets Wilson Chandler facing 25 game suspension after testing positive for PED use per wojespn ,94,285,1518,1803,photo
CompanyJ_8237,Leonard Fournette exiled himself to Wyoming lived out of a hotel for three months and dropped 20 pounds He s ready for 2019 S t I got better man ,145,1435,10919,12354,photo
CompanyJ_8238, ,1,471,3807,4278,photo
CompanyJ_8239,KD and Kyrie are pushing Nets to sign Melo Brooklyn remains interested in potentially signing him per TheFrankIsola ,116,4927,21400,26327,photo
CompanyJ_8240,Ronaldo s reaction to Messi winning UCL Forward of the Season via brlive ,73,2143,13485,15628,photo
CompanyJ_8241,Get ready brfootball ,21,396,1550,1946,photo
CompanyJ_8242,Virgil van Dijk wins the UEFA Men s Player of the Year ,55,378,2401,2779,video
CompanyJ_8243,Juventus vs Atletico Madrid in the group stage Last time they faced each other in the UCL 27 Ronaldo 1 0 Atleti 49 Ronaldo 2 0 Atleti 86 Ronaldo 3 0 Atleti ,156,693,4606,5299,video
CompanyJ_8244,Ronaldo on his and Messi s rivalry We shared this stage for 15 years me and him It s good to be part of the history of football via brfootball ,143,9270,42506,51776,video
CompanyJ_8245,Kap and Kobe at the U S Open cheering on Naomi Osaka ,53,2845,22216,25061,photo
CompanyJ_8246,An arrest warrant has been issued for DeMarcus Cousins on a domestic violence charge per byajperez ,99,3273,11418,14691,photo
CompanyJ_8247,When you find out you have to play Barcelona Dortmund and Inter Milan via brlive ,81,430,3390,3820,video
CompanyJ_8248, Sign Steph Draymond and Klay to lifetime deals If E40 was GM of the Warriors ,78,173,1189,1362,video
CompanyJ_8249,That hand speed Mo_12_Sanu Ditch the Playbook with AdamLefkoe premieres Sept 4 ,79,127,1110,1237,video
CompanyJ_8250,Soon UCL brfootball ,20,125,925,1050,photo
CompanyJ_8251,Zo had some words for the Lakers in his new single ,51,3007,19419,22426,photo
CompanyJ_8252,WHAT AN UPSET Taylor Townsend takes down No 4 Simona Halep in the 2nd round Her first win against a top 10 opponent USOpen ,123,322,1304,1626,photo
CompanyJ_8253,Carli Lloyd isn t afraid of the NFL spotlight ,46,157,1963,2120,photo
CompanyJ_8254,JOSH GORDON IS BACK via NFL ,28,1996,12793,14789,photo
CompanyJ_8255,CFB BACK It s gonna be as wild as last season champssports ,59,404,5380,5784,link
CompanyJ_8256,9 0 YARDS TO THE HOUSE Travis Etienne ties Clemson s record for longest run in school history via CBSSportsHQ ,110,927,5239,6166,video
CompanyJ_8257,Gael Monfils broke out the 360 for the WIN via Eurosport_ES ,60,776,3977,4753,link
CompanyJ_8258,COCO GAUFF MOVES ON CoCo vs Naomi Osaka next USOpen ,52,2580,10553,13133,photo
CompanyJ_8259,Carli Lloyd did the FlyEaglesFly celebration after scoring a goal in Philly via FOXSoccer ,90,225,1750,1975,video
CompanyJ_8260,HE CAUGHT THAT via BigTenNetwork ,33,1920,10900,12820,video
CompanyJ_8261,Hurdle season via Pac12Network ,31,1245,9484,10729,video
CompanyJ_8262,Kenyon Martin Jr will attend IMG for a post grad year and enter the NBA Draft next spring via brhoops ,102,900,7813,8713,video
CompanyJ_8263, via SHAQ ,10,4272,33499,37771,photo
CompanyJ_8264,Jerry Jones gives update on Ezekiel Elliott I m operating as though right now he s going to miss regular season games per jonmachota ,133,392,2297,2689,photo
CompanyJ_8265,Ronaldo s face at the end of Cantona s speech says it all via brfootball ,73,699,4747,5446,video
CompanyJ_8266, I m so unloyal but I m loyal Snoop has repped so many soccer teams even he was shocked by the list brfootball ,111,479,2223,2702,video
CompanyJ_8267, QuinnenWilliams got on FaceTime with fans that were standing outside his bus What a real one brgridiron via jacobjcohen IG ,124,697,5677,6374,video
CompanyJ_8268,It s amazing how in depth MLB players go when picking out their walk up songs Justin Turner will text me in the middle of the night asking Is this a banger ,156,35,460,495,photo
CompanyJ_8269,He hurdled him and made two others hit each other via askboutrayy IG h t HoHighlights ,86,3464,22904,26368,video
CompanyJ_8270,Kid s balance and focus on via rgally29 ,40,2193,16499,18692,video
CompanyJ_8271,Melo amp Julius Randle in the gym together via tylerrelph10 ,60,1101,8471,9572,video
CompanyJ_8272,Pop playing heads up is pure comedy via Original_Turner ,56,923,6425,7348,video
CompanyJ_8273,He s breaking out new moves via isaiahrivera_1 ,47,1209,8779,9988,video
CompanyJ_8274,Kobe wasn t looking for any games off ,38,4544,23639,28183,photo
CompanyJ_8275,They really spilled all over the signed Chiefs jersey Ditch the Playbook with AdamLefkoe premieres Sept 4 ,106,40,365,405,video
CompanyJ_8276,Wisconsin RB Jonathan Taylor hit the ground running in their season opener 183 total yards 4 total TD s 8 4 yards per carry Heisman endorsement from Mahomes Set the bar high in Week One ,186,827,6836,7663,photo
CompanyJ_8277,Eric Gordon and Rockets agree to 4 year 76M max contract extension per ShamsCharania ,85,1189,8486,9675,photo
CompanyJ_8278,Game winner from 56 Scholarship postgame Life changing night for NevadaFootball freshman kicker Brandon Talton ,111,972,7401,8373,video
CompanyJ_8279,CFB Saturdays are back and the mascots are ready ,49,531,2708,3239,photo
CompanyJ_8280,The Bills are releasing RB LeSean McCoy per AdamSchefter ,57,1278,5621,6899,photo
CompanyJ_8281,The road to the College Football Playoff starts now Who can run the table ,74,3493,20516,24009,video
CompanyJ_8282,The roast happening between torylanez and ykOsiris is pure comedy Where s the 1v1 footage ,90,1850,8362,10212,video
CompanyJ_8283,Seahawks are deep in talks for Jadeveon Clowney per TomPelissero The Texans star has told people he wants to be in Seattle ,123,552,3759,4311,photo
CompanyJ_8284,Getting fit for the season and breaking records doing it UGA has the most dedicated strength training in college sports ,120,527,3288,3815,video
CompanyJ_8285,Hurts Eason Bryant Or Fields Which transfer will have the best season of the bunch ,83,365,3244,3609,photo
CompanyJ_8286,Seahawks and Texans have agreed to trade parameters on Jadeveon Clowney based on Clowney and other players passing physicals per JayGlazer ,139,1666,5702,7368,photo
CompanyJ_8287,Seahawks Texans trade is being finalized Seattle receives Jadeveon Clowney Houston receives Third round pick LB Jacob Martin Pass rusher Barkevious Mingo via RapSheet ,167,1677,7024,8701,photo
CompanyJ_8288,The Heisman Race is set to be a special one this season ,56,272,2207,2479,photo
CompanyJ_8289,Justin Fields making BIG impressions early in OSU debut Touchdown on 1st drive Via CFBONFOX ,92,1721,8440,10161,video
CompanyJ_8290,What really goes down in the NFL MasterTes is letting you know Untold Stories drops Sept 5 ,91,43,260,303,video
CompanyJ_8291,16 year old Ansu Fati scores his first goal for Barcelona ,58,1369,10769,12138,photo
CompanyJ_8292,Contract talks between Zeke and the Cowboys are intensifying and both sides aim to wrap up a new deal this weekend per AdamSchefter ,132,1344,6483,7827,photo
CompanyJ_8293,Messi is kind of important Barcelona has one win in their last eight without him via BRfootball ,96,176,1193,1369,photo
CompanyJ_8294,CLOWNEY TO SEATTLE That defense just got a whole lot meaner via brgridiron ,75,1328,8749,10077,photo
CompanyJ_8295,The line to bet on CFB Week 1 never ends br_betting ,52,98,777,875,video
CompanyJ_8296,Hurdle had him tackling the air via CBSSportsNet ,49,566,3260,3826,video
CompanyJ_8297,Team USA s quest for gold starts tomorrow Name some of the past teams coldest moments CoorsLight ,97,127,948,1075,video
CompanyJ_8298,F2 driver Anthoine Hubert has passed away after a crash He was 22 years old Hearbreaking ,89,494,2918,3412,photo
CompanyJ_8299,Howard University after this 3rd quarter ,41,6602,33118,39720,photo
CompanyJ_8300,The Kentucky band made a 2 2 to honor former star QB Jared Lorenzen who died in July He went on to play for the Giants R I P via SECNetwork ,140,526,5814,6340,video
CompanyJ_8301,Hands team He was ready via CFBONFOX ,37,300,2620,2920,video
CompanyJ_8302,The Crimson Tide suffered a devastating championship loss last season and are looking for redemption ,101,317,2158,2475,video
CompanyJ_8303,Smoked by Kavosiey Smoke via SECNetwork ,40,363,2573,2936,video
CompanyJ_8304,The Browns are waiving Damon Sheehy Guiseppi the undrafted WR who talked his way into a tryout and slept outside a 24 hour gym before it Shoutout to Damon for chasing his dream brgridiron ,188,4046,28360,32406,photo
CompanyJ_8305,Last time Auburn played Oregon at the 2011 BCS National Championship Game Bo Nix was a 10 year old fan Now he s a true freshman QB starting for the Tigers tonight ,163,3084,17126,20210,photo
CompanyJ_8306,Dolphins are trading LT Laremy Tunsil and WR Kenny Stills to Texans for huge package of picks per RapSheet h t brgridiron ,122,1243,5113,6356,photo
CompanyJ_8307,Neymar told his family he s staying at PSG this season after months of pursuing a return to Barcelona according to lequipe ,123,270,1936,2206,photo
CompanyJ_8308,NFL cutdown day Clowney traded to Seahawks Shady cut by Bills Texans trade for Tunsil Stills amp Hyde Myles Jack signs 57M extension Pats cut Demaryius Browns cut Sheehy Guiseppe McKinnon out for year Melvin Gordon allowed to seek trade brgridiron ,248,3211,15929,19140,video
CompanyJ_8309,WHAT A GRAB NHTSAgov ,21,597,3702,4299,video
CompanyJ_8310,Tua making his Heisman case early 26 31 passing 336 yards 4 TDs Tide rolls over Duke 42 3 ,90,1089,6678,7767,photo
CompanyJ_8311,Two of tennis brightest stars go head to head Naomi vs Coco This is gonna be good ,82,682,4232,4914,photo
CompanyJ_8312,Potential Heisman candidate Justin Herbert is throwing dimes all 2019 ,70,267,1658,1925,video
CompanyJ_8313,Naomi Osaka moves on after beating Coco Gauff in the third round of the US Open ,80,809,5495,6304,photo
CompanyJ_8314,Respect The future of tennis is in good hands via usopen ,57,4071,25747,29818,video
CompanyJ_8315,Hit em with the Iverson stepover via NBCSNorthwest ,51,2371,13232,15603,video
CompanyJ_8316,Josef Martinez just dunked on the Philadelphia Union via FoxSportsSouth ,72,577,2944,3521,video
CompanyJ_8317,Minnesota Twins have set the record for most home runs hit in a season with 268 ,80,461,3850,4311,photo
CompanyJ_8318,Almost 10 years since their National Championship game Ducks lose another close one to the Tigers ,98,1234,6236,7470,video
CompanyJ_8319,LeSean McCoy and Chiefs agree to 1 year 4M deal per AdamSchefter brgridiron ,76,1935,13565,15500,photo
CompanyJ_8320,Bo Nix knows comeback victories NHTSAgov ,41,540,4341,4881,video
CompanyJ_8321,Defender HUSTLED for an unreal double stop on the goal line via MatchTV ,72,2778,14892,17670,video
CompanyJ_8322,When Ronaldo scored his first goal of the season he told fans not to celebrate in case VAR ruled it out h t brfootball ,119,710,7620,8330,photo
CompanyJ_8323,What a moment ,14,185,1796,1981,photo
CompanyJ_8324, GridironHeights is BACK Season 4 drops 9 3 ,44,257,1689,1946,photo
CompanyJ_8325,The touch the chip the goal Incredible from the USMNT s Josh Sargent via FOXSoccer ,83,571,3544,4115,video
CompanyJ_8326,Perfect placement on the assist via NBCSportsSoccer ,52,310,2688,2998,video
CompanyJ_8327, SHAQ was back in the pit via LADiesloveLAD ,44,934,6390,7324,video
CompanyJ_8328,Joao Felix has arrived The 19 year old scores his first La Liga goal via brfootball ,84,196,2169,2365,photo
CompanyJ_8329,Bare hand beer hand fan catch of the year candidate via BlueJays ,65,1209,9805,11014,video
CompanyJ_8330,Taunting him ended up backfiring via BTSportBoxing ,51,4959,25548,30507,video
CompanyJ_8331,Chargers GM Tom Telesco says contract extension talks with RB Melvin Gordon will be suspended until after the season per AdamSchefter h t brgridiron ,149,376,2428,2804,photo
CompanyJ_8332,JUSTIN VERLANDER NO HITTER Astros ace tosses his third career no no to become only the 6th pitcher in MLB history with at least three ,134,2227,10248,12475,photo
CompanyJ_8333,Nationals reenacted the Lion King in the dugout via Cut4 ,57,174,1355,1529,video
CompanyJ_8334,Serena moves on to the US Open quarterfinal Victory in straight sets 118 MPH ace on match point 52nd major quarterfinal appearance ,131,635,3430,4065,photo
CompanyJ_8335,Ray Allen explains to his kids the importance of free throws and how to be clutch in uncomfortable situations via trayfour IG ,126,3510,19140,22650,video
CompanyJ_8336,Grind don t stop via KingJames ,31,4024,26687,30711,photo
CompanyJ_8337,No 1 Novak Djokovic concedes with an injury down 6 4 7 5 2 1 to No 23 Stanislas Wawrinka at USOpen ,99,212,1258,1470,photo
CompanyJ_8338,Jalen Hurts was doing it all for the Sooners ,45,2575,17262,19837,video
CompanyJ_8339,From one No 1 to the next Oklahoma is in good hands with Jalen Hurts ,69,679,9028,9707,photo
CompanyJ_8340,Lionel Messi Cristiano Ronaldo and Virgil van Dijk are the finalists for FIFA s TheBest Men s Player via brfootball ,116,239,2054,2293,photo
CompanyJ_8341, DwyaneWade getting down with Pat Riley on a yacht in Saint Tropez Retirement life ,83,6823,38087,44910,video
CompanyJ_8342,Didn t go as he expected via realdanieljay1 ,44,1390,8629,10019,video
CompanyJ_8343,Browns waived Damon Sheehy Guiseppi but the WR will always have obj s respect brgridiron ,89,175,1877,2052,photo
CompanyJ_8344,NFL BACK A lot to look forward to this week on brgridiron ,58,135,814,949,photo
CompanyJ_8345,Melo on potentially joining KD and Kyrie in Brooklyn That s family That s bigger than basketball If something happens something s gonna happen via TMZ_Sports ,158,1700,12154,13854,photo
CompanyJ_8346,Gilbert Arenas says MJ told Kobe after a Wizards Lakers game that he could wear the shoes but never fill them Kobe got so mad that he didn t speak to teammates for two weeks When LA played the Wizards again Mamba dropped 55 via The No Chill Podcast balldontstop ,262,6186,27329,33515,photo
CompanyJ_8347,Turn had the defenders colliding via koshish10 IG ,50,779,6355,7134,video
CompanyJ_8348,No 1 and defending champion Naomi Osaka upset by No 13 Belinda Bencic in the U S Open Round of 16 Osaka lost in straight sets ,126,368,2243,2611,photo
CompanyJ_8349, Dame_Lillard says it s all respect between him and Russ NSFW via HoHighlights ,79,1852,10440,12292,video
CompanyJ_8350,Everything you see on Sundays starts in the offseason NFL stars put in work this summer via brgridiron ,103,434,3490,3924,video
CompanyJ_8351,50 days until the new NBA season ,33,16393,58185,74578,photo
CompanyJ_8352,This Alex Caruso mix goes hard via Lakers ,42,9180,43690,52870,video
CompanyJ_8353,Former captain Mauro Icardi officially joins PSG on a season long loan from Inter Milan brfootball ,99,334,2647,2981,video
CompanyJ_8354,Following the Neymar saga all transfer window via brfootball ,61,251,2279,2530,photo
CompanyJ_8355,Lonzo found out he got traded on Twitter via BigBoy Real923LA ,62,865,5615,6480,video
CompanyJ_8356,Browns LB Christian Kirksey paid homage to Nipsey on his visor via Kirko58 h t brgridiron ,90,4800,22530,27330,photo
CompanyJ_8357,Rafa made this no look look easy Wow via usopen ,48,293,2404,2697,video
CompanyJ_8358,Layup was on expert mode via themoroccanmam1 ,45,258,2776,3034,video
CompanyJ_8359,Ball was hit right to him via MLB ,34,436,4455,4891,video
CompanyJ_8360,Nadal UNBELIEVABLE Tiger loves it as Rafa moves on to the US Open quarterfinal via usopen ,90,1247,7975,9222,video
CompanyJ_8361,That move via tv_bball ,23,3332,23733,27065,video
CompanyJ_8362,Jalen Hurts turned it up in his Sooners debut ,46,636,5359,5995,photo
CompanyJ_8363,Same talent new teams ,22,2564,16476,19040,photo
CompanyJ_8364,Coming soon brkicks ,20,63,948,1011,photo
CompanyJ_8365,Browns are in the Super Bowl conversation after bringing in some f king dudes to change the culture ,100,498,4472,4970,photo
CompanyJ_8366,Laid him out via NRL ,21,2264,8481,10745,video
CompanyJ_8367,Khalil Mack heading into Thursday night s season opener vs Green Bay I m so ready to hit somebody ,98,4272,31635,35907,photo
CompanyJ_8368,The opening weekend of CFB lived up to the hype champssports ,61,24,148,172,link
CompanyJ_8369,Juice thinks Odell doesn t deserve the criticism ,49,298,2731,3029,photo
CompanyJ_8370,3x WNBA champion Sue Bird will miss the remainder of the 2019 WNBA season and playoffs after undergoing successful knee surgery earlier this season Gonna miss this passing in the playoffs via seattlestorm ,205,367,2702,3069,video
CompanyJ_8371,HIS OWN TEAM via ZSturgill h t BRGaming ,40,490,3921,4411,video
CompanyJ_8372,Cris Cyborg becomes highest paid woman in MMA history after signing contract with Bellator per ScottCoker ,106,348,2324,2672,photo
CompanyJ_8373,Lane Kiffin s FAU backfield will feature Frank Gore Jr son of the five time Pro Bowler in 2020 ,95,648,4756,5404,video
CompanyJ_8374,Is Zeke ready to re join the Cowboys I ve been ready via MikeLeslieWFAA h t brgridiron ,87,2155,14150,16305,video
CompanyJ_8375,One team has been in preliminary communications with Chargers about a potential Melvin Gordon trade per JosinaAnderson brgridiron ,130,430,3042,3472,photo
CompanyJ_8376, GridironHeights Season 4 Premiere AB Andrew Luck and Zeke hijack the wild offseason playstation ,97,1028,3948,4976,video
CompanyJ_8377,Rams and QB Jared Goff have agreed to 4 year extension per MikeSilver h t brgridiron ,85,420,3553,3973,photo
CompanyJ_8378, kevinlove spoke about decision to open up about his mental health struggles TheShopHBO via uninterrupted ,106,1660,8855,10515,video
CompanyJ_8379,DOWN GOES FEDERER No 78 ranked Grigor Dimitrov upsets No 3 Roger Federer in 5 sets to advance to USOpen semifinals ,115,766,3197,3963,photo
CompanyJ_8380,Fan had the catch of the night via MLB ,39,648,6279,6927,video
CompanyJ_8381,King of fits via brkicks h t brgridiron ,40,347,4230,4577,photo
CompanyJ_8382,Breaking ZEKE GOT PAID Cowboys sign Ezekiel Elliott to a six year 90M extension with roughly half guaranteed Highest paid RB in the NFL per RapSheet and SlaterNFL ,163,11159,33103,44262,photo
CompanyJ_8383,Zeke showing up back at practice today via thecheckdown ,56,4509,26643,31152,photo
CompanyJ_8384,N Golo Kante surprised this Chelsea fan at his wedding and then stayed til the end via FrankKhalidUK ,101,168,1835,2003,video
CompanyJ_8385,Jax is only two years old and he knows the name and position of all the Yankees players before the alphabet Via bohan ,118,628,4583,5211,video
CompanyJ_8386,THIS DUNK IS WILD via abscbnsports ,35,6485,30753,37238,video
CompanyJ_8387,2019 was the summer of obj Browns hype New look Custom Rolls Unforgettable fan moments brgridiron ,98,561,5488,6049,video
CompanyJ_8388, Mo_12_Sanu has a CANNON The Falcons WR launches a football farther than 28 starting NFL QBs including his own QB Matt Ryan on the debut of Ditch the Playbook StateFarm ,169,757,3618,4375,video
CompanyJ_8389, GOATs are f kin made You don t start out that way NSFW TheShop is streaming on HBO ,84,2226,11303,13529,video
CompanyJ_8390,Shareef and Bronny will be in the league in no time brhoops ,60,1136,9158,10294,photo
CompanyJ_8391,After riding the bench for three years at Ohio State QB Joe Burrow has turned LSU into the most dangerous team in the league ,125,587,3112,3699,photo
CompanyJ_8392,Man was really flying through the air via OmarGooddness ,56,4033,26277,30310,video
CompanyJ_8393,OBJ pulled up with Kap s jersey before they put some work in together brgridiron via Kaepernick7 ,97,6518,26507,33025,video
CompanyJ_8394,Lonzo says his manager had to carry extra ZO2s because they d rip every quarter brkicks via lighthartedpod ,107,3861,19511,23372,video
CompanyJ_8395,Put him in a blender ,21,224,2148,2372,video
CompanyJ_8396,Happy Birthday to the queen of courtside Beyonce ,49,818,5999,6817,photo
CompanyJ_8397, Hurts Eason Fields Transfer QBs put up Heisman numbers in their new homes ,75,230,1885,2115,video
CompanyJ_8398, ,1,945,9947,10892,photo
CompanyJ_8399,Lonzo getting adjusted to the NOLA lifestyle and gators via ZO2_ ,65,1869,15503,17372,video
CompanyJ_8400,Brand new look at Bron s 2K Nike LeBron 17 colorway via KingJames h t brkicks ,78,1213,10551,11764,photo
CompanyJ_8401,Deion Sanders is the only athlete ever to score an NFL touchdown and hit an MLB home run in the same week 30 years ago today 3 for 5 with HR pair of doubles Five days later returns punt 68 yards for a TD in his NFL debut Legend ,228,14652,64530,79182,photo
CompanyJ_8402,The best game of TheRealC_Portis career came while he was severely hungover as a rookie vs the Cards in 2002 He still balled out 228 yards 2 TDs Watch the debut of Untold Stories with MasterTes ,194,306,1333,1639,video
CompanyJ_8403, PatrickMahomes and his girlfriend brittanylynne8 share embarrassing photos from back in the day on their Google Nest Hub Max googlenest ,137,74,881,955,video
CompanyJ_8404,KD week 12 update ,18,2090,14783,16873,photo
CompanyJ_8405,Antonio Brown and Raiders GM Mike Mayock got into it on Wednesday and the team is planning to suspend AB per AdamSchefter ,122,2096,9551,11647,photo
CompanyJ_8406,Antonio Brown and Raiders GM Mike Mayock did not get physical but AB told Mayock he would hit him in the face Then he punted a ball and said Fine me for that via RapSheet ,171,3982,20108,24090,photo
CompanyJ_8407,NFL season is here and bets are rushing in before kickoff These lineups could wind up being big wins in Week 1 YahooFantasy ,124,24,197,221,video
CompanyJ_8408,He literally drove it to the basket via kodiaksimpson ,54,1367,9290,10657,video
CompanyJ_8409,Season starts tonight Drop the team that s gonna make you money br_betting ,75,62,488,550,video
CompanyJ_8410,Brett Favre tries to one up Pat Mahomes no look pass via SNFonNBC ,66,2316,14108,16424,video
CompanyJ_8411,Raiders are not planning to have WR Antonio Brown for Week 1 unclear if it s a suspension or if AB will be inactive per RapSheet ,129,340,1792,2132,photo
CompanyJ_8412,Last season Aaron Rodgers led the Packers back from down 20 0 and beat the Bears on this 75 yard DIME via NFL ,110,996,7169,8165,photo
CompanyJ_8413,Tonight the climb begins brgridiron ,36,198,1250,1448,video
CompanyJ_8414,Aaron Rodgers worst nightmare via thecheckdown ,47,3823,27180,31003,video
CompanyJ_8415,First TD of the season for Aaron Rodgers via thecheckdown ,58,754,6233,6987,video
CompanyJ_8416,Amos who spent first four years with Bears picks up the BIG TIME INT via NFL ,77,976,7950,8926,photo
CompanyJ_8417,Packers march into Soldier Field and win their season opener 10 3 brgridiron ,77,1565,8842,10407,photo
CompanyJ_8418, brgridiron ,12,4906,32941,37847,photo
CompanyJ_8419,How did one of the most talented offenses of all time fall apart Tomlin created a monster in Big Ben Le Veon AB felt betrayed AB called his QB a f king phony mikefreemanNFL brings you inside the downfall of Pittsburgh s Big 3 ,226,246,1347,1593,photo
CompanyJ_8420,AD s impression of Bron on Taco Tuesday is on point But the King said Davis wasn t fun enough via NBA2K ,104,1433,12007,13440,video
CompanyJ_8421,Falcons WR Mo_12_Sanu has a cannon but his throw power rating in Madden is only a 72 He launched balls in front of a ratings adjustor to try to improve it on the debut of Ditch the Playbook StateFarm ,200,356,2491,2847,video
CompanyJ_8422,There might be a real chance that AB avoids suspension and even plays on Monday per RapSheet ,93,856,6790,7646,photo
CompanyJ_8423,Casually walking past LeBron no big deal via uninterrupted ,59,8282,59796,68078,video
CompanyJ_8424,Antonio Brown will play Monday night per VicTafur brgridiron ,61,1501,7945,9446,photo
CompanyJ_8425, ,1,10419,49656,60075,photo
CompanyJ_8426,Artist Klaus Littmann planted a forest in an Austrian stadium to raise awareness for climate change and deforestation Incredible h t brfootball ,144,507,3681,4188,photo
CompanyJ_8427,One pitch two hitters This batting practice is wild via schumdog18 IG ,70,1037,8425,9462,video
CompanyJ_8428,Antonio Brown s heel turn late last year caught a lot of teammates by surprise brgridiron ,90,417,4196,4613,photo
CompanyJ_8429, DustinPoirier s path to UFC gold is amazing 8 3 at featherweight until loss to McGregor Moves to lightweight wins seven Performance amp Fight of the Night bonuses Wins over three champs before winning interim LW belt Can hand Khabib his first career loss at UFC 242 ,267,185,1151,1336,photo
CompanyJ_8430,Bradley Beal gives John Wall a special birthday toast via 5deepjak IG ,70,1405,9430,10835,video
CompanyJ_8431,Raiders fined Antonio Brown an unspecified amount for his behavior in recent interaction with GM Mike Mayock per WerderEdESPN He s been fined and he s not happy ,161,460,3670,4130,photo
CompanyJ_8432, ochocinco has never made a sports bet in his life That s about to change Ocho joins the debut of the br_betting Show ahead of Week 1 this Sunday Submit your betting questions in the B R app NOW ,195,36,309,345,video
CompanyJ_8433, Knock on wood if you re with me brgridiron ,44,1193,10697,11890,photo
CompanyJ_8434,Mexico picks up another W in the USA via brfootball ,52,703,3971,4674,photo
CompanyJ_8435,Serena in another US Open final Greatness never changes ,56,998,6253,7251,photo
CompanyJ_8436,AB wrote Release me to the Raiders in his IG caption ,53,1656,7435,9091,photo
CompanyJ_8437,Raiders voided Antonio Brown s 29 125M guaranteed money in his deal after fining him 215 073 53 for conduct detrimental to the team per AdamSchefter h t brgridiron ,164,1678,6390,8068,photo
CompanyJ_8438,Zaire is the mood this weekend with 2K out now Via DwyaneWade ,62,2077,15729,17806,video
CompanyJ_8439,Julio Jones Falcons finalizing multi year extension that will make him NFL s highest paid receiver per TomPelissero brgridiron ,127,2043,11902,13945,photo
CompanyJ_8440,Breaking Raiders have released Antonio Brown brgridiron ,56,7306,27053,34359,photo
CompanyJ_8441,Raiders fans after the team released Antonio Brown via brgridiron ,66,1528,7703,9231,video
CompanyJ_8442,Antonio Brown is a now an unrestricted free agent He s clear to sign with any team Agent Drew Rosenhaus says he s looking forward to a new beginning via adamschefter ,166,1631,8281,9912,photo
CompanyJ_8443,AB s time in Oakland Cryotherapy frostbite Helmet grievance Threatened retirement All in or all out Posts fine on IG Gets into it with GM Apologizes no suspension Posts Gruden phone convo Guarantees voided Asks for release Cut ,227,5477,24450,29927,photo
CompanyJ_8444,Julio Jones and Falcons agree to 3 year 66M guaranteed contract extension per AdamSchefter h t brgridiron ,106,1409,8501,9910,photo
CompanyJ_8445,Gruden is finished with the AB saga via brgridiron ,51,1936,9581,11517,video
CompanyJ_8446,Steelers mood via brgridiron ,29,1089,5536,6625,video
CompanyJ_8447, Zionwilliamson threw down in the Air Jordan 34 in Harlem New York via brkicks ,79,823,6910,7733,video
CompanyJ_8448,No 1 Clemson Tigers face their first test of the season vs the No 12 Texas A amp M Aggies ,90,248,2226,2474,photo
CompanyJ_8449, MICHIGAN HOLDS ON No 7 Michigan escapes Army in 2OT 24 21 ,59,566,4143,4709,photo
CompanyJ_8450,Time to see who s the real champ Khabib vs Poirer UFC242 ,57,309,1833,2142,photo
CompanyJ_8451,Trevor Lawrence under pressure is something special via CBSSportsHQ ,68,603,4258,4861,video
CompanyJ_8452,AND STILL Khabib Nurmagomedov beats Dustin Poirier by submission in Round 3 to retain the UFC lightweight championship 28 0 UFC242 ,131,3440,8972,12412,photo
CompanyJ_8453,Antonio Brown is close to signing a deal with the Patriots per MasterTes brgridiron ,84,5293,14342,19635,photo
CompanyJ_8454,Breaking Antonio Brown has agreed to terms with the Patriots per MasterTes ,75,10478,27614,38092,photo
CompanyJ_8455,Belichick does it again ,24,6470,25977,32447,photo
CompanyJ_8456,AB gets the last laugh Brown and Pats reach agreement on 1 year deal worth up to 15M 9M signing bonus per AdamSchefter ,119,3947,12166,16113,photo
CompanyJ_8457,We ve seen this before brgridiron ,34,7464,27104,34568,photo
CompanyJ_8458, AB84 was on cloud nine after the Raiders released him h t alesticktalk brgridiron ,83,6491,26923,33414,video
CompanyJ_8459, UPSET No 15 Bianca Andreescu upsets No 8 Serena to win the USOpen ,67,909,4140,5049,photo
CompanyJ_8460,The showdown of the week is in Austin Who ya got ,49,133,975,1108,video
CompanyJ_8461,AB and Brady Prestige Worldwide via brgridiron ,47,3107,11915,15022,video
CompanyJ_8462,Antonio Brown Josh Gordon Julian Edelman Demaryius Thomas Pats wide receiver corps gonna be scary via brgridiron ,113,4314,22018,26332,photo
CompanyJ_8463,Pretty toss from Ehlinger even better grab from Eagles via CBSSportsHQ ,71,276,1919,2195,video
CompanyJ_8464,Tua made it look easy 16 24 passing for 227 yards 3 TDs and he didn t play the full game ,89,305,3142,3447,video
CompanyJ_8465,Joe Burrow has the Tigers looking good in Austin LSU up 20 7 at half vs Texas via CBSSportsHQ ,94,314,1893,2207,video
CompanyJ_8466,Had to know BYU was getting the upset after their player tossed the Tennessee QB s shoe ,88,542,5032,5574,video
CompanyJ_8467,LSU dagger sad McConaughey ,27,1340,12239,13579,photo
CompanyJ_8468,Joe Burrow and Justin Jefferson leave no doubt in LSU s matchup vs Texas Tigers beat the Longhorns 45 38 via CBSSportsHQ ,121,657,3261,3918,video
CompanyJ_8469,Joe Burrow went off in No 6 LSU s win vs No 9 Texas ,52,1060,6078,7138,photo
CompanyJ_8470,LSU plants team flag in Texas via JacquesDoucet ,48,1821,11199,13020,video
CompanyJ_8471,WEEK 1 IS HERE brgridiron ,26,1028,6431,7459,photo
CompanyJ_8472,Zion had NYC in awe Via game_stopper IG ,40,1203,9024,10227,photo
CompanyJ_8473,The OBJ era begins in Cleveland today About to be dangerous via brgridiron ,75,3214,17719,20933,video
CompanyJ_8474,Le Veon Jimmy G Cooper Kupp Happy to have all these guys back brgridiron ,73,249,1940,2189,video
CompanyJ_8475,Mahomes coming with MVP energy again in 2019 via Chiefs ,56,2134,15247,17381,video
CompanyJ_8476,Baker has Cleveland ROCKING early via Browns ,45,2960,19628,22588,video
CompanyJ_8477,Rookie JoshAllen41_ could learn a lot from a former Pro Bowler who proved he was much more than scouts predicted From B R x mbyMstrahan JCPenney ,145,17,209,226,video
CompanyJ_8478,WEEK 1 LET S GO ,16,549,2453,3002,photo
CompanyJ_8479,THAT WAS QUICK Mahomes to Sammy Watkins gets the 2019 season started via thecheckdown ,86,2828,18197,21025,video
CompanyJ_8480,OBJ s first catch as a member of the Browns via thecheckdown ,61,1262,10021,11283,video
CompanyJ_8481,Vernon Davis TOOK FLIGHT on his way to the endzone via nfl ,59,2197,10833,13030,photo
CompanyJ_8482,Adam Thielen getting comfortable in the end zone already 6 via thecheckdown ,76,288,2642,2930,video
CompanyJ_8483,Nick Foles with an absolute DIME via thecheckdown ,50,978,6860,7838,video
CompanyJ_8484,Hollywood Brown has arrived 2 catches 130 yards 2 TDs Lamar has his go to via thecheckdown ,91,7580,41288,48868,video
CompanyJ_8485,Sammy Watkins is decimating the Jags 4 catches 151 yards 2 TDs via thecheckdown ,80,1562,11225,12787,video
CompanyJ_8486,Vernon Davis grandfather passed away yesterday The veteran TE broke down in tears after his epic touchdown to begin the game Powerful via FOXSports ,148,15586,107548,123134,video
CompanyJ_8487,Florida s own Lamar Jackson will NOT let up on the Dolphins Fourth passing TD of the first half via thecheckdown ,113,2310,16523,18833,video
CompanyJ_8488,D Jax is back 51 yards He s home Via thecheckdown brgridiron ,61,1515,7092,8607,video
CompanyJ_8489,Lamar Jackson had six passing touchdowns last year He has five today ,69,2988,18868,21856,photo
CompanyJ_8490,Le Veon said he was ready to unleash in his Jets debut He wasn t lying via NFLonCBS ,84,547,4028,4575,photo
CompanyJ_8491,SAMMY WATKINS 9 catches 198 yards 3 TDs ,40,2727,19042,21769,photo
CompanyJ_8492,Odell is playing with a watch worth 350k He s really on Richard Mille time brgridiron ,86,6008,29560,35568,photo
CompanyJ_8493,RGIII welcomed a daughter last night and is wearing his wife s hospital bracelet He just came in for Lamar and threw a touchdown brgridiron via Ravens ,151,2105,20123,22228,photo
CompanyJ_8494,Logan Ryan broke out the chalk toss in Cleveland after picking off Baker The disrespect via thecheckdown ,105,1346,9239,10585,video
CompanyJ_8495,All Lamar today 17 20 324 yards 5 TD 59 10 W ,45,5271,24949,30220,photo
CompanyJ_8496,Cleveland s season starts with a dud Titans win 43 13 ,54,2083,11140,13223,video
CompanyJ_8497,Lamar heard all the talk via brgridiron ,40,2718,15217,17935,photo
CompanyJ_8498,Titans TE Delanie Walker wasn t impressed by the Browns after the Titans beat them by 30 They were who we thought they were via TDavenport_NFL ,143,4666,23911,28577,video
CompanyJ_8499,Tyreek Hill is expected to miss a few weeks after going to hospital with shoulder injury per RapSheet No surgery required ,122,272,2014,2286,photo
CompanyJ_8500,Malik Hooker with ONE HAND via Colts ,37,4354,21874,26228,photo
CompanyJ_8501,Seahawks rookie D K Metcalf rocking a pacifier mouthpiece in his NFL debut brgridiron ,86,1441,10726,12167,photo
CompanyJ_8502,Game on the line and T Y refused to go down via thecheckdown ,61,678,6238,6916,video
CompanyJ_8503,Dak and the Cowboys wrangled the Giants in Dallas winning 35 17 brgridiron 25 32 passing 405 yards 4 TD 158 3 passer rating ,124,1814,5505,7319,photo
CompanyJ_8504,COMEBACK KYLER ALL TIED AT 24 via NFL ,38,1032,6975,8007,photo
CompanyJ_8505,6 rings Brady is a savage via brgridiron ,41,1125,4749,5874,video
CompanyJ_8506,Kyler to Fitz on the via NFL ,29,1565,11775,13340,photo
CompanyJ_8507,Michael Bennett or T Challa playing for the Patriots via thecheckdown ,70,4241,21735,25976,video
CompanyJ_8508,Josh Gordon would not be denied on his way to this TD Flash is back via thecheckdown ,85,5699,38133,43832,video
CompanyJ_8509,Rafael Nadal beats Daniil Medvedev in five sets to win 19th career Grand Slam singles title at the USOpen ,106,976,4967,5943,photo
CompanyJ_8510,Josh Gordon really held onto this via thecheckdown ,51,2646,24228,26874,video
CompanyJ_8511,Time hasn t slowed Brady down in year 20 24 36 passing 341 yards 3 TD Pats cruise to 33 3 win over Steelers ,108,3092,15534,18626,photo
CompanyJ_8512, kobebryant s Mambas got their revenge ,39,4712,37808,42520,photo
CompanyJ_8513,Bill Belichick on the AB signing via NBCSBoston ,48,1131,8669,9800,video
CompanyJ_8514,D Jax says he will warm up in cleats honoring Nipsey Hussle every game and auction them off Proceeds will go to Nipsey s family That s real brkicks ,148,2696,15682,18378,photo
CompanyJ_8515,Year 20 and counting brgridiron ,32,801,7693,8494,photo
CompanyJ_8516,Historic production from De11eDonne ,36,430,2496,2926,photo
CompanyJ_8517,The FIFA20 Top 10 brfootball ,29,652,3775,4427,photo
CompanyJ_8518,2013 sixth round pick David Quessenberry missed three seasons because of cancer He returned in 2017 but got waived last fall Quessenberry suited up for the Titans on Sunday brgridiron ,184,1454,13646,15100,photo
CompanyJ_8519,Joe Burrow forcing his way into the Heisman convo ,50,359,2100,2459,photo
CompanyJ_8520,This angle of Malik Hooker s one handed pick via jayrivera_66 ,62,2397,17928,20325,video
CompanyJ_8521,LeBron promptly held conversations with LA higher ups expressing that AD should be the offensive focal point as soon as the trade went down per ChrisBHaynes ,157,926,7970,8896,photo
CompanyJ_8522,Griezmann with the no look back heel nutmeg pass FILTHY via OptusSport ,71,1315,9560,10875,video
CompanyJ_8523,Brow s coming for DPOY ,23,1412,12170,13582,photo
CompanyJ_8524,Raptors to make Brittni Donaldson the NBA s 10th female assistant coach and the youngest 26 after spending two years as a data analyst for the team via ZachLowe_NBA ,165,541,4298,4839,photo
CompanyJ_8525,Lynn Swann has resigned as athletic director at USC ,52,309,1952,2261,photo
CompanyJ_8526,The NBA is banning ninja style headwear this season according to WojESPN ,73,2210,14517,16727,photo
CompanyJ_8527,Dwight Howard throwing down at Venice Beach via coopersurles tracidsurles IG ,77,1132,10260,11392,video
CompanyJ_8528,Drew Brees has us ready to run through a brick wall via Saints ,63,5034,24591,29625,video
CompanyJ_8529,Big Papi is at Fenway to throw tonight s first pitch What an ovation via joonlee ,81,750,3999,4749,video
CompanyJ_8530,June David Ortiz was shot in the Dominican Republic September Big Papi returns to Boston to toss the first pitch at Fenway via joonlee ,135,914,5287,6201,video
CompanyJ_8531,WILL FULLER HOW DID YOU DO THAT via NFL ,40,4063,22818,26881,photo
CompanyJ_8532,Deshaun took things into his own hands Texans up 7 0 early in NOLA via thecheckdown ,84,778,5595,6373,video
CompanyJ_8533,One TD wasn t enough for DeAndre Hopkins via thecheckdown ,58,519,5185,5704,video
CompanyJ_8534,DeAndre Hopkins SUPLEXED Marcus Williams ,41,4468,23773,28241,photo
CompanyJ_8535,Brees is kicking it into gear Saints take the lead in New Orleans via NFL ,74,269,1931,2200,photo
CompanyJ_8536,Raiders fans started a F k AB chant in Oakland NSFW via MikeSteveRitter ,72,4885,23101,27986,video
CompanyJ_8537,DESHAUN DIMES IT TO KENNY STILLS TEXANS LEAD 28 27 via thecheckdown ,68,3345,18899,22244,video
CompanyJ_8538,Last two games for the Saints ,30,613,3596,4209,photo
CompanyJ_8539, A_kamara6 was supernatural tonight vs Houston 97 rushing yards 72 receiving yards 169 yards from scrimmage Saints beat Texans on a game winning FG 30 28 brgridiron ,165,1162,6114,7276,photo
CompanyJ_8540,Wil Lutz with the 58 yard field goal for the GAME Saints put together the game winning drive with 37 seconds left via NFL ,122,3738,21987,25725,photo
CompanyJ_8541, BigLegLutz ,12,566,5377,5943,photo
CompanyJ_8542,Drew Brees is at his best with the game on the line brgridiron ,63,802,5556,6358,photo
CompanyJ_8543,TFW they won t stop mentioning Antonio Brown isn t on the Raiders ,66,420,4439,4859,photo
CompanyJ_8544,Chucky coached the Raiders to a beatdown win vs the Broncos via brgridiron ,75,910,4489,5399,video
CompanyJ_8545,Jon Gruden celebrated with fans in the stands after the Raiders last opening week game in Oakland via thecheckdown ,115,1615,16659,18274,video
CompanyJ_8546,Gruden is done with all things Antonio Brown via brgridiron ,60,258,2583,2841,photo
CompanyJ_8547,7 days until the Champions League returns brfootball ,53,435,3636,4071,photo
CompanyJ_8548,This Cowboys photo experience at AT amp T Stadium is mind blowing brgridiron via sergcio ,89,6789,39620,46409,video
CompanyJ_8549,The next Manning QB is here 14 year old Arch is next up via brgridiron ,71,1977,13446,15423,video
CompanyJ_8550,KD just wants to hoop ,22,699,5785,6484,photo
CompanyJ_8551,Ronaldo showing Joao Felix the tricks via sntvstory ,52,2070,13664,15734,video
CompanyJ_8552, Get the right jersey son DeMarcus Lawrence signs for Cowboys fans only via 1Freedrugs ,87,7292,38607,45899,video
CompanyJ_8553,USWNT stars have pledged to donate their brains raising awareness of CTE in women They re definitely still focused on football Women aren t even on the radar ,158,162,819,981,photo
CompanyJ_8554,Michael Jordan announces he will donate 1M to hurricane relief in the Bahamas ,78,3373,25125,28498,photo
CompanyJ_8555, jaytatum0 had second thoughts on ordering lobster ,51,5412,35324,40736,video
CompanyJ_8556,Quenton Nelson flattened him brgridiron via Colts ,50,3494,20968,24462,link
CompanyJ_8557,The dummy nutmeg from Luis Suarez ,34,1752,14604,16356,video
CompanyJ_8558, 20K in straight cash SnoopDogg says danawhite once paid him big on a Lakers Celtics bet He s still looking for markwahlberg to pay up br_betting ,146,267,1611,1878,video
CompanyJ_8559,This expanding scoreboard at Wells Fargo Center is from the future via davegisaac ,82,938,5854,6792,video
CompanyJ_8560,7 61 65 76 Ronaldo on fire for Portugal ,40,1311,7285,8596,photo
CompanyJ_8561,The Patriots are trading veteran WR Demaryius Thomas to the Jets for a 2021 6th rounder per AdamSchefter ,105,744,3984,4728,photo
CompanyJ_8562,The Browns thought they could take the title of America s Team GridironHeights Playstation ,91,1221,5365,6586,video
CompanyJ_8563,Off the floor between the legs Run that back Via jclarkthejumper ,65,5582,26806,32388,video
CompanyJ_8564,Unreal catch over two defenders Via FabianGuerra_86 ,52,4069,26550,30619,video
CompanyJ_8565,Antonio Brown accused of sexually assaulting and raping a woman who attended college with him per benshpigel ,109,3069,9839,12908,photo
CompanyJ_8566,Dodgers beat Orioles 7 3 to win the NL West and become the first MLB team to clinch a playoff spot 94 52 record for Los Angeles is enough to get a spot in the postseason ,170,463,2520,2983,photo
CompanyJ_8567,Christian Yelich suffered fractured knee cap and is out for the season team announces ,86,1563,8285,9848,photo
CompanyJ_8568,Raiders rookie safety Johnathan Abram suffered torn rotator cuff and labrum vs Broncos likely to miss season after surgery this week per AdamLefkoe ,148,1048,5164,6212,photo
CompanyJ_8569,Fresh Prince of Bel Air debuted today 29 years ago Had some of the best athlete cameos Ken Griffey Jr Kareem Abdul Jabbar Evander Holyfield Bo Jackson Isiah Thomas A certified classic ,184,2321,14422,16743,photo
CompanyJ_8570,Team USA goes down France defeats America 89 79 to advance to the World Cup semifinals ,87,3702,14730,18432,photo
CompanyJ_8571,Messi s son doing dad s celebration via antonelaroccuzzo IG ,60,1312,12077,13389,video
CompanyJ_8572,The ending of Saints Texans was unreal especially if you had money on it via br_betting ,88,292,2793,3085,video
CompanyJ_8573,DJing gives SHAQ his adrenaline fix I love seeing people jumping up and down It s like Game 7 ,94,309,2438,2747,video
CompanyJ_8574,Sean McVay was a PROBLEM in high school The Rams HC breaks down his dominant HS film and he still remembers the names of each play New Ditch the Playbook with AdamLefkoe StateFarm ,180,406,2880,3286,video
CompanyJ_8575,Russ hears his NBA2K20 rating for the first time To me this doesn t mean s t via FallonTonight ,95,3657,21186,24843,video
CompanyJ_8576, No D I interest D II wanted him as DB Western Colorado Undrafted 26 RBs picked over him Replacing Melvin Inside the rise of Austin Ekeler ,139,603,4620,5223,photo
CompanyJ_8577,D Wade says he would love to own an NFL team with Rick Ross brgridiron via GQMagazine ,86,1557,15635,17192,photo
CompanyJ_8578,A decade ago today Michael Jordan delivered his GOAT Hall of Fame speech Rebuffed the media saying Magic and Bird were better Rubbed salt in Bryon Russell s 98 Game 6 wounds Said HS coach made a mistake picking Leroy Smith over him with Smith in the crowd ,256,1719,11813,13532,photo
CompanyJ_8579,The curve on this van Dijk assist brfootball ,45,286,3943,4229,video
CompanyJ_8580,Kobe sees who s got the Mamba mentality on his daughter s team ,63,2327,19477,21804,photo
CompanyJ_8581,James Harden s always evolving via Cbrickley603 ,48,4012,20466,24478,video
CompanyJ_8582,California Senate unanimously passed a bill that would allow college athletes to profit from their names and likenesses per latimes ,132,4760,18835,23595,photo
CompanyJ_8583,LeBron James trademark application for Taco Tuesday has been refused by the U S Patent amp Trademark Office per JoshGerben ,123,2004,17497,19501,photo
CompanyJ_8584,Christian Yelich will not need surgery on fractured right kneecap expected to be out 6 weeks per JimBowdenGM ,109,339,3317,3656,photo
CompanyJ_8585,This kid pulled out the Shammgod on him via exporecruits ,57,10772,58825,69597,video
CompanyJ_8586,Team USA lost again After losing 94 89 to Serbia America can t place higher than 7th in the World Cup ,102,2081,11104,13185,photo
CompanyJ_8587,DSJ and Ice Trae impersonated each other and it s spot on via Ballislife ,73,2962,21876,24838,video
CompanyJ_8588,Jets coach Adam Gase says QB Sam Darnold will be out for Monday Night Football against the Browns with mono ,108,339,2394,2733,photo
CompanyJ_8589,Zlatan completely unbothered via LAGalaxy ,42,1225,8170,9395,video
CompanyJ_8590,35 years ago today The Bulls signed No 3 draft pick Michael Jordan His rookie season 28 2 PTS 6 5 REB 5 9 AST Rookie of the Year All Rookie team ,145,3376,16173,19549,photo
CompanyJ_8591,Kobe once skipped basketball for dance too ,43,2457,17257,19714,video
CompanyJ_8592, Models his game after J J Watt Led B1G in sacks as a sophomore and didn t even start Picked Iowa over Ohio State and Alabama Potential top five pick A J Epenesa is the most under the radar future superstar in college football ,227,637,3736,4373,photo
CompanyJ_8593,Pistons are on the verge of signing Joe Johnson per GoodmanHoops Detroit will possibly release Michael Beasley to make room for Iso Joe ,136,1099,6447,7546,photo
CompanyJ_8594,Going all in on the Ravens this week YahooFantasy ,50,43,472,515,video
CompanyJ_8595, ,1,868,7250,8118,photo
CompanyJ_8596, PatrickMahomes s best friend N_shim_9er delivers a custom Yeezy 700 from TheShoeSurgeon googlenest ,100,93,778,871,video
CompanyJ_8597,When Ronaldo hit a ROCKET from almost 40 yards out via brfootball ,66,1750,13338,15088,video
CompanyJ_8598,All summer these athletes stayed competitive by picking up the sticks VideoGameDay ,83,71,738,809,video
CompanyJ_8599,Gronk would want his kids to know about his experience before they play football brgridiron ,92,998,8082,9080,photo
CompanyJ_8600,Happy Birthday YaoMing 8x All Star No 1 draft pick in 2002 Averaged 19 0 PTS amp 9 2 REB 5x All NBA member Face of China Basketball Hall of Famer ,146,946,7390,8336,photo
CompanyJ_8601, DeAndreHopkins was SCARY in high school via Gundi21 h t MaxPreps ,66,3145,26419,29564,video
CompanyJ_8602,Superman celebration on Cam after the sack via thecheckdown ,60,557,7407,7964,video
CompanyJ_8603,Oh no Cam via thecheckdown ,27,234,3087,3321,video
CompanyJ_8604,Warren Sapp didn t hold back on OBJ ,36,2712,18038,20750,photo
CompanyJ_8605,GOAL LINE STOP FOR THE WIN via NFL ,35,1173,9125,10298,photo
CompanyJ_8606,Sean McVay beat out Calvin Johnson for offensive player of the year in high school with plays like these StateFarm ,115,292,2694,2986,video
CompanyJ_8607,He took his sneakers off to challenge the cop to a push up challenge all to lose brkicks via ohnoitsdapopo ,107,2776,21083,23859,video
CompanyJ_8608,Hopkins vs Ramsey Sunday brgridiron ,36,479,3999,4478,photo
CompanyJ_8609,She was the WNBA s first Bahamian draft pick Then she was MIP Then Sixth Woman Now Jonquel Jones is an MVP candidate Inside the rise of the star Buddy Hield calls a sign of hope for girls in the Bahamas ,203,273,1120,1393,photo
CompanyJ_8610,Canelo Alvarez vs Sergey Kovalev is officially set for Nov 2 at MGM Grand Superfight ,85,1864,6714,8578,photo
CompanyJ_8611,Zion really broke the golf club via PelicansNBA ,48,3833,24898,28731,video
CompanyJ_8612,Don t let this 5 11 dad s age fool you at 47 years old he s one of the more famous dunkers on the internet ,107,305,3052,3357,video
CompanyJ_8613,Donovan McNabb put up big numbers both passing and rushing The QB s precision and versatility should make him a for the PFHOF FordTrucks ,137,166,880,1046,video
CompanyJ_8614,Messi sat the defender down via brfootball ,43,1289,9929,11218,video
CompanyJ_8615,Went up and got it with fingertips via NicKorn1 ,48,678,7774,8452,video
CompanyJ_8616,Ichiro must be a wizard via Mariners ,37,954,9134,10088,video
CompanyJ_8617,Give a good pup a french fry you re gonna have to give a good pup all the french fries via Cut4 ,96,773,6064,6837,video
CompanyJ_8618,That s trust via jake_foggia56 IG ,34,3714,26525,30239,video
CompanyJ_8619,In this photo 91 home runs 217 RBIs Rookie of the Year Future Rookie of the Year Two future MVPs ,97,241,3047,3288,photo
CompanyJ_8620,Firmino s back heel assist Salah s finish via NBCSportsSoccer ,62,703,5015,5718,video
CompanyJ_8621,Still got the bucket via shescreamdarius IG ,44,2650,16469,19119,video
CompanyJ_8622,Real Madrid s new no 7 Eden Hazard makes his debut ,51,199,2073,2272,photo
CompanyJ_8623,What A Goal via NBCSportsSoccer ,32,665,3782,4447,video
CompanyJ_8624,Chelsea s Tammy Abraham Only 21 years old Youngest Chelsea player to score a Premier League hat trick 7 goals in his last 3 games ,130,1883,9534,11417,photo
CompanyJ_8625,Happy 30th birthday to JimmyButler From 2 star recruit to 4x All Star What a journey it s been so far ,102,1707,14684,16391,photo
CompanyJ_8626, terrenceclarke_ the No 3 prospect in 2021 is reclassifying and committing to KentuckyMBB for the 2020 season brhoops ,118,882,3154,4036,video
CompanyJ_8627,Neymar overhead stoppage time winner in his first game of the season for PSG via beINSPORTSUSA ,95,4093,18173,22266,photo
CompanyJ_8628,Booed by fans pre game Scores 92nd minute winner ,49,691,5800,6491,photo
CompanyJ_8629,Norwich City 3 2 Manchester City Newly promoted NCFC hand Manchester City their first loss of the season ,105,326,1793,2119,photo
CompanyJ_8630,16 year old Ansu Fati has a goal and an assist in less than 10 minutes ,71,2280,11144,13424,photo
CompanyJ_8631,HE WENT FLYING via CBSSportsHQ ,31,5077,18766,23843,video
CompanyJ_8632,Last month Arkansas State coach Blake Anderson s wife Wendy passed away from breast cancer Today he reflected on Georgia fans supporting WearPinkForWendy One of the classiest moves I ve ever seen via ChrisHudgison Region8news ,226,1374,8287,9661,video
CompanyJ_8633,Najee Harris is NOT HUMAN via CBSSports ,40,10910,50345,61255,video
CompanyJ_8634,Garrett Shrader was out ,24,4653,22432,27085,video
CompanyJ_8635,Jalen turned on the jets via CFBONFOX ,38,503,4429,4932,video
CompanyJ_8636,He did a BACKFLIP in the middle of the fight via ufc ,53,3161,14047,17208,video
CompanyJ_8637,Florida ices game on an elite 76 yard fake via SECNetwork ,58,2602,18994,21596,video
CompanyJ_8638,Jalen Hurts continues his run at the Heisman 15 20 passing 289 Yards 3 TDs 14 carries 150 yards TD Oklahoma rolls past UCLA 48 14 ,130,1477,8773,10250,video
CompanyJ_8639,Tyson Fury defeats Otto Wallin via unanimous decision ,54,672,4253,4925,photo
CompanyJ_8640,Back heel flick assist was wild ,32,1103,8418,9521,video
CompanyJ_8641,What does Sterling Shepard do in his free time He hits the links Watch his golf game get put to the test in his levis Advanced Stretch Jeans ,141,23,278,301,video
CompanyJ_8642,Saints Rams rematch today What if brgridiron ,45,1671,10757,12428,video
CompanyJ_8643,Drew neymarjr with his CLEAT brfootball via bouboudesign_ IG ,61,2764,13660,16424,video
CompanyJ_8644,Stefon Diggs with the Imma head out SpongeBob kicks via MACHE275 Vikings ,73,13251,60594,73845,photo
CompanyJ_8645,Saints and HC Sean Payton agree to 5 year contract extension per JayGlazer h t brgridiron ,90,1047,5506,6553,photo
CompanyJ_8646,AB had three catches for 36 yards on his first drive with the Patriots ,71,909,6938,7847,photo
CompanyJ_8647,Lamar staying hot from the pocket via thecheckdown ,51,962,8704,9666,video
CompanyJ_8648,Rodgers looking surgical early Second TD pass of the afternoon via NFL ,71,347,2519,2866,video
CompanyJ_8649,Titans OL David Quessenberry missed three seasons after 2014 due to cancer He just caught a TD pass from Marcus Mariota via Titans ,131,3126,19880,23006,photo
CompanyJ_8650,The legend of Adrian Peterson grows Today he passed Jim Brown on the all time rushing TD list brgridiron ,105,782,4215,4997,photo
CompanyJ_8651,DALVIN COOK 75 YARD HOUSE CALL via Vikings ,43,653,4033,4686,video
CompanyJ_8652,Brady had her starstruck via NBCSBoston ,40,431,4426,4857,video
CompanyJ_8653,Antonio Brown catches his first touchdown as a Patriot via thecheckdown ,72,5839,33713,39552,video
CompanyJ_8654,This man is cold Lamar at half 12 16 171 yards 2 TD 8 carries 64 rushing yards ,79,3618,24068,27686,photo
CompanyJ_8655,Mike Williams FLEW to make this catch via Chargers ,51,807,5042,5849,photo
CompanyJ_8656,Mike Trout to miss remainder of season having foot surgery later this week team announces ,90,519,2529,3048,photo
CompanyJ_8657,Stefon Diggs with the 45 yard TD and then lets Lambeau know about it via NFLonFOX ,82,978,6674,7652,photo
CompanyJ_8658,Deshaun got SLIPPERY on 4th down via thecheckdown ,50,345,3318,3663,video
CompanyJ_8659,Lamar s over 100 yards rushing after three quarters Not bad for a QB ,69,840,8535,9375,photo
CompanyJ_8660,Jamie Collins with the most disrespectful INT return Started jogging at the 30 via NFL ,87,2980,19304,22284,photo
CompanyJ_8661,Lamar and Hollywood are a PROBLEM via thecheckdown ,51,4091,27823,31914,video
CompanyJ_8662,Lamar Jackson s first two games this season 41 57 596 yards 7 passing TD 127 rushing yards 0 turnovers 0 snaps at WR 2 0 It s quiet for a lot of critics right now brgridiron ,174,5157,21468,26625,photo
CompanyJ_8663,Tied for most points given up through the first two weeks in NFL history ,73,704,4562,5266,photo
CompanyJ_8664,Hit Mecole Hardman in stride for a 42 yard TD Mahomes is BALLIN via NFL ,72,620,5403,6023,photo
CompanyJ_8665,Mahomes with 313 yards and 4 TDs at HALFTIME MVP mode ,54,3719,21826,25545,photo
CompanyJ_8666,Retirement Marshawn is the best via NBCSports ,46,10632,41111,51743,video
CompanyJ_8667,Kelsey Plum with an unreal shot James Harden couldn t believe it via LVAces ,76,2450,15127,17577,video
CompanyJ_8668,Cooper Kupp INCREDIBLE via thecheckdown ,40,2766,18645,21411,video
CompanyJ_8669,THAT WAS WILD via LVAces ,25,2387,9841,12228,video
CompanyJ_8670,Patrick Mahomes put on a show 30 44 passing 443 yards 4 TDs Chiefs scored 28 unanswered to beat Raiders 28 10 ,110,601,4017,4618,photo
CompanyJ_8671,Lamar and the Ravens Mahomes and the Chiefs Next week is about to be crazy via brgridiron ,90,8515,48596,57111,photo
CompanyJ_8672,Drew Brees will see a hand specialist in LA today after hurting his thumb Says he s concerned and that it could be significant per JosinaAnderson ,146,528,3284,3812,photo
CompanyJ_8673,JULIO via thecheckdown ,23,1106,9245,10351,video
CompanyJ_8674,Desmond Trufant caught his 2nd INT of the game sitting down via thecheckdown ,77,966,10283,11249,video
CompanyJ_8675,6 straight games with a TD for Julio via NFL ,45,484,4837,5321,photo
CompanyJ_8676,Wentz somehow found a way via thecheckdown ,43,1623,10809,12432,video
CompanyJ_8677,JULIO GOES ALL THE WAY via NFL ,31,2454,15292,17746,photo
CompanyJ_8678,History for Julio brgridiron ,29,924,6353,7277,photo
CompanyJ_8679,Nelson Agholor MY GOODNESS via SNFonNBC ,40,301,2632,2933,video
CompanyJ_8680,The Falcons had so much fun tonight ,36,5291,22258,27549,video
CompanyJ_8681,Quavo perfecting his outside game via Cbrickley603 h t HoHighlights ,68,561,5546,6107,video
CompanyJ_8682,Minnesota Lynx s Napheesa Collier wins WNBA Rookie of the Year 13 1 PPG 6 6 RPG 2 6 APG ,88,307,2655,2962,photo
CompanyJ_8683,Lionel Messi has officially been declared healthy for Barcelona s Champions League opener on Tuesday brfootball ,112,548,4916,5464,photo
CompanyJ_8684,Dirk says he had to slow down a little with eating whatever he wanted in retirement because he was heading toward three bills via ESefko ,137,389,5648,6037,photo
CompanyJ_8685,Jamal Crawford on why he s the only person Kawhi follows on Twitter I just knew he d be a star So I think he remembered that I thought about him and liked his game before everyone else via kidstakeoverig IG ,207,1587,11618,13205,video
CompanyJ_8686,Drew Brees has a torn ligament in his right thumb will require surgery He s likely out six weeks per RapSheet ,110,1442,6698,8140,photo
CompanyJ_8687,Alabama s Najee Harris hit the Rapinoe celebration after his incredible TD on Saturday Shout out to her ,104,1617,17743,19360,photo
CompanyJ_8688,Patriots WR Antonio Brown was accused of sexual misconduct by a second woman according to RobertKlemko ,103,2472,8161,10633,photo
CompanyJ_8689,Big Ben is out for the year Steelers QB needs surgery on his elbow and will be placed on IR ,92,1912,8131,10043,photo
CompanyJ_8690,Tomorrow the Champions League returns brfootball ,49,556,3212,3768,photo
CompanyJ_8691,The Dodgers have the best record in the NL on the backs of Cody Bellinger and Clayton Kershaw But it s the young core that could end the title drought in LA ,157,187,1027,1214,photo
CompanyJ_8692,Heisman race between former teammates is heating up ,52,244,1690,1934,photo
CompanyJ_8693,He s got springs for feet via trydrs ,37,1539,14061,15600,video
CompanyJ_8694,Japan s Sapporo Dome is a baseball stadium that also has a soccer and rugby pitch outside that can be slid in at any time Whoa via rugbyworldcupjp ,147,8182,37354,45536,video
CompanyJ_8695,Shaun Alexander scored 15 TDs in five consecutive seasons The former MVP was the definition of a workhorse ProFootballHOF bound FordTrucks X PFHOF20 Vote Now ,158,133,687,820,video
CompanyJ_8696,Can t wait for the new UCL season ,34,39,419,458,link
CompanyJ_8697,Can t catch Kerryon via thecheckdown ,37,2308,18526,20834,video
CompanyJ_8698,D Rose joins the ranks brkicks ,31,1066,6969,8035,photo
CompanyJ_8699,Another parade another Marc Gasol chug via BasketMediaset ,58,732,6504,7236,video
CompanyJ_8700,Jaguars CB Jalen Ramsey has requested a trade from Jacksonville per AdamSchefter h t brgridiron ,96,7081,32255,39336,photo
CompanyJ_8701,OBJ s still got love for Giants fans via MikeGarafolo ,54,2437,24848,27285,video
CompanyJ_8702,OBJ bound to go off after talking to Randy Moss pregame via thecheckdown ,73,3210,25770,28980,video
CompanyJ_8703,RJ is already a Knicks legend ,30,2364,14643,17007,photo
CompanyJ_8704,OBJ back with the Richard Mille Only 10 made Worth 2 02 million h t MasterTes brgridiron ,89,5731,25731,31462,photo
CompanyJ_8705,YOU KNEW OBJ WOULD DO THIS IN NEW YORK via thecheckdown ,56,15315,78387,93702,video
CompanyJ_8706,Steelers trade 2020 first round pick to Dolphins for DB Minkah Fitzpatrick per AdamSchefter h t brgridiron ,107,2759,11512,14271,photo
CompanyJ_8707,OBJ OFF TO THE RACES via thecheckdown ,38,9474,48791,58265,video
CompanyJ_8708,OBJ made his presence felt in NY Browns get their first W of the season 161 yards 89 yard TD Browns beat the Jets 23 3 ,119,997,9224,10221,photo
CompanyJ_8709,The One With The Football Team From Cleveland via Browns ,57,1695,9501,11196,video
CompanyJ_8710,The best of the best The Champions League is back via brfootball ,65,1301,5908,7209,video
CompanyJ_8711,Bronny got hops via brhoops ,28,2174,19344,21518,video
CompanyJ_8712,New era Giants have named rookie QB Daniel Jones their starter ,63,3800,23935,27735,photo
CompanyJ_8713,Salute to Eli if this is the end of his Giants run 16 years 232 starts 116 116 record 2 Super Bowls 2 Super Bowl MVPs 362 TDs 8th all time 56 537 yards 7th all time brgridiron ,176,8353,37563,45916,photo
CompanyJ_8714,Rocking a Crenshaw Lakers jersey for Nipsey KingJames ,54,1246,8855,10101,photo
CompanyJ_8715,CAN T WAIT Follow brfootball for everything UCL ,48,108,1108,1216,link
CompanyJ_8716,Daniel Jones time in NY Giants fans have been ready brgridiron ,63,1706,10264,11970,video
CompanyJ_8717,On this day in 2000 a 13 year old Leo Messi arrived in Barcelona Today he kicks off his 16th Champions League season with the club brfootball ,142,1285,9087,10372,photo
CompanyJ_8718,James Harden just turned 30 but he s still eyeing two three four rings and a couple more MVPs for his trophy case The Beard on everything from his ambitions to his legacy and not showing up ,190,419,2669,3088,photo
CompanyJ_8719,Some fans from Kentucky spotted Lamar in traffic after Baltimore beat the Cardinals on Sunday The QB pulled over to the side of the road and signed autographs for the whole group brgridiron via Ravens ,201,924,8468,9392,photo
CompanyJ_8720,The culture needs these next from KingJames brkicks ,52,2089,11527,13616,photo
CompanyJ_8721,Three weeks ago 16 year old Ansu Fati made his Barcelona debut He makes his Champions League debut today ,105,329,2947,3276,photo
CompanyJ_8722,New city new jerseys warriors just unveiled some heat ,54,985,6115,7100,video
CompanyJ_8723,20 year old American tyler_adams14 put on a Go Pro for 24 hours to take us inside the life of a player via brfootball ,118,121,915,1036,video
CompanyJ_8724,Watch out ,10,2419,16393,18812,photo
CompanyJ_8725,Why d he smack him like that via brlive ,40,4186,23856,28042,video
CompanyJ_8726,A hat trick in the first half of his Champions League debut And Erling Haaland is only 19 brfootball ,101,270,1988,2258,video
CompanyJ_8727,FINGERTIP SAVE via brfootball ,30,177,1573,1750,video
CompanyJ_8728,Napoli 2 0 Liverpool Stopping the champions party via brfootball ,65,277,1734,2011,photo
CompanyJ_8729,Thursday Night Football Somebody has to do it GridironHeights PlayStation ,74,1234,5524,6758,video
CompanyJ_8730,Mayfair is stacked Josh Christopher no 7 in class of 2020 Dior Johnson no 4 in class of 2022 Devontes Cobbs rising guard in class of 2022 Rankings via 247Sports ,161,204,1026,1230,link
CompanyJ_8731,He said I got this then skied the penalty via brfootball ,57,1595,12471,14066,video
CompanyJ_8732,Does Chad Johnson Deserve Your 2020 Pro Football Hall of Fame Vote profootballhof PFHOF20 Vote Now From B R X FordTrucks ,121,410,2274,2684,video
CompanyJ_8733,14 year old Calder Hodge s legs were amputated at age two because of a rare disorder Now he has dreams of becoming the NFL s first double amputee QB ,149,923,8066,8989,video
CompanyJ_8734, I definitely thrive in competition and being the best and center of attention Liz Cambage never backs down Tonight she ll continue her quest to lead the Aces to a title From B R x adidasrunning ,195,48,306,354,video
CompanyJ_8735,Offset is at SmackDown in a robe posted up in the middle of the ring via WWE ,77,4684,17401,22085,video
CompanyJ_8736,Patrick Mahomes did all of this before turning 24 Happy Birthday to a legend in the making via brgridiron ,106,3224,22796,26020,photo
CompanyJ_8737,Steph Curry definitely wants to play for Team USA at the 2020 Olympics per Rachel__Nichols It would be Curry s first time on the Olympic team ,142,1894,17731,19625,photo
CompanyJ_8738,Today Atleti vs Juventus Joao Felix vs Ronaldo Portugal s future vs Portugal s present brfootball ,98,344,2349,2693,photo
CompanyJ_8739,Kobe says he knew about the Lakers trade but Charlotte GM Bob Bass said We couldn t have used you anyway during their call after the Hornets drafted the 17 year old I was triggered I was ready to go to the gym via Knuckleheads on PlayersTribune ,245,913,5923,6836,photo
CompanyJ_8740,The first touch and turn from 18 year old Sergino Dest ,55,2934,21677,24611,video
CompanyJ_8741,Filet T bone or chicken tenders MichaelVick s first dinner with Arthur Blank got real awkward when he wasn t sure who was paying New Untold Stories with mastertes ,163,147,711,858,video
CompanyJ_8742,Get ready Follow brfootball for everything Champions League ,60,49,338,387,link
CompanyJ_8743,An NFL scout thinks Jonathan Taylor could easily crack the first round of the draft In the meantime the Wisconsin RB is looking to break the all time NCAA rushing record in just three seasons ,192,160,1341,1501,photo
CompanyJ_8744,One of the most feared defenders of all time Is Troy Polamalu profootballhof bound PFHOF20 Vote now From B R X FordTrucks ,122,260,1793,2053,video
CompanyJ_8745, That was the reason Juve signed me for this The last time Ronaldo faced Atletico Madrid he scored a comeback hat trick to send Juventus into the quarterfinals via brfootball ,175,308,2681,2989,video
CompanyJ_8746,Eli s keeping things in perspective brgridiron ,47,312,4127,4439,photo
CompanyJ_8747,DI MARIA via brlive ,20,128,854,982,video
CompanyJ_8748,Ronaldo Joao Felix via brfootball ,34,1874,15414,17288,video
CompanyJ_8749,Neymar and Mbappe loved this goal from Di Maria brfootball ,59,471,4391,4862,video
CompanyJ_8750,What a goal this would ve been via brfootball ,46,502,4250,4752,video
CompanyJ_8751,Odell is partnering with Swedish watchmaker Daniel Wellington after rocking Richard Mille to open the season There s always a method to the madness ,148,1666,9021,10687,photo
CompanyJ_8752,Incredible goal better celebration via brfootball ,50,686,4689,5375,video
CompanyJ_8753,Give Ronaldo the ball or else ,30,343,2998,3341,video
CompanyJ_8754,PSG demolish Real Madrid 3 0 in their Champions League opener brfootball ,73,681,3275,3956,photo
CompanyJ_8755,Neymar and Mbappe loving PSG s win via brfootball ,50,898,8357,9255,video
CompanyJ_8756,Duke now has the No 2 recruiting class for 2020 Steward joins No 8 Jalen Johnson and No 19 Jeremy Roach via 247Sports ,118,265,1228,1493,link
CompanyJ_8757, BillsMafia member from day 1 via Estelle_Ann ,46,863,6570,7433,video
CompanyJ_8758, CCSabathia gets a standing O after leaving his last regular season start at Yankee Stadium Legend via YESNetwork ,114,933,4988,5921,video
CompanyJ_8759,He juked out Steph Curry with his own signature move 7 footer Chet Holmgren is only a junior in high school and might be the next unicorn brhoops ,146,398,3689,4087,video
CompanyJ_8760,Happy 21st birthday to Christian Pulisic Youngest ever to captain USMNT in modern history Youngest to win U S soccer Male Player of the Year Most expensive U S soccer player ever via brfootball ,194,1010,10058,11068,photo
CompanyJ_8761,Bruce Bochy becomes 11th manager in MLB history to reach 2 000 career wins Legend ,82,758,6652,7410,photo
CompanyJ_8762,This kid s swing and accuracy is something else via mikeandheather8 ,68,1698,14549,16247,video
CompanyJ_8763,EDD MVP 19 5 PPG 8 2 REB 2 2 AST 97 4 FT 114 of 117 1st WNBA player with 50 40 90 1st to win MVP on two different teams ,120,1207,6463,7670,photo
CompanyJ_8764,Patrick Mahomes had more fantasy points in the second quarter Sunday than these guys had all season Cheat code brgridiron ,122,226,1997,2223,photo
CompanyJ_8765,Iverson stepover on the field Brutal Via ColinDeaverTV ,55,5068,30803,35871,video
CompanyJ_8766,The fireman wanted in and they really embraced him via brlive ,62,200,2733,2933,video
CompanyJ_8767,It only took eight years for Patrick Willis to join the profootballhof conversation Does the former Niners LB get your vote PFHOF20 Vote now From B R X FordTrucks ,163,124,758,882,video
CompanyJ_8768,Colorado s Laviska Shenault only started playing football in 9th grade Now his coach says he could be one of the most complete WRs ever He s Julio Jones Only bigger ,165,183,1146,1329,photo
CompanyJ_8769,Ballmer hesitated Doc went all in ,34,361,4424,4785,photo
CompanyJ_8770,DeAndre Hopkins took 10 kids from the local Boys and Girls Club on a shopping spree with 200 gift cards each It s something I don t ever feel like I can get tired of doing brgridiron via MarkBermanFox26 ,203,2619,19744,22363,video
CompanyJ_8771,Nike has cut ties with Antonio Brown via brkicks ,49,1693,10333,12026,photo
CompanyJ_8772,Chicharito with an incredible free kick via brlive ,51,1578,6258,7836,video
CompanyJ_8773,Larry Fitz has topped 100 yards in two straight games Time to roll with him in fantasy again YahooFantasy ,106,62,638,700,video
CompanyJ_8774,No 7 on the hat finally on the chest First look at KD in the Nets threads BrooklynNets ,87,2155,13104,15259,photo
CompanyJ_8775,Holdouts are becoming more and more common in the NFL They re the players ultimate power move to securing the bag ,114,93,461,554,video
CompanyJ_8776,Tua Tagovailoa Is leading the way to the Heisman trophy this year SoutheastToyota ,82,176,1416,1592,video
CompanyJ_8777,Jalen Ramsey s time with the Jaguars is just about over brgridiron ,67,679,4863,5542,photo
CompanyJ_8778,LEONARD FOURNETTE 69 YARDS via Jaguars ,39,1215,11521,12736,photo
CompanyJ_8779,Minshew Mania A True Underdog Story Gardner Minshew leads the Jags to their first win of the season 20 7 over the Titans brgridiron ,132,1669,12894,14563,photo
CompanyJ_8780,TULANE TD FOR THE WIN UNREAL via CBSSportsHQ ,45,2235,11440,13675,video
CompanyJ_8781,Antonio Brown allegedly sent intimidating text messages to woman who accused him of sexual misconduct claiming she only wanted money Her lawyer has asked the NFL to intervene per RobertKlemko ,192,518,3101,3619,photo
CompanyJ_8782,Conor McGregor is preparing for his return to UFC action early next year could fight Nate Diaz or Jorge Masvidal per TMZ_Sports ,128,2053,12103,14156,photo
CompanyJ_8783,16 year old Barcelona sensation Ansu Fati is now eligble to play for Spain brfootball ,86,356,3577,3933,photo
CompanyJ_8784,Wouldn t be surprised if one of these was an Who will they find in the Area51storm ,83,1234,9744,10978,photo
CompanyJ_8785,Russ and Harden training to be the best 1 2 combo in the league via UFCPI TheofficialEG10 ,90,742,4861,5603,video
CompanyJ_8786,Nobody wanted to hold the banner for the picture brfootball h t Esp_Interativo ,79,590,4999,5589,video
CompanyJ_8787,The Beard been working on a lethal signature move ,50,1099,7628,8727,video
CompanyJ_8788,Alex Caruso might not look the part but he s going to play a big role in LA this year You think of the Lakers it s LeBron Anthony Davis guys who are bona fide NBA players and then there s me ,191,706,5263,5969,photo
CompanyJ_8789, Happy to answer any football questions but I m done with the rest Belichick walks away from a presser not wanting to answer more Antonio Brown questions following his opening remarks via MikeGiardi ,199,247,1810,2057,video
CompanyJ_8790,LaMelo got NBA scouts sweating All around game helped get the W over the defending champs via NBL H T brhoops ,110,1553,8214,9767,video
CompanyJ_8791,Darek Formella was informed that his father passed away three hours before kickoff He kept the news to himself and played anyway In the 81st minute he scored the winning goal for SacRepublicFC His reaction speaks for itself via brfootball ,239,5902,26826,32728,video
CompanyJ_8792,Calvin Johnson says he had at least nine concussions and smoked weed after every game to avoid the rampant abuse of opioids in the league per Rosenberg_Mike ,157,11938,46988,58926,photo
CompanyJ_8793,Ravens TE Mark Andrews won t let Type 1 diabetes define him Only takes insulin pump off to play Tests sugar 2x during practice Mentoring diabetic athletes since HS Andrews leads all TEs in yards and TDs this year H T brgridiron ,228,2103,14059,16162,photo
CompanyJ_8794,Stricter compliance with tampering and salary cap circumvention will be enforced across the league after board approves new package of measures per wojespn ,156,140,1281,1421,photo
CompanyJ_8795, MichaelVick says when he saw the taxes taken out of his rookie signing bonus check it was tougher than goin to prison ,119,747,3196,3943,video
CompanyJ_8796,Breaking Patriots have cut Antonio Brown per ProFootballTalk ,61,10195,31820,42015,photo
CompanyJ_8797,AB s last few months Cryotherapy frostbite Helmet grievance Threatened retirement Posts fine on IG Yells at Mayock Posts Gruden convo Cut by Raiders Signs with Patriots Sexual assault and misconduct allegations Cut after 1 game brgridiron ,239,3142,14453,17595,photo
CompanyJ_8798,He was determined to get that TD Awareness turned all the way up via kaiacia IG ,80,2824,16728,19552,video
CompanyJ_8799,Rage quitting would be justified via u Paxopoxo h t BRGaming ,61,850,7720,8570,video
CompanyJ_8800,AD looking ready to go for the new season via Lakers ,53,1738,11510,13248,video
CompanyJ_8801,Pete Alonso CRUSHED this one for his 50th home run of the year Incredible rookie season via Mets ,97,641,4221,4862,video
CompanyJ_8802,Braves repeat as NL East champs Ronald Acuña Jr second year superstar Surprise resurgence from free agency bet Josh Donaldson Won the Dallas Keuchel sweepstakes Franchise record in season HRs Top 5 run differential in MLB 27 15 in one run games Built for the playoffs ,268,489,2473,2962,photo
CompanyJ_8803,OMG via LovoCristian ,21,4490,24364,28854,video
CompanyJ_8804,The catch The run Michael Pittman Jr extends USC s lead via Pac12Network ,73,489,3415,3904,video
CompanyJ_8805, Drake in the lab perfecting his jumper via LethalShooter__ ,60,1978,13945,15923,video
CompanyJ_8806,Get this man in the X Games via it_should_matter you_got_that_comin IG ,71,18292,75616,93908,video
CompanyJ_8807,Harry Kane with the ridiculous goal while falling down via NBCSportsSoccer ,75,2364,15807,18171,video
CompanyJ_8808,Filthy ,7,57,770,827,link
CompanyJ_8809,Reflexes on Via tigers ,23,924,10703,11627,video
CompanyJ_8810,Undefeated drip from Game Day RicFlairNatrBoy ,46,458,3024,3482,photo
CompanyJ_8811,Manchester City really got five goals in 18 minutes Via NBCSportsSoccer ,72,389,2496,2885,video
CompanyJ_8812,This is what it s all about Bartolo Colon was in his motherland Dominican Republic playing with the kids via hgomez27 ,118,317,2314,2631,video
CompanyJ_8813,Buzzer beaters and guitar cellys StephensonLance living his best life Via EASLofficial ,87,349,2280,2629,video
CompanyJ_8814,Manchester City 8 0 Watford EIGHT brfootball ,45,637,5611,6248,photo
CompanyJ_8815,Bo Nix is generating Cam Newton level buzz as a 5 star true freshman starter for Auburn For his next big test the 19 year old QB will face off against his dad s old coach Jimbo Fisher in a SEC showdown against No 17 Texas A amp M ,230,340,2901,3241,video
CompanyJ_8816,Raheem Sterling just disappeared in FIFA via robertsziile IG ,61,121,1021,1142,video
CompanyJ_8817,Jonathan Taylor is SPECIAL Wisconsin RB already has 143 yards via CFBONFOX ,75,771,6200,6971,video
CompanyJ_8818,TD celebrations getting out of hand via BigTenNetwork ,54,4391,19568,23959,video
CompanyJ_8819,JACK COAN GETS LOOSE via CFBONFOX ,34,230,1781,2011,video
CompanyJ_8820,Michigan fans at half ,22,342,2414,2756,photo
CompanyJ_8821,Turned this lineman into flapjacks via SECNetwork ,50,3852,19463,23315,video
CompanyJ_8822,1 800 I Need Help via SECNetwork ,33,672,4412,5084,video
CompanyJ_8823,Coastal Carolina might have the best turnover celebration in the country via PFF_Cam ,85,1133,5195,6328,video
CompanyJ_8824,Jonathan Taylor really from the tri state Another Supreme mouthpiece This time it s the LV edition ,99,355,3170,3525,photo
CompanyJ_8825,The Bulldogs have dominated the competition so far and are looking to do the same vs the Fighting Irish tonight ,112,110,535,645,video
CompanyJ_8826,Tua continues his streak 17 21 for 293 yards 5 TDs 0 INTs Leads Bama to 49 7 win over Southern Mississippi ,107,684,3975,4659,video
CompanyJ_8827,WHAT A STAND BY THE CAL DEFENSE ,32,374,2878,3252,video
CompanyJ_8828,Jonathan Taylor made a STATEMENT against Michigan 23 carries for 203 yards 2 rushing TDs 8 8 YPC average Wisconsin handles Michigan 35 14 ,138,590,4208,4798,video
CompanyJ_8829,Joe Burrow put on an absolute clinic against Vanderbilt School record 6 TDs most TD passes in a game 25 34 for 398 yards 0 INTs The Heisman race continues to heat up ,166,437,2497,2934,photo
CompanyJ_8830,Michigan fans everywhere rn via BadgerFootball ,47,934,7119,8053,video
CompanyJ_8831,Kylin Hill took flight from the 4 yard line for the TD via SECNetwork ,70,275,2199,2474,video
CompanyJ_8832,Don t think he will be allowed at Cardinals home games any time soon via Cubs ,78,500,4008,4508,video
CompanyJ_8833,Ja Marr Chase channeled obj against Vanderbilt via brgridiron ,62,204,1450,1654,photo
CompanyJ_8834,Young Kobe was a different breed via Lakers ,44,7844,31078,38922,video
CompanyJ_8835,Justin Fields had himself a day 1st OSU QB with 6 TDs in one quarter 14 21 for 223 yards Led Buckeyes offense to 76 5 win Incredible ,133,1039,4800,5839,video
CompanyJ_8836,The showdown of the week is in Athens Who ya got ,49,127,1108,1235,photo
CompanyJ_8837,Pitt pulled out the Philly Special to hand No 15 UCF their first regular season loss since 2016 Crowd LOVES it via CBSSportsHQ ,127,2302,13356,15658,video
CompanyJ_8838,SPINNING BACKFIST KO via ufc ,29,5008,22119,27127,video
CompanyJ_8839,Antonio Brown s agent has communicated with a few teams that are interested in AB but teams want more information on legal situation deal not likely to happen until investigation is resolved per AdamSchefter ,208,484,3002,3486,photo
CompanyJ_8840,Chris Long tried to hit up a UCF buddy about their game but the number was changed Still tried to get some betting advice via JOEL9ONE h t br_betting ,150,112,1312,1424,photo
CompanyJ_8841,The concentration is crazy via CBSSports ,41,731,5817,6548,video
CompanyJ_8842,D Andre Swift has bounce via CBSSports ,39,732,3961,4693,video
CompanyJ_8843,Cougs shirt Short jorts Headband Glasses Gardner Minshew is back in Pullman supporting Washington State ,104,807,7965,8772,photo
CompanyJ_8844,HE ENDED HIM via PBConFOX ,26,2491,10288,12779,video
CompanyJ_8845,LSU guard flattened him ,24,2504,17520,20024,video
CompanyJ_8846,Sam Ehlinger was a force of nature against Oklahoma State 351 total yards 4 TDS 36 30 Texas win ,96,1144,5641,6785,photo
CompanyJ_8847,Bulldogs are too much for the Irish in Athens tonight Georgia beats Notre Dame 23 17 ,85,561,3450,4011,photo
CompanyJ_8848,UCLA beat Washington State in a CLASSIC 67 63 score UCLA comes back from 49 17 deficit 130 total points 1 377 total yards 7 total turnovers UCLA s Dorian Thompson Robinson 7 total TDs WSU s Anthony Gordon 9 TD passes Unforgettable night ,237,3225,15692,18917,photo
CompanyJ_8849,The 67 63 game winner for UCLA Candidate for game of the year ,62,1066,8048,9114,video
CompanyJ_8850,Lamar Mahomes Get hyped brgridiron ,35,859,5915,6774,video
CompanyJ_8851,Antonio Brown calls out Robert Kraft after RapSheet reported the owner was behind the WR s release from the Patriots He says he s done playing in the NFL ,154,1022,4109,5131,photo
CompanyJ_8852,Ronaldo turns 43 today 2x World Cup winner 2x Copa America winner 2x Ballon d Or Youngest player 20 to win FIFA World Player of the Year Scored 200 goals before he turned 23 And so much more Happy birthday to Il Fenomeno one of the best ever brfootball ,253,869,4490,5359,photo
CompanyJ_8853,DOUBLE BACKFLIP via tannerwitt IG ,34,1726,11772,13498,video
CompanyJ_8854,Heavy rain coming in KC but Chiefs fans have been lining up since 3 a m via JamesPalmerTV ,90,391,2878,3269,video
CompanyJ_8855,On this day in 2015 Robert Lewandowski scored FIVE goals in NINE minutes as a sub Still unreal via FCBayernUS ,110,2315,9168,11483,video
CompanyJ_8856,Get hyped for Week 3 TheMattCamp is answering all your fantasy questions on Your Fantasy Fire Drill Watch NOW before you lock in your lineups ,142,11,54,65,link
CompanyJ_8857,It s only right Diggs broke out the Chucky cleats for Raiders Vikings today brkicks via MACHE275 ,97,462,3460,3922,photo
CompanyJ_8858,WHAT A FREE KICK via NBCSportsSoccer ,37,443,2093,2536,video
CompanyJ_8859,Shoutout to the Texans for everything they did this week Hopkins took kids from Boys amp Girls Club on a shopping spree Stills talked to Houston police about building trust in the community Lonnie Johnson Jr paying for funeral of young hometown player brgridiron ,263,943,5526,6469,photo
CompanyJ_8860,Kante with a STUNNER via NBCSportsSoccer ,41,381,2177,2558,video
CompanyJ_8861,NEVER give Aaron Rodgers a free play 6 via thecheckdown ,56,1208,9136,10344,video
CompanyJ_8862,Lamar is a video game character in real life via thecheckdown ,62,4108,27373,31481,video
CompanyJ_8863,Mark Andrews wanted the ball Lamar wanted the first down via thecheckdown ,74,4332,33669,38001,video
CompanyJ_8864,DEMARCUS ROBINSON via thecheckdown ,35,1339,9108,10447,video
CompanyJ_8865,ANKLES via thecheckdown ,24,4918,27212,32130,video
CompanyJ_8866,The line to place a bet at Caesars Sportsbook br_betting ,57,167,1187,1354,video
CompanyJ_8867,Amari Cooper through three weeks Four touchdowns Scored every game Price going up ,82,944,6208,7152,photo
CompanyJ_8868,Dalvin Cook handing out footwork tutorials every Sunday via thecheckdown ,73,2035,16503,18538,video
CompanyJ_8869,Josh Gordon has to be kidding WOW via NFL ,42,2399,13761,16160,photo
CompanyJ_8870,Nelson Agholor went via Eagles ,31,572,3589,4161,photo
CompanyJ_8871,Lamar with the PRAYER via thecheckdown ,39,893,7377,8270,video
CompanyJ_8872,Julio belongs in Area 51 What a TD via AtlantaFalcons ,54,936,4831,5767,photo
CompanyJ_8873, Heaven wants us to win this game Jackie Moon Lamar Jackson amp Willie Snead via thecheckdown ,94,814,7051,7865,video
CompanyJ_8874,DAWSON KNOX IS ABOUT THAT ACTION via BuffaloBills ,50,6822,27425,34247,photo
CompanyJ_8875,L A M A R U N R E A L via thecheckdown ,39,13650,68216,81866,video
CompanyJ_8876,Mahomes came to BALL in his showdown with Lamar 27 37 374 yards 3 TDs W via brgridiron ,87,629,4392,5021,photo
CompanyJ_8877,Evan Engram HOW Via thecheckdown ,33,5280,33041,38321,video
CompanyJ_8878,The future via thecheckdown ,28,2345,20625,22970,video
CompanyJ_8879,Bills superfan Pancho Billa passed away in May but his son Gino is carrying on his legacy in his absence via thadbrown7 ,120,2482,15645,18127,video
CompanyJ_8880,Last week Fans boo Neymar pregame he scores 92nd minute winner This week Fans pelt him with plastic cups he scores 87th minute winner Neymar just keeps going brfootball ,169,751,3920,4671,photo
CompanyJ_8881,These Patriots are scary Through three games 3 0 Brady 8 TDs Outscored opponents 106 17 Outgained opponents 1 225 597 yards ,124,2217,9215,11432,photo
CompanyJ_8882, See you in the AFC title game ,31,3505,28252,31757,photo
CompanyJ_8883,Her Make a Wish was to meet her favorite player Today Diggs made it happen for Brooke via NFL ,94,679,5887,6566,photo
CompanyJ_8884,Saquon Barkley had to be helped to the locker room after injuring his ankle Hope he s alright via NFLonFOX ,107,486,3561,4047,video
CompanyJ_8885,Kamara wasn t going down Kamara wasn t going out of bounds TOUCHDOWN SAINTS via thecheckdown ,93,1193,8185,9378,video
CompanyJ_8886,Frank Gore scored the game winning TD and the first person he wanted to celebrate with was his son Ivia JonScottTV h t thecheckdown ,132,3239,27378,30617,video
CompanyJ_8887,CMC WAS OUT via NFL ,20,990,6529,7519,photo
CompanyJ_8888,Donte Jackson FLOATED for this interception via thecheckdown ,61,5051,26886,31937,video
CompanyJ_8889,It took seven people to take down Kamara via thecheckdown ,58,754,5004,5758,video
CompanyJ_8890,DANIEL JONES COMEBACK KID via NFL ,34,4258,22516,26774,photo
CompanyJ_8891,Daniel Jones era is here via brgridiron ,40,1498,6366,7864,video
CompanyJ_8892,Saquon had to join the Giants celebration even on one leg via thecheckdown ,75,2083,21107,23190,video
CompanyJ_8893,Odell getting ready for primetime via NFL ,42,889,9080,9969,video
CompanyJ_8894,Never change OBJ via SNFonNBC ,30,6696,37625,44321,video
CompanyJ_8895,Snoop Dogg took over DeAndreHopkins IG while Hop was playing ,61,575,5240,5815,video
CompanyJ_8896,Baker gets fancy with it via thecheckdown ,42,2658,29090,31748,video
CompanyJ_8897,Did Baker just call a Daniel Jones audible via thecheckdown ,60,351,4670,5021,video
CompanyJ_8898,LeBron giving Bronny some pointers during his Sierra Canyon debut brhoops via aaron imanoel IG h t HoHighlights ,112,2469,22041,24510,video
CompanyJ_8899,Rams stay undefeated 3 0 LA handles the Browns 20 13 Cooper Kupp 11 REC 102 YARDS 2 TDs ,88,504,3929,4433,photo
CompanyJ_8900,Dak and Coop playing with money on their minds for the 3 0 Cowboys Dak 70 94 920 yards 2 turnovers 10 total touchdowns Coop 16 catches 238 yards 4 touchdowns ,158,970,7373,8343,photo
CompanyJ_8901,Dunked over him standing on a chair via fiba3x3 ,48,1213,7309,8522,video
CompanyJ_8902, Started throwing babies out the window We was catching em unlike Agholor Philly is ruthless via SteveLindsayCBS ,113,16840,66913,83753,video
CompanyJ_8903,CFB week 4 had everything What was the best play champssports ,62,168,2558,2726,link
CompanyJ_8904,Must have the highest shot power in the game via PSN dass1494 ,62,6096,34559,40655,video
CompanyJ_8905,Giants are expecting to lose Saquon for the next several weeks with a high ankle sprain per RapSheet ,101,462,3552,4014,photo
CompanyJ_8906,Keenan Allen threw TheRealJRSmith his touchdown ball and then broke out Swish s celebration brgridiron ,103,4375,39785,44160,video
CompanyJ_8907, Dame_Lillard s shoes are just a few sizes too big for Dame Jr brkicks ,71,477,6498,6975,video
CompanyJ_8908,MLB batting leader Tim Anderson wants to bring fans back to the game even he calls boring And the bat flip is a start ,118,308,1781,2089,photo
CompanyJ_8909, Rapinoe arrives at TheBestAwards ,34,84,667,751,photo
CompanyJ_8910,Police confirm Andre Emmett was killed Monday morning in Dallas The former Texas Tech star played for the Nets and Grizzlies He was an MVP candidate in thebig3 R I P ,166,1685,6759,8444,photo
CompanyJ_8911,Half million on one game ROUGH br_betting ,42,196,1688,1884,photo
CompanyJ_8912,Leo Messi wins TheBest Men s Player brfootball ,47,960,3878,4838,photo
CompanyJ_8913, World Cup champion World Cup Golden Boot World Cup Golden Ball And now TheBest Women s Player brfootball ,106,276,1484,1760,photo
CompanyJ_8914,Messi has now won the most ever FIFA men s Player of the Year awards 6 via brfootball ,86,1437,7349,8786,photo
CompanyJ_8915,Only one start for Danny Dimes brgridiron ,42,722,5876,6598,photo
CompanyJ_8916,Coby White s best hair day happened to land on the same day his lifelong dream came true draft night att ,105,263,2399,2662,video
CompanyJ_8917,Iggy and the Grizzlies have reached an agreement to keep him out of camp and on the trade market per HerringtonNBA ,115,645,4246,4891,photo
CompanyJ_8918,Wisconsin RB Jonathan Taylor lived up to his Heisman hype this past weekend against Michigan and he did it all with a custom LV mouthguard ,139,206,1784,1990,video
CompanyJ_8919,The Bucs missed field goal meant his bet hit His reaction NSFW via johnmorris_ IG h t br_betting ,97,398,3649,4047,video
CompanyJ_8920, nelsonagholor is inviting this man and his family to the next Eagles home game Respect ,88,2814,23516,26330,link
CompanyJ_8921,Khalil with The Silencer after the sack via NFL ,48,518,4629,5147,photo
CompanyJ_8922,Khalil Mack can t be stopped via thecheckdown ,46,1072,9703,10775,video
CompanyJ_8923,Taylor Gabriel is going off tonight First TD Good Second TD Great Third TD via NFL ,83,1088,7551,8639,photo
CompanyJ_8924, SSJreef via brhoops ,21,883,8299,9182,photo
CompanyJ_8925,He s really stirring the Gatorade with a sleeve of cups via thecheckdown ,73,6147,39593,45740,video
CompanyJ_8926,Vernon Davis accidentally pressed the wrong button via thecheckdown ,68,6341,49251,55592,video
CompanyJ_8927,Khalil Mack went off 3 tackles 2 sacks 2 forced fumbles Chicago routs Washington 31 15 ,87,2708,21324,24032,video
CompanyJ_8928,It s always the last game br_betting ,37,248,2822,3070,link
CompanyJ_8929,A year ago today the laugh via TSN_Sports ,42,11222,44794,56016,video
CompanyJ_8930,Messi named Ronaldo in his TheBest voting but Ronaldo didn t pick Messi via brfootball ,87,334,2610,2944,photo
CompanyJ_8931,Stole it then nutmegged him Brutal via esp_interativo ,54,813,6160,6973,video
CompanyJ_8932,The first time JManziel2 ever rolled dice he spent 8 hours at the table and turned 2 500 into 100K br_betting ,110,1512,11540,13052,video
CompanyJ_8933,Bradley Beal hit the pose via WashWizards ,42,1402,14283,15685,video
CompanyJ_8934,Now in his third season with FAU Lane Kiffin said being fired by USC changed him for the better as both a coach and a person Had that never happened I think I d still be so just drawn by the chase of the championships and the ego ,230,62,472,534,photo
CompanyJ_8935,NBA exec on LaMelo s play in NBL If he keeps this up I don t see any way he isn t in the conversation for the No 1 overall pick per DraftExpress ,145,1497,7433,8930,photo
CompanyJ_8936,This robot can do an entire gymnastics routine via WIRED BostonDynamics ,72,2352,13863,16215,video
CompanyJ_8937,Kevin Durant expected to miss the entire 2019 20 season according to GM Sean Marks ,83,1988,10812,12800,photo
CompanyJ_8938,Russ training a future No 1 pick ,33,539,5581,6120,video
CompanyJ_8939,Middle of the game but Dak is thinking about the spicy nuggets via NFLFilms ,76,5986,37895,43881,video
CompanyJ_8940,Baker took the time to sign autographs and take pictures with every kid at a Special Olympics event today brgridiron via clevelanddotcom ,137,492,5838,6330,video
CompanyJ_8941,Kawhi My hands too big for that little a bait over there This new look LAClippers team already has team chemistry ,114,1569,9664,11233,video
CompanyJ_8942,Griezmann goal Messi assist The first Messi Griezmann connection ,65,183,1696,1879,photo
CompanyJ_8943, ,1,1299,7682,8981,photo
CompanyJ_8944,The team was so hype for him after he scored via gokhanmuslera IG ,66,1579,11100,12679,video
CompanyJ_8945,Local high school player Jayden Payne saved a mom and her baby from drowning in Texas floodwaters last week He ll be at the Texans game as a guest of deshaunwatson ,164,652,7054,7706,photo
CompanyJ_8946,Tottenham are knocked out of the League Cup by Colchester a fourth tier team ,77,183,1029,1212,photo
CompanyJ_8947, WHAT S IN THE BOX Starters are going down based on the seven deadly QB sins GridironHeights PlayStation ,105,1234,4537,5771,video
CompanyJ_8948, KingJames working out in a Bronny shirt ,41,788,9059,9847,video
CompanyJ_8949,Mahailya Reeves is just 15 years old and she s already breaking records with a 360 pound bench press ,101,1091,5920,7011,video
CompanyJ_8950,Eagles fan is back to explain why he roasted nelsonagholor despite having just saved people from a burning building He was thinking No fumble via JClarkNBCS ,157,8389,38462,46851,video
CompanyJ_8951,Their reaction when Aaron Judge gave them his gloves and bat is what sports are all about via MarlyRiveraESPN ,110,772,6560,7332,video
CompanyJ_8952,Lakers are in the house for Mystics vs Aces ,44,603,6465,7068,photo
CompanyJ_8953,Pedro was almost in pinstripes ,31,92,709,801,photo
CompanyJ_8954,Elena Delle Donne was in MVP form to send the Mystics to the WNBA Finals 25 PTS 6 REB 5 7 3PT Mystics vs Sun for the championship ,130,729,4476,5205,photo
CompanyJ_8955,On this day in 2000 Vince Carter did this Over 7 2 Frederic Weis During an Olympic game ,88,6636,33903,40539,photo
CompanyJ_8956,Steve Kerr says the KD Draymond incident wasn t a big deal as crazy as that sounds The Warriors coach on the KD drama how he ll use D Lo and more on The Full 48 podcast with HowardBeck ,185,86,682,768,photo
CompanyJ_8957,Grant Holloway went down as one of the greatest collegiate hurdlers of all time now he s out to become an olympic icon DNA of a champion From B R x adidasrunning ,162,725,2393,3118,video
CompanyJ_8958,Jets rookie QuinnenWilliams re created some of the most iconic memes of all time New Ditch the Playbook with AdamLefkoe StateFarm ,130,634,2886,3520,video
CompanyJ_8959,On this day in 2001 Michael Jordan made the announcement he would come out of retirement again He donated his salary to relief agencies working with victims from the 911 terrorist attack ,187,1502,10622,12124,photo
CompanyJ_8960, Never take it for granted Teddy Bridgewater s postgame speech after getting the W starting in place of Brees via NFLFilms ,123,3660,26644,30304,video
CompanyJ_8961,Still Warriors vs the world ,28,208,1880,2088,photo
CompanyJ_8962,Near bust for the Pirates future superstar for the Rays and all it took Tyler Glasnow was a different mindset The mind can be manipulated the whole day is dedicated to me convincing myself I m the best person on the field ,222,86,720,806,photo
CompanyJ_8963,WWE needs to make this Ronaldo vs Messi happen with a Ballon d Or in the suitcase brfootball ,93,287,1175,1462,video
CompanyJ_8964,QB1 mentality via brgridiron ,29,751,8716,9467,photo
CompanyJ_8965,Shaq couldn t believe he s the only player to ever get a 100 rating on NBA 2K But I was so lazy via FairGameonFS1 ,114,3690,24026,27716,video
CompanyJ_8966,Kyrie has been diagnosed with a left side facial fracture and will be day to day per ShamsCharania ,99,678,4734,5412,photo
CompanyJ_8967,Baker s response to Rex Ryan calling him overrated as hell Savage via MaryKayCabot ,83,4450,32481,36931,video
CompanyJ_8968,Mom didn t care how much this kid made br_betting Via gregalcaro IG ,68,236,1996,2232,video
CompanyJ_8969,Zlatan can do it all via juanpcaffa ,36,2319,16082,18401,video
CompanyJ_8970,Melvin Gordon will end his holdout and report to the Chargers tomorrow per RapSheet He won t play this week but plans to be back on the field with teammates ,157,1146,6824,7970,photo
CompanyJ_8971,Steph launching from deep at the PGA Tour via loganmmurdock ,60,492,5391,5883,video
CompanyJ_8972,Alabama WRs apparently play mid game rock paper scissors to decide who is going to run the TD route Unbelievable via omwhitmireTV ,130,3418,26409,29827,video
CompanyJ_8973,This fan was GOING OFF on ochocinco after beating him in FIFA Chad Johnson was speechless NSFW via br_betting ,110,1184,8567,9751,video
CompanyJ_8974,Never seen a finish like this before via luarirup IG brfootball brgaming ,73,3979,27096,31075,video
CompanyJ_8975,Serena Williams turns 38 today 23 Grand Slam titles most by any man or woman in Open Era Has been ranked No 1 for 319 weeks total 4x Gold Medalist ,147,862,4041,4903,photo
CompanyJ_8976, 328 And Barcelona is still going to appeal the fine brfootball ,64,136,1719,1855,photo
CompanyJ_8977,Patrick Mahomes becomes fastest player to reach 99 rating in Madden brgridiron via NFLOutsiderRig h t BRGaming ,111,1209,13428,14637,video
CompanyJ_8978,22 years since leaving the Tar Heels Mack Brown is back and has the program feeling rejuvenated Mack will still recruit better than anyone ,139,138,895,1033,photo
CompanyJ_8979,A fan of the Moroccan club Al Raja has cancer and isn t able to attend any games so the team s fanbase came to his house to show their support via RCAOfficiel1949 ,163,353,3508,3861,video
CompanyJ_8980, He tweaking me out dog Shump went to the Magic Castle in MYCALVINS and had his mind blown From B R x CalvinKlein ,114,78,674,752,video
CompanyJ_8981,Stone Cold Steve Austin says he could wrestle one more match at 54 years old I m in a good place Could I have a match In theory yes via steveaustinBSR ,151,1317,6965,8282,photo
CompanyJ_8982,Pelicans are hiring HOFer and 5x WNBA All Star Teresa Weatherspoon to their coaching staff per wojespn New Orleans now has two NY legends on its staff T Spoon and Swin Cash ,173,493,2909,3402,photo
CompanyJ_8983,Twins are the first team to ever hit 300 home runs in a season ,63,498,3361,3859,video
CompanyJ_8984,Old faces new arrivals more drama The Champions Season 3 drops Monday at 5 p m ET playstation ,94,121,790,911,video
CompanyJ_8985,Russ bringing that fire to Houston already NSFW via dmorey ,59,2468,13919,16387,video
CompanyJ_8986,3 16 return ,12,522,3551,4073,photo
CompanyJ_8987,James Conner has been a fantasy dud That changes this week vs Cincy YahooFantasy ,81,48,437,485,video
CompanyJ_8988, QuinnenWilliams confused the legend Chris Farley for AdamSchefter statefarm ,77,78,692,770,video
CompanyJ_8989,Klaw x Mamba Championship mentality MambaSportsHQ ,50,3964,25436,29400,photo
CompanyJ_8990,Gardner Minshew met the real Uncle Rico How much you wanna bet I can throw a football over them mountains brgridiron via Jaguars ,129,3835,22361,26196,photo
CompanyJ_8991,Kyle Kuzma is out indefinitely with a stress reaction in his foot suffered with Team USA ,89,736,4723,5459,photo
CompanyJ_8992,Fan who roasted Nelson Agholor after catching babies from a burning building is selling shirts and giving some of the profits to the family affected by the fire via AlexHolleyFOX29 ,181,763,5214,5977,photo
CompanyJ_8993,14 years in the NFL and Marcedes Lewis is still doing this via NFL ,67,545,5159,5704,video
CompanyJ_8994,Rodgers yelled hard count to try and get Philly to jump via thecheckdown ,73,413,5773,6186,video
CompanyJ_8995,Tae Adams almost has 150 receiving yards and it s still the second quarter Eagles need some help ,97,1029,7058,8087,photo
CompanyJ_8996,GERONIMO Packers WR fought through contact for the grab via NFL ,64,311,2627,2938,photo
CompanyJ_8997,Markelle Fultz follow through is different cbrueywftv IG ,57,1181,9686,10867,video
CompanyJ_8998,Jeezy is launching a sports agency Sports 99 will rep NBA and NFL players per ChrisBHaynes ,91,917,3961,4878,photo
CompanyJ_8999,Bad man via NFL ,16,717,6687,7404,photo
CompanyJ_9000,Jordan Howard is EATING in Green Bay 3rd TD of the game ,56,727,5974,6701,photo
CompanyJ_9001, Pointed right to the flag via thecheckdown ,44,13328,74914,88242,video
CompanyJ_9002,EAGLES WIN IT Philly picks off Aaron Rodgers with the game on the line to secure the W Wentz 3 TD Howard 3 TD ,110,1777,7334,9111,photo
CompanyJ_9003,DAGGER via NFL ,15,876,4836,5712,photo
CompanyJ_9004,Seattle poured its heart out for King Felix via mlb ,52,1703,13680,15383,video
CompanyJ_9005,Bron s new look for 2019 NSFW ,30,3088,20371,23459,video
CompanyJ_9006,Big time mood brfootball ,25,279,3783,4062,photo
CompanyJ_9007, FIFA20 day is here brfootball ,31,473,3176,3649,photo
CompanyJ_9008,Zlatan jumpstarting the matrixchallenge brfootball Ibra_official ,65,1015,7778,8793,video
CompanyJ_9009,NBA media day is here Don t sleep on the Rockets closet brkicks ,64,2397,14260,16657,photo
CompanyJ_9010,Jets rookie QuinnenWilliams was so comfortable in his Oprah outfit he started Facetiming people and singing Whitney Houston StateFarm ,134,50,413,463,video
CompanyJ_9011,King of Brooklyn Via YESNetwork ,32,2140,12768,14908,video
CompanyJ_9012,Kyrie knows a lot of people are invested in protecting the biggest competitors of the game via SNYtv ,101,634,3303,3937,video
CompanyJ_9013, We want to end our careers together via SNYtv ,47,1687,12211,13898,video
CompanyJ_9014, Ultimately I wanted to be here KD via SNYtv ,45,476,3708,4184,video
CompanyJ_9015,Canelo doesn t need part 3 against GGG he has nothing to offer he s basically coming off a fight against nobody DAZN_USA ,121,201,974,1175,photo
CompanyJ_9016,Kyrie keeping it a buck ,24,362,2423,2785,photo
CompanyJ_9017, They really thought we d be Knicks KD and Kyrie probably brkicks ,66,7417,42586,50003,video
CompanyJ_9018,H Town via HoustonRockets ,26,2149,9914,12063,photo
CompanyJ_9019,Kobe to Tyson Chandler He s James Harden going to be the next one after me via doloresalozano ,94,656,4041,4697,video
CompanyJ_9020,James Harden doesn t play the blame game when leading Via MarkBermanFox26 ,74,168,1166,1334,video
CompanyJ_9021,James Harden on the 2020 Olympics It s one of my goals to represent this beautiful country via espn_macmahon ,109,580,6770,7350,photo
CompanyJ_9022,Why d he roar in his face like that via ufc ,44,3513,21876,25389,video
CompanyJ_9023,Russ It s gonna be scary Not for us via MarkBermanFox26 ,56,2485,13975,16460,video
CompanyJ_9024,The Pelicans got Zion but say they still want to build the team in Jrue s image He could launch himself into the MVP conversation Guards KD Dame Still puts up 20 amp 10 Most underrated guard in the league More from NOLA ,220,1210,7451,8661,photo
CompanyJ_9025,Jimmy saw how Miami embraced Wade County and wanted in ,55,517,3997,4514,photo
CompanyJ_9026,Bron and Lakers plan to run offense through AD via HarrisonSanford ,67,1402,8683,10085,video
CompanyJ_9027,Who was the biggest winner of the summer Bron Staples Center via NBATV SpectrumSN ,82,1576,11649,13225,video
CompanyJ_9028,Lakers look ready for the runway via NBA ,41,2098,14243,16341,video
CompanyJ_9029,Bron got jokes brhoops ,23,205,2513,2718,photo
CompanyJ_9030,AD was surprised to hear that Bron and Lakers want to run offense through him ,78,1469,9802,11271,video
CompanyJ_9031,Brodie and Beard are coming for the rest of the league ,55,447,2960,3407,photo
CompanyJ_9032,Brooklyn s Blueprint via NBA ,29,1160,8827,9987,photo
CompanyJ_9033, YES SIR KingJames seems excited for year 17 via NBA ,53,8730,50290,59020,video
CompanyJ_9034,Yankees reach 300 homers on the year Bronx Bombers came to rake this season ,76,468,2666,3134,video
CompanyJ_9035,N e v e r b u n t Bunt for a double via MLB ,44,568,5217,5785,video
CompanyJ_9036,Roy Williams was getting down at UNC via GoHeels ,49,6611,35952,42563,video
CompanyJ_9037, JimmyButler showing off his melodies ,38,877,5147,6024,video
CompanyJ_9038,Five star recruit Sharife Cooper has committed to Auburn Tigers may have gotten the best point guard in the 2020 class brhoops ,127,817,4580,5397,video
CompanyJ_9039,Three years ago today KMbappe made his Champions League debut and helped lead Monaco to a semi final run brfootball ,116,239,2528,2767,video
CompanyJ_9040,Dalvin Cook is coming for the rushing title this year brgridiron ,65,452,3858,4310,video
CompanyJ_9041,Liverpool really got the W on this goalkeeper error They ve won all seven Premier League games this season via NBCSportsSoccer H T brfootball ,142,184,2275,2459,video
CompanyJ_9042,Jimmy Butler got some of the best NBA memes His explanations for how they happened is just as funny via ClayWPLG ,113,3791,20849,24640,video
CompanyJ_9043,CMC is a cheat code in Madden How d he go under them like that via marbinwitab IG ,82,1805,17051,18856,video
CompanyJ_9044,Carried him through the end to finish together at the World Athletics Champs What a display of sportsmanship Via NBCSports ,123,3035,15192,18227,video
CompanyJ_9045,He really emailed the NCAA to investigate the over br_betting via typical goose IG ,83,544,4310,4854,photo
CompanyJ_9046,Enes Kanter knew he wasn t blocking Tacko Fall nicolecyang ,59,521,5636,6157,video
CompanyJ_9047,Wade Unions vs James Family Tacos on the line These bets getting crafty but they re serious ,92,349,3091,3440,photo
CompanyJ_9048,CeeDee Lamb isn t fair 71 yards via OU_Football ,48,516,3650,4166,video
CompanyJ_9049,The first Pokemon game turns 21 today Pros who weren t born yet Kylian Mbappé Vladimir Guerrero Jr Luka Doncic Fernando Tatís Jr BRGaming ,138,819,5704,6523,photo
CompanyJ_9050,Jalen Hurts 308 passing yards is a career high for a half Kyler Murray never had a 300 yard passing half in college ,116,1047,8703,9750,photo
CompanyJ_9051,KD and Kyrie getting up shots via SNYtv ,40,1110,8030,9140,video
CompanyJ_9052,Jalen Hurts put on a clinic against Texas Tech 17 24 for 415 yards 3 TDs 1 INT 9 carries for 70 yards 1 TD Dropped a career high 308 passing yards in 1st half in eventual 55 16 win Where is he on your Heisman rankings ,218,2217,12326,14543,video
CompanyJ_9053,MACK BROWN HAS UNC PREPARED via accnetwork ,43,546,5037,5583,video
CompanyJ_9054,Tua froze the defense with the pump and cut upfield for the score via CBSSports ,80,173,1714,1887,video
CompanyJ_9055, JalenHurts back in the weight room after a big win ,52,6606,45123,51729,video
CompanyJ_9056,DeVonta Smith update 7 catches 188 yards 3 TDs and counting Definition of dominant via CBSSports ,97,255,1598,1853,video
CompanyJ_9057,DEVONTA SMITH FOUR TOUCHDOWNS 221 YARDS ONE HALF via CBSSports ,63,1196,6305,7501,video
CompanyJ_9058,DeVonta Smith picks up his 5th TD and the Bama single game receiving yards record Unreal via CBSSports ,103,865,5120,5985,video
CompanyJ_9059,He d win 8 8 million br_betting ,32,299,2032,2331,photo
CompanyJ_9060,DeVonta Smith had an unforgettable day for Bama 11 catches for 274 yards 5 TDs single game school record Passed Amari Cooper for most receiving yards in single game at Bama WILD ,178,3221,15419,18640,video
CompanyJ_9061,Zion got his own banner in New Orleans via PelicansNBA ,55,1146,8954,10100,photo
CompanyJ_9062,Ohio State pick Justin Fields touchdown run OSU showing out early against Nebraska via BigTenNetwork ,101,313,2655,2968,video
CompanyJ_9063,Pete Alonso is the new rookie HR king Did not get drafted when he finished HS in 2013 64th pick in 2016 by Mets Rookie record for most RBI before All Star break 2019 HR Derby Champion 53 HRs and counting No ceiling on his potential ,232,1398,6228,7626,photo
CompanyJ_9064,49 year old Antonio McKee is fighting on the same card as his son A J tonight He won by TKO Bellator228 via DAZN_USA ,117,617,4163,4780,video
CompanyJ_9065,Isaiah Hodgins had to reach back for the one handed TD via Pac12Network ,72,1283,10543,11826,video
CompanyJ_9066,Another 4 TDs for Justin Fields Ohio State dominates Nebraska 48 7 ,67,1108,8044,9152,photo
CompanyJ_9067,The kid s reaction when Pete Alonso broke the rookie home run record via SamZComedy ,84,2814,21351,24165,video
CompanyJ_9068,Holding off a comeback That s cold Catching the ball as well as you throw it Ice cold From B R X CoorsLight ,108,228,1991,2219,video
CompanyJ_9069,Errol Spence Jr comes out on top Spence edges out Shawn Porter by judges decision to keep undefeated record alive at 26 0 What a fight SpencePorter via PBConFOX ,161,2901,8933,11834,video
CompanyJ_9070,Winning back PSG fans is just that simple brfootball ,53,142,1814,1956,photo
CompanyJ_9071,A team official interested in Antonio Brown told mikefreemanNFL the league will use what he s doing on Twitter as further proof he s out of control and needs to be suspended AB has argued with Baker and Weddle after calling out Ben Kraft and Shannon Sharpe brgridiron ,268,378,2503,2881,photo
CompanyJ_9072,New shoe New go to move After a busy offseason James Harden is ready to get the preseason started tomorrow adidashoops ,119,604,3079,3683,video
CompanyJ_9073,KD turns 31 today Absolute bucket from the jump ROY MVP 2x NBA champ 2x Finals MVP 10x All Star 4x scoring champ No 6 in PPG Never averaged under 20 PPG Youngest to join 50 40 90 club Youngest scoring title ever 21 years old 30 1 PPG ,234,7673,34756,42429,photo
CompanyJ_9074,Week 4 is almost here TheMattCamp is answering all your fantasy questions on Your Fantasy Fire Drill Watch NOW before you lock your lineups ,140,15,62,77,link
CompanyJ_9075,KD rang in his 31st birthday with some Pop A Shot alongside Kyrie via ArashMarkazi ,83,1562,14513,16075,video
CompanyJ_9076,Patrick Mahomes and a fan had the most wholesome conversation of the day via Chiefs ,84,1595,17155,18750,video
CompanyJ_9077,Bills coach Sean McDermott wasn t having it with these Patriots staffers during Buffalo s warmups via thadbrown7 ,113,339,2820,3159,video
CompanyJ_9078,Joe Maddon will not return as Cubs manager per JeffPassan ,58,247,1554,1801,photo
CompanyJ_9079,This is everything JJWatt via NFLonFox ,39,592,5288,5880,video
CompanyJ_9080, Dolphins have their first lead of the season via MiamiDolphins ,64,518,4242,4760,photo
CompanyJ_9081,Touchdowns allowed by the Patriots D ST 0 Touchdowns scored by the Patriots D ST 3 via NFL ,91,507,3512,4019,photo
CompanyJ_9082,This absolute from OBJ deserved a catch via NFL ,48,2945,22477,25422,photo
CompanyJ_9083,No 15 overall NFL draft pick Dwayne Haskins now in at QB for Washington brgridiron ,83,831,6564,7395,photo
CompanyJ_9084,15K career rushing yards Emmitt Smith Walter Payton Barry Sanders And now Frank Gore Legend ,92,4466,31626,36092,photo
CompanyJ_9085,A couple got married during halftime at the Bills game First date was Bills game in 08 Jim Kelly gave away the bride Kyle Williams officiated the wedding Story to tell for a lifetime via thecheckdown ,200,1178,12362,13540,video
CompanyJ_9086,Deshaun did the Mutombo finger wag right in Jermaine Carter s face on his way to scoring a TD Savage via thecheckdown ,118,1390,10915,12305,video
CompanyJ_9087,Lamar stopped on a DIME via NFL ,32,1223,9981,11204,photo
CompanyJ_9088,Can t stop watching Christian McCaffrey making this catch via NFL ,66,1186,9945,11131,photo
CompanyJ_9089,Just when you thought the Chiefs offense couldn t get more creative Mahomes Kelce Shady via NFL ,96,4867,26653,31520,photo
CompanyJ_9090,COLD BLOODED Mahomes leads a game winning drive capped by a Darrel Williams TD with 20 seconds left to beat the Lions 34 30 ,124,1069,8341,9410,photo
CompanyJ_9091,Bradley Chubb with a false start dance via thecheckdown ,56,1679,15301,16980,video
CompanyJ_9092,Today the Patriots defense gave up its first touchdown since the AFC Championship game last season That was 252 days ago ,121,1167,8152,9319,photo
CompanyJ_9093,It s the little things for OBJ brgridiron ,42,223,2377,2600,photo
CompanyJ_9094,Beard is changing the game ,27,790,4790,5580,photo
CompanyJ_9095,Had to wait until the last day of the MLB season for the catch of the year via Orioles ,87,1533,9942,11475,video
CompanyJ_9096,Leonard Fournette trying to put the Jaguars on his back via thecheckdown ,73,2313,21220,23533,video
CompanyJ_9097,Kawhi was shown on the video board at the Rams game in Los Angeles and got booed via RPMSports18 ,97,2135,12454,14589,video
CompanyJ_9098,No 1 and 2 on the NFL s all time reception list via NFL ,56,3008,29338,32346,photo
CompanyJ_9099, Schaub we might need you cause Matt playing like some doodoo Dude unleashed on the Falcons at halftime Atlanta eventually lost to the Titans 24 10 via tonyhuntzinger ,167,3222,11978,15200,video
CompanyJ_9100,Ndamukong Suh beats his former team with game sealing TD via thecheckdown ,74,2530,21056,23586,video
CompanyJ_9101,Minshew Magic via NFL ,22,566,4659,5225,photo
CompanyJ_9102,Leonard Fournette had himself a career day brgridiron ,54,846,6490,7336,photo
CompanyJ_9103,After the Texans tough loss today Deshaun Watson went back onto the field hours later to work with QB coach Quincy Avery brgridiron via AaronWilson_NFL ,152,1282,10738,12020,video
CompanyJ_9104,Taysom Hill is a freight train in the backfield via thecheckdown ,65,3375,24724,28099,video
CompanyJ_9105,Good luck trying to tackle Alvin Kamara via thecheckdown ,57,2809,24307,27116,video
CompanyJ_9106,Whole lotta buckets in LA ,26,1278,9206,10484,photo
CompanyJ_9107,One last play ,14,106,1308,1414,photo
CompanyJ_9108,Saints hand the Cowboys their first L of the season NOLA beats Dallas 12 10 and moves to 2 0 without Drew Brees ,112,2952,13065,16017,photo
CompanyJ_9109,,0,3023,14923,17946,photo
CompanyJ_9110,Adam Thielen says the Vikings have to be able to throw the ball in this league you can t be one dimensional Minnesota ranks 31st in passing yards per game this year via SeawrightSays ,183,525,4717,5242,video
CompanyJ_9111,PG thinks he and Kawhi are the best duo in the game Two guys that can go and get a basket Two guys that can stop you from getting a basket via NBATV ,149,1431,11077,12508,video
CompanyJ_9112,California governor Gavin Newsom signs bill that will allow California college athletes to profit off their name likeness and image Newsom signed it on the TheShop with KingJames ,179,5339,20671,26010,video
CompanyJ_9113,Meek Mill brought Russ Harden P J Tucker and Austin Rivers on stage last night at his show via rockets_insider ,111,939,5296,6235,video
CompanyJ_9114,This week is stacked ,21,504,2529,3033,photo
CompanyJ_9115,You don t always get this kind of insight from one of the best in the game brgridiron via HoustonTexans ,104,1092,8592,9684,video
CompanyJ_9116,Raiders LB Vontaze Burfict has been suspended for the rest of the season for repeated violations of unnecessary roughness rules ,128,1724,9485,11209,photo
CompanyJ_9117, King Kong ain t got nothing on me Le Veon Bell pranks his boy Jamal Adams in a head to head GhostRecon Breakpoint battle Available October 4th pre order now ghostrecon xbox ,174,150,1117,1267,video
CompanyJ_9118,The future in NOLA via PelicansNBA ,35,1224,9140,10364,video
CompanyJ_9119,Vince McMahon and WWE vs Cody Rhodes and AEW Inside the Game of Thrones style battle for the pro wrestling throne ,114,97,581,678,photo
CompanyJ_9120, You re supposed to jump Chest bumps with Tacko are a little different via celtics ,83,3751,29098,32849,video
CompanyJ_9121,Zion grew up creating himself on 2K He can t believe he doesn t have to anymore Man I m here via PelicansNBA ,109,2453,21442,23895,video
CompanyJ_9122,Broncos OLB Bradley Chubb is out for the year with a torn ACL per AdamSchefter ,79,515,3305,3820,photo
CompanyJ_9123, That s around the time that your idols become your rivals Kyler used to watch Russ wearing his jersey On Sunday they swapped brgridiron ,137,1275,12775,14050,photo
CompanyJ_9124,J J Redick s been to the playoffs every year of his career He told Zion Don t f k this up for me via PelicansNBA ,113,12740,69928,82668,video
CompanyJ_9125,LeBron breaks down what would ve happened if he d gone to college and says his family wouldn t have gotten anything from it via BenGolliver ,140,2799,14229,17028,video
CompanyJ_9126,Ben s ready to launch ,22,1274,8838,10112,photo
CompanyJ_9127,WHOA via NBCSportsSoccer ,25,372,1991,2363,video
CompanyJ_9128,This will take some getting used to via wontgottlieb ,53,671,6105,6776,photo
CompanyJ_9129,Finally The Rock HAS COME BACK The People s Champ says he s returning to the WWE this Friday for SmackDown s Fox debut ,119,1984,10032,12016,photo
CompanyJ_9130, CR7 gives newcomer Joao Felix some advice Pulisic can t fit in Klopp and Pep s showdown It s move in day for The Champions S3 Premiere PlayStation ,148,363,1632,1995,video
CompanyJ_9131,This was filthy via brfootball ,31,256,2780,3036,video
CompanyJ_9132,Jimmy made his own neymarjr jersey for media day via MiamiHEAT ,63,363,3679,4042,video
CompanyJ_9133, TeamJuJu always doing it for the fans via thecheckdown ,56,408,5977,6385,video
CompanyJ_9134,Dray is confident the Dubs are going back to the Finals this year Steph Curry still on the team Klay Yup via NickFriedell ,122,1289,9848,11137,video
CompanyJ_9135,James Harden debuted his new move in the first game of the preseason ,69,3806,24955,28761,video
CompanyJ_9136, Fun isn t something one considers when balancing the NBA via PelicansNBA ,74,704,7009,7713,video
CompanyJ_9137,Here s your new Russ meme ,26,1711,13839,15550,video
CompanyJ_9138,Russ and Harden already on the same wave ,41,1597,13891,15488,video
CompanyJ_9139, via Dloading ,14,704,7664,8368,photo
CompanyJ_9140,Mahomes on the sideline before leading a game winning drive Can t teach this via chiefs ,88,11239,70498,81737,video
CompanyJ_9141,Mistaken identity Love triangle A cover up David Ortiz was shot almost four months ago and still nobody knows what really happened B R went to the Dominican Republic to investigate the shooting of the Red Sox icon ,214,256,1457,1713,photo
CompanyJ_9142,16 years ago today Cristiano Ronaldo made his Champions League debut All time top scorer 126 First player to win 5 UCL titles Only player to score in 11 straight games Single season scoring record 17 in 2013 14 ,211,1237,6624,7861,video
CompanyJ_9143,Kane Lewandowski Ronaldo Mbappe Expect goals today on brlive ,61,51,379,430,link
CompanyJ_9144,Dame already responded to Shaq s diss track Your shoes s t Kobe won you them rings In Miami won that on the strength of Flash Full song ,136,948,5433,6381,photo
CompanyJ_9145, A wedding and memorial service before the game Meeting the Godfather One of the best atmospheres in the world Inside a matchday with Galatasaray s ultrAslan via brfootball ,173,179,892,1071,video
CompanyJ_9146,Throw of the year Stafford really put it through four defenders on Sunday via thecheckdown ,91,2797,26703,29500,video
CompanyJ_9147,A goal s a goal brfootball ,27,155,1725,1880,video
CompanyJ_9148,Real Madrid 0 2 Club Brugge ,28,199,1620,1819,photo
CompanyJ_9149,Every Sixer hit the woah with him Via ChristianCrosby ,54,4048,23497,27545,video
CompanyJ_9150,Scores twice vs Real Madrid Hits the Ronaldo celebration ,57,697,4155,4852,photo
CompanyJ_9151,The cut the shot brfootball ,28,271,2238,2509,video
CompanyJ_9152,Zo s jumper looking clean via PelicansNBA ,42,4013,30902,34915,video
CompanyJ_9153,OH MY LEWANDOWSKI ,18,306,2322,2628,video
CompanyJ_9154,Joao Felix scores his first Champions League goal brfootball ,61,111,978,1089,photo
CompanyJ_9155,19 year old Joao Felix has arrived ,35,274,2719,2993,video
CompanyJ_9156, Couldn t stop him via brfootball ,34,135,1214,1349,video
CompanyJ_9157,Kawhi has the rooks carrying his fruit via LAClippers ,54,2315,19049,21364,video
CompanyJ_9158, Serge Gnabry with FOUR goals 9 goal thriller Tottenham 2 7 Bayern brfootball ,78,804,4388,5192,photo
CompanyJ_9159,Kyler sneaks in Matty Ice and Kirk struggle Lamar and Russ thrive This year s quarter season carnival is here PlayStation GridironHeights ,138,1047,4694,5741,video
CompanyJ_9160,Serge Gnabry wanted the game ball after scoring 4 but his teammate kicked it into the stands instead He couldn t believe it brfootball ,135,395,3910,4305,video
CompanyJ_9161,Ronaldo has now scored in 14 consecutive Champions League seasons Fourteen Straight ,84,514,4625,5139,video
CompanyJ_9162,California is paving the way for college athletes to get paid Professional athletes showed their support for The Fair Pay to Play act that was signed on an episode of The Shop ,176,339,2194,2533,video
CompanyJ_9163,What 3 5 million on the Astros to win the World Series looks like via DKSportsbook h t br_betting ,98,2457,11574,14031,photo
CompanyJ_9164,Harden ready to keep defenders guessing all season long via Cbrickley603 ,73,3055,18198,21253,video
CompanyJ_9165,The StLouisBlues invited 11 year old superfan Laila Anderson who has a life threatening immune disease to Game 7 of the Stanley Cup Final last year Today the team gave her a championship ring that has her name engraved in it ,225,1318,6297,7615,video
CompanyJ_9166,Love is the No 21 prospect in the class of 2020 per 247Sports He joins five star big men Walker Kessler and Day Ron Sharpe in Roy Williams current class ,153,439,2219,2658,link
CompanyJ_9167,Nationals beat the Brewers in the NL Wild Card game 4 3 Washington will move on to face the Dodgers in the NLDS ,112,1301,7062,8363,photo
CompanyJ_9168,May the force be with the Nationals the rest of the playoffs via Bobby_Blanco ,78,444,3684,4128,video
CompanyJ_9169,The Heat s first practice started at 10 a m on Tuesday Jimmy Butler clocked in at 3 30 a m Just a little extra work while y all in your third dream via IraHeatBeat ,164,2877,19758,22635,photo
CompanyJ_9170,The assist The first touch The speed The finish brfootball ,59,326,4128,4454,video
CompanyJ_9171,Controller about to get put through a wall BRGaming via daxanderman24 IG ,73,4645,24912,29557,video
CompanyJ_9172,Kyle Kuzma signed five year deal with Puma becomes face of company per shamscharania brkicks ,93,2970,22535,25505,photo
CompanyJ_9173, There s not a game I played in that I wasn t high Percy Harvin opens up about his struggles with anxiety during his playing career New Untold Stories with MasterTes ,166,5433,16498,21931,video
CompanyJ_9174,The European Champions are back home for the first time this season brfootball ,79,74,1013,1087,photo
CompanyJ_9175,2021 Texas commit made the OBJ catch in OBJ s exact spot via Hudl ,66,2221,19332,21553,video
CompanyJ_9176,The Yankees Dodgers and Astros are among the teams accused of sign stealing You can t trust nobody ,99,85,742,827,photo
CompanyJ_9177,Baker loves the game like he s still a kid in the backyard via thecheckdown ,76,3229,34452,37681,video
CompanyJ_9178, To show them they re missing something Club Brugge s Dennis on why he did the Ronaldo celebration vs Real Madrid via Esp_Interativo h t brfootball ,148,197,1284,1481,video
CompanyJ_9179,Happy birthday to the legend Joeingles7 ,40,2951,22879,25830,photo
CompanyJ_9180,Ran from his own half and got around everybody brfootball ,58,95,1080,1175,video
CompanyJ_9181,Zeke welcomes D Rose to Detroit via DetroitPistons ,51,1231,9162,10393,video
CompanyJ_9182,Lonzo to Zion alley Get used to this via WGNOsports ,52,2504,16200,18704,video
CompanyJ_9183,Only took two minutes for Barcelona to concede via brlive ,58,163,1094,1257,video
CompanyJ_9184,WHAT A STRIKE ,14,459,3326,3785,video
CompanyJ_9185,Van Dijk got crossed up brfootball ,35,1264,6763,8027,video
CompanyJ_9186,New angle of the Zo Zion alley Fast breaks with these two via PelicansNBA ,74,1892,13649,15541,video
CompanyJ_9187, Hat trick in his first UCL game Scores equalizer vs the reigning champions in his second 19 year old Erling Haaland is having a dream season so far ,149,158,1141,1299,photo
CompanyJ_9188,Oh my Luis Suarez via brlive ,29,489,3134,3623,video
CompanyJ_9189,Endless Euro buckets in Dallas this year Luka and KP are cash via swishcultures_ ,81,1646,11517,13163,video
CompanyJ_9190,Salah with the winner in a wild 4 3 Liverpool win brfootball ,61,199,1540,1739,photo
CompanyJ_9191,Messi to Suarez Unstoppable ,28,1140,6429,7569,video
CompanyJ_9192,Chris Jericho Jon Moxley The debut of AEW on TNT is about to change the wrestling world forever ,96,489,2734,3223,video
CompanyJ_9193,Messi with the smooth meg brfootball ,37,589,5351,5940,video
CompanyJ_9194,Yandy Diaz wasting no time That s the first postseason leadoff HR in Rays history ,82,146,1425,1571,video
CompanyJ_9195,Joker throwing dimes all throughout training camp via NBA ,58,2118,21900,24018,video
CompanyJ_9196,A day to remember for Yandy Diaz and the Rays as they beat the A s 5 1 in AL Wild Card Rays hit team playoff record 4 HRs Diaz records first postseason leadoff HR in Rays history Diaz goes from one HR combined in 2017 and 2018 seasons two HRs today against A s ,261,159,1057,1216,photo
CompanyJ_9197,Damn Boban ,11,1257,11987,13244,photo
CompanyJ_9198,Stefon Diggs frustration with the Vikings has been palpable and teammates are left wondering if he wants to be there per RapSheet ,130,842,7417,8259,photo
CompanyJ_9199,Got him via tampabayrowdies ,28,20221,93966,114187,video
CompanyJ_9200,Jameis comes with risk but it s time to take him seriously with Evans and Godwin dominating YahooFantasy ,105,50,478,528,video
CompanyJ_9201,Happy 38th birthday to Ibra_official who has only gotten better with age via brfootball ,88,563,4066,4629,photo
CompanyJ_9202,JuJu grew up with 23 family members and didn t sleep in a bed until he went to USC Now he s a record breaking 22 year old star with the pressure of Pittsburgh on his shoulders That comes with being The Guy ,206,541,4699,5240,photo
CompanyJ_9203,Don t mess with James Dolan s son ,34,148,1325,1473,video
CompanyJ_9204, Really trying to carry on that marathon Kuz says that honoring Nipsey was part of his decision to sign with Puma brkicks via NickDePaula ,138,1509,9747,11256,video
CompanyJ_9205,Frustration growing in Minnesota brgridiron ,44,411,3816,4227,photo
CompanyJ_9206,OBJ s casual with it No gloves via Browns ,42,2120,20691,22811,video
CompanyJ_9207,He can barely see over the child they paired him up with via brfootball ,72,485,5615,6100,video
CompanyJ_9208,Kawhi Kyrie and PG pulled up to Kobe s Mamba Sports Academy via MambaSportsHQ ,78,7452,33449,40901,video
CompanyJ_9209,Watching Atletico Madrid track back is mesmerizing via brfootball ,66,361,2658,3019,video
CompanyJ_9210,Shades of Jamal Crawford via EuroCup ,37,2763,13991,16754,video
CompanyJ_9211,Splash SZN approaching via dubs_training ,41,1563,11970,13533,video
CompanyJ_9212,Bron pulled up from the logo to tie the Lakers scrimmage with 6 seconds left via mcten ,87,5690,34089,39779,video
CompanyJ_9213,Zlatan s basketball twin pretended to be him all around Miami via FCBayernUS ,77,446,2050,2496,video
CompanyJ_9214, Don t talk to me Zo and JJ had a three point contest after practice via PelicansNBA ,85,2283,14991,17274,video
CompanyJ_9215,Fans asked Jimmy what took so long I can t wash my ass NSFW via pg shifty IG ,77,14489,74245,88734,video
CompanyJ_9216,KP responds to RJ Barrett saying he wanted to posterize him Knicks Mavs play on Nov 8 via fanaticsview ,103,1298,9489,10787,video
CompanyJ_9217,11 years ago today Candace_Parker became the first WNBA player to win ROY and MVP in the same season via WNBA ,110,3172,14043,17215,video
CompanyJ_9218,OZUNA CLUTCH ,13,268,2429,2697,video
CompanyJ_9219,Tyler Lockett WHAT via NFL ,27,3584,22387,25971,video
CompanyJ_9220,Acuña SENDS IT ,15,258,1853,2111,video
CompanyJ_9221,Cardinals take Game 1 of the NLDS against the Braves in a WILD 7 6 finish ,74,342,2240,2582,video
CompanyJ_9222,DK Metcalf outran everybody via NFL ,36,1547,12759,14306,video
CompanyJ_9223,Russ is the definition of a playmaker via NFL ,46,692,6198,6890,photo
CompanyJ_9224,Tedric Thompson with a miraculous INT via thecheckdown ,55,3793,30034,33827,video
CompanyJ_9225,Russell Wilson comes up huge for the Seahawks as they take down the Rams 30 29 in a thriller brgridiron ,104,973,7725,8698,photo
CompanyJ_9226,It was all Dodgers in Game 1 of the NLDS LA handles Washington 6 0 ,67,524,2513,3037,photo
CompanyJ_9227,Russ gives emotional tribute to late owner Paul Allen after big time win via NFLonFOX ,86,1020,7697,8717,video
CompanyJ_9228,Only right Kawhi got a special delivery from Leonard s via LAClippers ,70,2417,21660,24077,video
CompanyJ_9229,The highest in the room live in the air trvisXX ,48,16862,55703,72565,video
CompanyJ_9230,What Russ and PG laughing about ,32,1312,14055,15367,video
CompanyJ_9231,Lefty righty lefty righty All money via dubs_training ,54,3277,22080,25357,video
CompanyJ_9232,Only eight years old with quick feet like that via dflashiiiv IG ,65,6662,44319,50981,video
CompanyJ_9233,He s the top 2020 QB prospect behind Tua but he almost quit football after his father took his own life Instead Jordan Love found that the game was his sanctuary and a way to honor his father The pride he would have had I can feel it ,234,489,2175,2664,photo
CompanyJ_9234,Ben Simmons not worried ,24,407,4279,4686,photo
CompanyJ_9235,Big Papi is back on set back with my boys via MLBONFOX ,55,1269,7945,9214,video
CompanyJ_9236,Harden and Russ celebrations about to be undefeated this season ,64,1042,8698,9740,video
CompanyJ_9237,Harden is warming up his one leg move for the regular season ,61,1399,11079,12478,video
CompanyJ_9238,Hornets gifted JColeNC with a custom jersey via hornets ,56,2020,12786,14806,video
CompanyJ_9239,Like the mustache the legend of Gardner Minshew is only growing brgridiron ,75,506,5808,6314,video
CompanyJ_9240,LaMelo Ball got scouts rethinking the best player in the 2020 class br_betting ,79,791,5524,6315,photo
CompanyJ_9241,Quavo might ve had the most ice for a first pitch in MLB history via Braves ,76,1185,9515,10700,video
CompanyJ_9242,Alabama s DeVonta Smith gives the Crimson Tide the most dangerous wide receiver trio in the nation SoutheastToyota ,115,111,811,922,video
CompanyJ_9243,Jimmy Butler to all the students waiting outside for him There s no way all of y all out of f king class GO TO SCHOOL NSFW via sjzip1 IG ,137,9735,58229,67964,video
CompanyJ_9244,The Rock is back to laying the SmackDown via WWE ,49,6240,25080,31320,video
CompanyJ_9245,Jimmy Butler setting the tone early NSFW via MiamiHEAT ,55,3657,27255,30912,video
CompanyJ_9246,Falling down Defender on top of him Still flipped it top shelf in the corner Contender for goal of the year and the NHL season just started via NHL ,148,399,2528,2927,video
CompanyJ_9247,Gleyber Torres doubles Yankees take the lead in the Bronx ,58,226,1561,1787,video
CompanyJ_9248,CAIN VELASQUEZ ON WWE Former UFC Champ attacks Brock Lesnar on SmackDown via WWE ,81,2644,10624,13268,video
CompanyJ_9249,Clayton Kershaw with the smoothest defensive play of the postseason so far ,75,1375,11875,13250,video
CompanyJ_9250,Max Muncy brings the Dodgers within one run with a solo shot ,61,165,1659,1824,video
CompanyJ_9251,Tuesday Spurs 2 7 Bayern Saturday Brighton 3 0 Spurs Tottenham aggregate this week 2 10 brfootball ,99,360,2128,2488,photo
CompanyJ_9252,Snoop Dogg performed at Kansas and had everybody bumping the classics Via RandyWithersKC ,89,3769,22220,25989,video
CompanyJ_9253,Eden Hazard lobs it in for his first goal in Real Madrid threads brfootball ,76,471,4761,5232,photo
CompanyJ_9254,Close call Streak stays alive brfootball ,41,151,802,953,photo
CompanyJ_9255,Playing in Brooklyn is bigger than basketball for Kyrie Nothing like playing close to home ,91,964,7930,8894,video
CompanyJ_9256,Wisconsin has scored on every opening drive this year Every result Jonathan Taylor rushing TD ,94,353,4801,5154,photo
CompanyJ_9257,Punch celebrations continue to be a thing this season via BigTenNetwork ,72,209,1493,1702,video
CompanyJ_9258,Jonathan Taylor continues to make his case for the Heisman 17 carries for 126 yards 3 rushing TDs 1 receiving TD This is all in the 1st half ,141,422,3585,4007,photo
CompanyJ_9259,Make that 5 TDs and counting for Jonathan Taylor He s now passed Melvin Gordon for 3rd on the all time Badgers rushing list via BigTenNetwork ,142,371,3084,3455,video
CompanyJ_9260,Sooners went from 1st amp Goal from the 7 to 3rd amp Goal from the 48 YIKES via KU_Football ,92,249,2189,2438,video
CompanyJ_9261,Nobody Michigan football via CFBONFOX ,38,4917,28258,33175,video
CompanyJ_9262,Jonathan Taylor s Heisman stock continues to rise 19 carries for 186 yards 5 TDs total Passed Melvin Gordon for 3rd on all time Wisconsin rushing list Wisconsin beats Kent State 48 0 ,183,426,2940,3366,video
CompanyJ_9263,Kid was in absolute disbelief watching Simmons drain 3s via NBCSPhilly ,71,3519,25560,29079,video
CompanyJ_9264,Auburn and Florida already getting after it via GridironStuds ,62,3647,19284,22931,video
CompanyJ_9265, Say goodbye Freddie Florida opens the game with a perfect strike via CBSSports ,80,545,3694,4239,video
CompanyJ_9266,DERRICK BROWN IS ON THE LOOSE via CBSSports ,44,529,4062,4591,video
CompanyJ_9267,Coach O brought LSU superfan Colton Moore up to the podium after the win via SECNetwork ,88,235,2193,2428,video
CompanyJ_9268,No explanation needed via CBSSports ,36,162,1526,1688,video
CompanyJ_9269,DIDI GREGORIUS R L A A N M D via MLBONFOX ,42,1270,5760,7030,video
CompanyJ_9270,Lamical Perine just TOOK OFF via CBSSports ,43,902,4141,5043,video
CompanyJ_9271,ONE HAND GIMME THAT ,20,2746,12649,15395,video
CompanyJ_9272,Zo to Zion via PelicansNBA ,27,2961,20181,23142,video
CompanyJ_9273,Florida iced the game on a 88 yard TD from Lamical Perine Too cold From B R X CoorsLight ,89,329,1841,2170,video
CompanyJ_9274,LeBron AD First of many buckets from that duo ,46,5057,32161,37218,video
CompanyJ_9275,Steph still gotta get used to the Chase Center ,47,648,5758,6406,video
CompanyJ_9276,AD goes back to back to back Lakers not messing around ,55,7134,38206,45340,video
CompanyJ_9277,Anthony Davis is a problem ,27,2739,17273,20012,video
CompanyJ_9278,One game into the AD era in LA things are going well ,53,810,7379,8189,photo
CompanyJ_9279,The crowd in NOLA got Zion to start singing his heart out via WillGuillory ,75,749,5715,6464,video
CompanyJ_9280,Gennady Golovkin beats Sergiy Derevyanchenko by unanimous decision Win No 40 for GGG via DAZN_USA ,98,363,1548,1911,video
CompanyJ_9281, stylebender with the best walk out in UFC history via ufc ,59,895,3151,4046,video
CompanyJ_9282,LeBron amp AD are ready to take the league by storm via KingJames ,66,2346,15225,17571,photo
CompanyJ_9283,AND NEW Israel Adesanya knocks out Robert Whittaker to become the new UFC middleweight champion via ufc ,104,4088,15568,19656,video
CompanyJ_9284,LaMelo didn t have to do him like that TWICE via NBL ,53,15850,62621,78471,video
CompanyJ_9285,Mack Attack faces Oakland for the first time since getting traded today brgridiron ,83,334,2561,2895,video
CompanyJ_9286,8 goals in 8 Premier League games for Chelsea s Tammy Abraham brfootball ,73,432,2658,3090,photo
CompanyJ_9287,The risk you take running on the field via oregonfootball GoDucks ,66,1954,13681,15635,video
CompanyJ_9288,Rookie DK Metcalf brought his mom to tears with a new car on her birthday Respect brgridiron ,93,2643,28117,30760,video
CompanyJ_9289,On this day in 1993 30 year old Michael Jordan retired from the NBA off the back of a three peat with the Bulls I don t have anything else to prove He would sign a minor league contract with the Chicago White Sox just 4 months later ,233,911,6007,6918,photo
CompanyJ_9290, We share the same name but he has his own path Bronny turns 15 today brhoops ,78,2540,16484,19024,video
CompanyJ_9291, You change the way I walk the way I talk the way I play The way I do everything Jags LB Josh Allen s letter to his baby son From B R x mbyMstrahan JCPenney ,157,149,969,1118,video
CompanyJ_9292,Golden Tate with the Bron Wade alley cleats for his Giants debut brkicks ,73,1431,9327,10758,photo
CompanyJ_9293,The reigning champions stumble again brfootball ,48,90,846,936,photo
CompanyJ_9294, Your Fantasy Fire Drill starts now TheMattCamp is answering your pressing questions dropping sleepers and providing injury updates RIGHT NOW FantasyFireDrill ,159,9,62,71,link
CompanyJ_9295,Double bicycle kick via thaileague ,35,379,2682,3061,video
CompanyJ_9296,Ref had to play it cool br_betting via justinfrank__ IG ,56,1149,10881,12030,video
CompanyJ_9297,CHRISTIAN MCCAFFREY CLEARED FOR TAKEOFF via NFL ,48,522,3491,4013,link
CompanyJ_9298,Steven Sims made the whole Patriots defense miss on his way to six First time New England has trailed all season via NFL ,121,758,4713,5471,photo
CompanyJ_9299,Lamar helped them back up What a guy via CBSSports ,51,4161,39692,43853,video
CompanyJ_9300,CMC just playing a different game out there today via NFLonCBS ,63,305,2309,2614,photo
CompanyJ_9301,Pro tip don t give Deshaun this much time to throw via NFL ,59,447,4272,4719,video
CompanyJ_9302,Brees not playing but he still brings that fire pregame via Saints ,67,2608,16684,19292,video
CompanyJ_9303,Nobody had a chance at beating Khalil Mack to the loose ball via NFL ,69,172,1894,2066,photo
CompanyJ_9304,O U C H via thecheckdown ,25,5034,30233,35267,video
CompanyJ_9305,Steelers QB Mason Rudolph helped off the field after taking a hit to the head vs Ravens Teammates including JuJu were very emotional Hoping he s alright ,153,952,7116,8068,photo
CompanyJ_9306,More history for Brady TB moves past Favre into the top three ever brgridiron ,78,731,3743,4474,photo
CompanyJ_9307,Lamar Jackson has em on skates via thecheckdown ,48,895,7937,8832,video
CompanyJ_9308,CMC today 237 yards 3 TDs Borderline unfair via Panthers ,57,3021,20381,23402,video
CompanyJ_9309,Luis Suarez is unreal ,22,173,1375,1548,photo
CompanyJ_9310,The wheels on Kyler Murray Set Arizona up for the game winning FG in his first win via thecheckdown ,100,424,6134,6558,video
CompanyJ_9311,Christian McCaffrey put on a SHOW today 25 touches 237 total yards 3 total TD W Cheat code brgridiron ,102,1229,8006,9235,photo
CompanyJ_9312,MESSI BACK Unbelievable free kick for his first goal of the season ,67,398,2659,3057,photo
CompanyJ_9313,Rodgers Ridiculous via NFL ,27,1478,9047,10525,video
CompanyJ_9314,CARLOS VELA IS UNSTOPPABLE via MLS ,35,480,2171,2651,video
CompanyJ_9315, I m 56 years old that s the most fun I ve ever had Jon Gruden broke out the dance moves and made his own Club Dub after beating the Bears via Raiders ,151,1218,9115,10333,video
CompanyJ_9316,Deshaun Watson gives another in dept explanation of the Falcons defense after putting up 53 on them via HoustonTexans ,118,917,5756,6673,video
CompanyJ_9317,22 years 815 appearances TimHowardGK has officially played his final game brfootball ,85,1967,13776,15743,photo
CompanyJ_9318,Hakim Laws the unlike Agholor fan was at the Eagles game with tickets from the Philly WR Only right he s taking pics with people and their babies via JClarkNBCS ,161,805,6390,7195,video
CompanyJ_9319,AMARI COOPER That was tough via dallascowboys ,46,2320,14078,16398,video
CompanyJ_9320,Rockets ownership has debated replacing GM Daryl Morey amid backlash from Morey s Stand with Hong Kong tweet per JohnGonzalez ,126,288,1162,1450,photo
CompanyJ_9321,Cowboys fans getting their hopes up after starting 3 0 brgridiron ,66,17083,60693,77776,photo
CompanyJ_9322,Boston gives Tacko Fall a standing O in his preseason debut Already a legend at TD Garden ,90,1885,13261,15146,video
CompanyJ_9323,Mahomes Ridiculous via NFL ,27,4886,29574,34460,video
CompanyJ_9324,The Dodgers just scored SEVEN RUNS in the 6th inning ,53,1225,7320,8545,video
CompanyJ_9325,Stefon Diggs winked at the camera after saying he wants to be in Minnesota via Andrew_Krammer ,94,455,4521,4976,video
CompanyJ_9326,Redskins fire head coach Jay Gruden per DanGrazianoESPN ,56,1181,4313,5494,photo
CompanyJ_9327,Kyle Lowry and Raptors agree on a one year 31M extension per wojespn Lowry won t be a free agent until July 2021 ,113,725,7380,8105,photo
CompanyJ_9328,Kid s an ELITE flopper via action_jaxin ,40,2345,13987,16332,video
CompanyJ_9329,After Sunday is Patrick Mahomes still your favorite for MVP dunkindonuts ,73,146,1241,1387,status
CompanyJ_9330,Redskins owner Dan Snyder and president Bruce Allen called Jay Gruden to the facility at 5 a m to fire him per Lescarpenter ,124,1007,5075,6082,photo
CompanyJ_9331,Simone Biles double double dismount is now known as the Biles Only 22 years old and already has FOUR total moves named after her via NBCOlympics ,145,1338,9068,10406,photo
CompanyJ_9332, From here on out I d like to be referred to as Red Velvet Time to put some respect on KevinHuerter s smooth game ,114,1076,5069,6145,video
CompanyJ_9333,Sharing the court with your idols like LeBron and Kobe can be kind of surreal Tatum Kuz and other NBA stars explain the stress and joy of playing with and against their favorite players ,186,198,1824,2022,photo
CompanyJ_9334,The shot the hit the hug Photographer shelleylipton snapped this Lamar stiff arm right before he accidentally knocked into her brgridiron ,138,1697,12098,13795,photo
CompanyJ_9335,Eli making dreams come true QB gave the jersey off his back via Giants ,71,1988,22532,24520,video
CompanyJ_9336,Kyrie balling with Kobe at the MambaSportsHQ ,45,3019,14371,17390,video
CompanyJ_9337,This Shaq Dame battle ,22,1211,8425,9636,photo
CompanyJ_9338,LaMelo s serious about going No 1 Defensive slides in the sand on his day off in Australia brhoops via chomicide ,113,3100,25923,29023,video
CompanyJ_9339,Any Chiefs WR getting targets is worth an add Time to scoop up Byron Pringle dunkindonuts ,90,93,1209,1302,video
CompanyJ_9340, SteveNash and swish41 went for 56 headers brfootball ,54,344,2883,3227,video
CompanyJ_9341, He was catching unlike Agholor Hakim Laws went viral after he saved a family from a fire Then Nelson Agholor brought the Philly legend to the Eagles Jets game Respect brgridiron ,179,340,2695,3035,video
CompanyJ_9342,CARDINALS WALK OFF St Louis ties their NLDS series at 2 2 ,58,449,2783,3232,video
CompanyJ_9343,ZION HAS ARRIVED ,17,20590,79781,100371,video
CompanyJ_9344,Lonzo defense Zion dunk ,24,3806,21047,24853,video
CompanyJ_9345,Lonzo comes out firing for the Pelicans 3 ,42,1183,9460,10643,video
CompanyJ_9346,Trae just nutmegged JJ in preseason Disrespect ,47,7784,43466,51250,video
CompanyJ_9347,Matt Breida ran over 22 MPH on this 83 yard TD run via NFL ,59,1578,9438,11016,photo
CompanyJ_9348,Streetball Marcus Morris got ejected for purposely hitting Justin Anderson in the head with the ball ,101,20026,92684,112710,video
CompanyJ_9349,Okay Markelle ,14,2314,18185,20499,video
CompanyJ_9350,Trae accidentally hit Zion in the face Welcome to the NBA ,58,430,5166,5596,video
CompanyJ_9351,42 year old Vince Carter dishing no look passes to 20 year old Cam Reddish ,75,4334,35512,39846,video
CompanyJ_9352,Baker Mayfield planted the Oklahoma flag in Ohio State s field two years ago OSU s Nick Bosa waved and planted a flag after hitting Baker tonight Waited for his revenge via thecheckdown ,186,10882,68786,79668,video
CompanyJ_9353,Zion already lighting up the league ,36,2951,20188,23139,video
CompanyJ_9354,wyd OBJ via NFL ,16,2787,23301,26088,photo
CompanyJ_9355,Gucci Garoppolo amp the Niners move to 4 0 brgridiron ,54,2942,17423,20365,photo
CompanyJ_9356,YANKEES MOVE ON TO THE ALCS 5 1 win 3 0 series sweep ,53,2754,10268,13022,photo
CompanyJ_9357,Harden with the casual nutmeg Brutal ,37,1295,10454,11749,video
CompanyJ_9358,Only two quarterbacks in the league remain undefeated Wasn t long ago they were in the same QB room ,100,3577,29027,32604,photo
CompanyJ_9359,Nick Bosa was chirping Baker all game He had it coming via KNBR ,64,1582,11788,13370,video
CompanyJ_9360,Beard s moves are gonna be next level all season ,49,2815,18544,21359,video
CompanyJ_9361, When you come to New York you have the Statue of Liberty when you come to Sweden you have the Statue of Zlatan A statue of Ibra_official is unveiled in his hometown of Malmo ,175,689,4862,5551,photo
CompanyJ_9362,KD keeping it a buck about NY ,30,701,4663,5364,photo
CompanyJ_9363,The Spanish call of McCaffrey s hurdle touchdown is pure electricity via Panthers ,82,12947,61445,74392,video
CompanyJ_9364,The Deshaun Watson Foundation has officially launched It will support education health housing and other charitable causes to support families and youth in underserved communities ,180,1519,8895,10414,photo
CompanyJ_9365,When NBA players have questions at 4 a m about everything from extortion to health insurance they go to one person Meet Momma Chin the mother figure behind the whole NBA ,170,306,2754,3060,photo
CompanyJ_9366,Clocked in balled out via st lukesmith IG ,42,4721,33361,38082,video
CompanyJ_9367,KD was busy this morning ,25,3871,28359,32230,photo
CompanyJ_9368, Simone_Biles keeps making history ,35,968,5179,6147,photo
CompanyJ_9369,A whole team though brgridiron ,31,2039,13988,16027,photo
CompanyJ_9370, SHAQ embracing his hairline ,29,914,7466,8380,video
CompanyJ_9371,Knicks coming for everybody s heads this year ,46,691,5323,6014,video
CompanyJ_9372,Matthew Stafford realizes the Lions have been a comedy not a tragedy New GridironHeights x Joker Playstation ,109,2974,13229,16203,video
CompanyJ_9373,BEN SIMMONS HIT A 3PT ,22,21974,84122,106096,video
CompanyJ_9374,Some of the most iconic moments in NBA history ,47,10926,57694,68620,photo
CompanyJ_9375,Terrance Ferguson OH MY via NBA ,32,930,7221,8151,video
CompanyJ_9376,All of Philly when Ben Simmons hit a 3 ,39,15865,67793,83658,video
CompanyJ_9377,Game 4 is coming down to the wire via WNBA ,43,111,1309,1420,video
CompanyJ_9378,THIS GAME via WNBA ,19,286,2261,2547,video
CompanyJ_9379,COURTNEY WILLIAMS AND THE SUN FORCE GAME 5 Connecticut takes down Washington 90 86 to set up winner take all series finale ,123,180,1422,1602,photo
CompanyJ_9380,OJ Howard out here barehanding foul balls at the Rays Astros game via MLBONFOX ,79,672,6953,7625,video
CompanyJ_9381,MPJ checks in and immediately gets a bucket via NBA ,52,2335,23351,25686,video
CompanyJ_9382,Ben Simmons special 3PT celebration in 2K via shady_00018 ,58,5598,34496,40094,video
CompanyJ_9383,Messi admits for the first time that he almost left Barcelona brfootball ,73,153,1791,1944,photo
CompanyJ_9384,NFL fans were talking so much trash about the Raiders until rookie JohnathanAbram1 surprised them and put them on blast StateFarm New Ditch the Playbook with AdamLefkoe ,169,781,3511,4292,video
CompanyJ_9385,David Montgomery can t count how many houses he s lived in His upbringing created a toughness that s already drawing Walter Payton comparisons There aren t many people you see across the league who are doing stuff like that ,224,171,1296,1467,photo
CompanyJ_9386,OBJ was too busy dancing brgridiron via JZFish ,47,1568,12880,14448,video
CompanyJ_9387,Baby on Babies with DaBabyDaBaby Not all NBA stars look identical to their baby pics ,85,1200,5822,7022,video
CompanyJ_9388,Deshaun Watson s childhood home was funded by Falcons RB Warrick Dunn He was a Falcons ball boy at 14 On Sunday he put up career numbers vs the Falcons Then he officially launched a foundation to help families like his Legend brgridiron ,237,4577,34786,39363,photo
CompanyJ_9389, Have passion Be determined Be this team This kid s speech via coach_crich ,75,1976,10496,12472,video
CompanyJ_9390, Choose your character BRGaming via PelicansNBA ,48,1552,13951,15503,video
CompanyJ_9391,She smoked EVERYBODY on that field via fabe_seg IG ,51,4328,32205,36533,video
CompanyJ_9392,Ben made his first three and the whole internet wasn t ready ,61,5151,25278,30429,video
CompanyJ_9393, It can t be described when a little kid comes up and says he wears a certain shoe because of you Zion talks Jordan Brand on Unboxed with brkicks ,146,229,1950,2179,video
CompanyJ_9394,Time to bring him in Braves ,28,2310,16980,19290,photo
CompanyJ_9395,Rihanna is Team Kap ,20,1389,9706,11095,photo
CompanyJ_9396,KP is officially back ,22,3214,30738,33952,video
CompanyJ_9397,Trae Young cross Dirty ,23,1847,14632,16479,video
CompanyJ_9398,Zach LaVine already in dunk contest form via NBCSBulls ,55,621,5412,6033,video
CompanyJ_9399,Luka got nice with it ,22,2313,20901,23214,video
CompanyJ_9400,Giannis first dunk of the game ,31,865,7553,8418,video
CompanyJ_9401,Zo and Zion in transition via NBATV ,36,6078,44192,50270,video
CompanyJ_9402,Trae Young s vision ,20,441,4091,4532,video
CompanyJ_9403,Giannis windmill ,17,1773,15163,16936,video
CompanyJ_9404,Zion s first step and finish Ridiculous via NBATV ,50,5798,44483,50281,video
CompanyJ_9405,BACK TO BACK ON KERSHAW TIE GAME ,33,1698,9902,11600,video
CompanyJ_9406,HOWIE KENDRICK GRAND SLAM ,26,1028,6493,7521,photo
CompanyJ_9407,NATS HIT A GRAND SLAM IN THE 10TH via MLB ,42,3545,16717,20262,video
CompanyJ_9408,Nationals heading to NLCS Howie Kendrick s 10th inning grand slam seals Game 5 win over Dodgers ,96,1429,6544,7973,photo
CompanyJ_9409,Dwight Howard literally jumped out of his pants on the pregame dunk via rachel__nichols ,88,4788,43587,48375,video
CompanyJ_9410,Dodgers fans were offering drivers the chance to run over Kershaw s jersey via LZGranderson ,92,1060,5459,6519,video
CompanyJ_9411,JaVale almost went Showtime ,28,219,3207,3426,video
CompanyJ_9412,Women have been banned from stadiums in Iran since 1979 Today 3 500 women were allowed in to Azadi Stadium to watch Iran s friendly vs Cambodia via maryampapi1 ,160,1683,11174,12857,video
CompanyJ_9413,Minshew Chark Time to go all in on the Jags passing attack YahooFantasy ,72,50,688,738,video
CompanyJ_9414,Pat Bev s journey is unlike any other Slept in a car with his mom Grew up without a father Cousin shot dead at 16 Scouts said he was too small Had to leave college to play in Europe Now has 40M contract and a real shot at a ring ,229,4815,29521,34336,photo
CompanyJ_9415,This Dodgers fan was so fed up he flung his Kershaw jersey onto the field via _thehoopgod saljmenez IG ,103,3988,24246,28234,video
CompanyJ_9416,Simone Biles list of accomplishments is already unbelievable ,61,519,2791,3310,photo
CompanyJ_9417,Mamba dropping knowledge to Kyrie Jamal Murray IT Jordan Clarkson and the future of hoops via MambaSportsHQ ,108,1752,9631,11383,video
CompanyJ_9418,Raiders safety JohnathanAbram1 is still getting roasted for how he pronounces salmon StateFarm Hard Knocks Training Camp with the Oakland Raiders is Streaming on HBO ,166,168,1114,1282,video
CompanyJ_9419, MattressMack is back with another bet He s now at upward of 8M total on the Astros br_betting ,95,115,778,893,photo
CompanyJ_9420,Robert Kraft still isn t ruling out a Gronk return brgridiron ,62,179,1338,1517,photo
CompanyJ_9421,TB12 passes Peyton Manning for second on the NFL s all time passing list brgridiron ,84,561,3514,4075,photo
CompanyJ_9422,Tom Brady PICKED via NFL ,25,1283,12624,13907,photo
CompanyJ_9423,He kicked it into the back of his helmet Pats with the easy score via thecheckdown ,83,708,7256,7964,video
CompanyJ_9424,Golden Tate slowed down and took his sweet time on this celebration via NFLonFOX ,81,732,7252,7984,photo
CompanyJ_9425,Giants defense SWARMED Brady for the scoop and score via NFLonFOX ,66,911,6019,6930,photo
CompanyJ_9426,Washington Mystics win their first WNBA title ,46,3365,11555,14920,photo
CompanyJ_9427,Elena Delle Donne battled through this season and came out with her first title Herniated disk Broken nose Bone bruise in knee The WNBA MVP was also the first player to go 50 40 90 ,181,2940,13466,16406,photo
CompanyJ_9428,Houston Astros advance to 3rd consecutive ALCS Astros handle the Rays 6 1 in Game 5 ,84,1083,3752,4835,photo
CompanyJ_9429,Daniel Jones picks up 3 INTs against the Patriots in 35 14 loss brgridiron ,75,485,3589,4074,photo
CompanyJ_9430,Steph looking like he s already in midseason form Dropped 17 PTS in the 1Q ,75,1374,11123,12497,video
CompanyJ_9431,Can t guard Steph when he does this ,36,2263,20648,22911,video
CompanyJ_9432,Kawhi didn t miss a beat in his Clippers preseason debut ,57,1261,10161,11422,video
CompanyJ_9433,Twenty years ago today 45pedromartinez threw six no hit innings in relief to lead the Red Sox in Game 5 of the ALDS GOAT stuff Cop the Pedro Martinez World Tour collection NOW ,176,75,506,581,photo
CompanyJ_9434,Bronny x Zaire Just like their dads ,36,21252,99828,121080,photo
CompanyJ_9435,This animator takes every LeBron post on social and recreates a giraffe version on LeRaffeJames ,96,1616,11947,13563,video
CompanyJ_9436, JohnathanAbram1 had enough of this Dolphins fan s trash talk StateFarm ,72,71,418,489,video
CompanyJ_9437,Second MVP first championship De11eDonne sleeping on the doubters ,66,648,6326,6974,photo
CompanyJ_9438,Zaire and Bronny wanted to flex in the chain But they got help from 7 3 Harold Yu to complete the windmill via WhosNextHS h t br_hoops ,135,1056,9070,10126,video
CompanyJ_9439,Board Man ready for some fun in LA Via LAClippers ,50,307,2799,3106,video
CompanyJ_9440,One of the best rivalries in sports Oklahoma vs Texas Who ya got foxsports ,75,349,2585,2934,video
CompanyJ_9441,How d he even throw it that far like that via sanantoniossc ,60,2350,18031,20381,video
CompanyJ_9442,Samford player changed his name to honor stepdad who helped raise him since the 2nd grade via SamfordFootball thecheckdown ,123,16587,74256,90843,video
CompanyJ_9443,Lonzo knows his little brother s real potential ,48,2220,19944,22164,photo
CompanyJ_9444,That father son connection brhoops ,35,1876,15056,16932,video
CompanyJ_9445,Zion from long range ,21,2133,20696,22829,video
CompanyJ_9446,Jalen Hurts and Sam Ehlinger have been making plays for their team all season Can the Longhorns knock off the Sooners in their Red River showdown Wendys ,153,80,688,768,video
CompanyJ_9447,Zo hitting the step back 3 ,27,1401,11755,13156,video
CompanyJ_9448, via brfootball ,16,196,2331,2527,photo
CompanyJ_9449,Zion My goodness ,17,2999,26881,29880,video
CompanyJ_9450,Luka goes 3 straight from deep ,31,1363,9363,10726,video
CompanyJ_9451,Ryan Zimmerman went Superman ,29,490,4389,4879,video
CompanyJ_9452,Nationals pitching dominates Cardinals in NLCS Game 1 Aníbal Sánchez takes his no hitter into the 8th inning in Washington s 2 0 win ,133,196,1465,1661,photo
CompanyJ_9453,1 59 40 Eliud Kipchoge is the first person to run a marathon in UNDER TWO HOURS via olympicchannel ,99,12753,66181,78934,video
CompanyJ_9454,20 years ago today Wilt Chamberlain passed away at 63 years old He holds 72 total NBA records Arguably the most dominant player ever ,133,1637,10327,11964,photo
CompanyJ_9455,Headband Chalk toss Vintage KingJames via Lakers ,49,4486,27102,31588,video
CompanyJ_9456,Oklahoma vs Texas about to be a show ,37,763,5471,6234,photo
CompanyJ_9457,The reaction in Kenya as Eliud Kipchoge finished his 1 59 40 marathon Incredible via OlympicsKe ,96,1410,9563,10973,video
CompanyJ_9458,Ronaldo s first club Sporting CP are considering renaming their stadium after him when he retires per tuttosport brfootball ,124,318,2432,2750,photo
CompanyJ_9459,With a gold in vault Simone Biles is now tied for most ever world gymnastics championship medals 23 via NBCOlympics ,116,1668,8597,10265,photo
CompanyJ_9460,Red River Rivalry getting off to a hot start NSFW via Eddie_Rado ,65,4687,26108,30795,video
CompanyJ_9461,Hurts CeeDee Lamb Sooners punch first on 4th and goal via CFBONFOX ,67,283,2278,2561,video
CompanyJ_9462,Hurts is ridiculous via CFBONFOX ,33,962,7965,8927,video
CompanyJ_9463,Jonathan Taylor making a strong case for the Heisman ,53,287,2325,2612,photo
CompanyJ_9464, 57 yard run via CFBONFOX ,26,301,2157,2458,video
CompanyJ_9465,Hurts CeeDee Lamb flea flicker Unbelievable via CBSSportsHQ ,60,2443,12650,15093,link
CompanyJ_9466,Hurts behind the back on the move like it was 2K via CFBONFOX ,62,1000,5946,6946,video
CompanyJ_9467,CeeDee Lamb is special via CFBONFOX ,36,1243,6836,8079,video
CompanyJ_9468,HE MISSED Double OT coming up ,30,373,2516,2889,photo
CompanyJ_9469, No 3 Georgia UPSET South Carolina hands Bulldogs first loss of the season in double OT on the road ,100,3795,17939,21734,photo
CompanyJ_9470,No 6 Oklahoma holds off No 11 Texas to win the Red River Rivalry 34 27 CeeDee Lamb 10 catches 171 yards 3 TDs ,110,844,5280,6124,photo
CompanyJ_9471,Bobbled it midair and still came down with it for the TD via FOXSports ,71,122,1090,1212,video
CompanyJ_9472,South Carolina upset No 3 Georgia in Athens and no one was happier than QB Ryan Hilinski who honors his late brother Tyler by wearing the No 3 jersey ,150,975,9347,10322,photo
CompanyJ_9473,Tua picked off for the first time this season via CBSSports ,60,309,2666,2975,video
CompanyJ_9474,Death Valley at night Tigers vs Gators Buckle up ,49,287,1883,2170,video
CompanyJ_9475,Tua Ruggs Can t do anything about this via CBSSports ,53,354,2619,2973,video
CompanyJ_9476,HOW WAS HE STILL STANDING via ufc ,34,1340,6649,7989,video
CompanyJ_9477,Tua and Bama roll Texas A amp M 47 28 Tagovailoa 21 34 for 293 yards 4 TDs 1 INT ,81,185,1324,1509,video
CompanyJ_9478,Bless this Bama fan ,20,1875,17958,19833,video
CompanyJ_9479,This catch doesn t even make sense via CFBONFOX ,48,1365,8527,9892,video
CompanyJ_9480,CeeDee Lamb left the Texas defense frozen exxonmobil ,53,2491,13813,16304,video
CompanyJ_9481,Last Chance U alum Malik Henry out here throwing DIMES for Nevada ,66,5392,35265,40657,video
CompanyJ_9482,KJ Hamler UP HIGH for six via BigTenNetwork ,44,139,1126,1265,video
CompanyJ_9483,AARON JUDGE WOW via MLB ,24,2972,19052,22024,video
CompanyJ_9484,Gleyber Torres ALCS is starting off with a bang via MLB ,56,368,1825,2193,video
CompanyJ_9485,O M G UPKICK KO via ufc ,24,7607,31488,39095,video
CompanyJ_9486,22 Gleyber Torres is 22 via MLB ,32,1781,11564,13345,video
CompanyJ_9487,Jayden Daniels was cold blooded on this game winning TD run CoorsLight ,71,298,1821,2119,video
CompanyJ_9488,There s a real problem in Houston Yankees take down Astros 7 0 in Game 1 of ALCS ,81,820,4042,4862,photo
CompanyJ_9489,Joe Burrow and the undefeated Tigers were electric in their win over No 7 Florida 21 24 passing 336 total yards 3 TDs 0 INT ,124,1033,6244,7277,photo
CompanyJ_9490,Superstar QBs drafted two picks apart Who will have more fantasy points this season dunkindonuts ,97,204,2496,2700,status
CompanyJ_9491,One snap One INT Jameis turns it over on the first play of the game in London Via NFL ,86,391,4028,4419,photo
CompanyJ_9492,Most Decorated Ever After winning gold on the balance beam today Simone Biles is the most decorated gymnast male or female in world championships history with 24 medals ,169,10408,43891,54299,photo
CompanyJ_9493,Coco Gauff is the WTA Linz champion at 15 years old She s the youngest American woman to win a tour singles title since 1991 Venus and Serena were 17 for their first ,166,1368,4719,6087,video
CompanyJ_9494,Tyreek is back Chiefs WR will be active for the first time since Week 1 shoulder per RapSheet ,94,522,5576,6098,photo
CompanyJ_9495,NOBODY IS SAFE DEFENDING CHRISTIAN MCCAFFREY via thecheckdown ,62,3928,32933,36861,video
CompanyJ_9496,If you re playing against McCaffrey you re gonna need some help TheMattCamp is answering your pressing questions dropping sleepers and providing injury updates RIGHT NOW FantasyFireDrill ,187,11,101,112,link
CompanyJ_9497,Disaster in London for Jameis Four turnovers and six sacks early in the 3rd quarter Panthers lead 27 7 ,103,264,2084,2348,photo
CompanyJ_9498,Gerald McCoy and the Bucs mutually parted ways in May Bruce Arians said that McCoy is not as disruptive as he used to be Today McCoy balled out for the Panthers against his former team 2 5 sacks 4 QB hits 37 26 win brgridiron ,226,579,4381,4960,photo
CompanyJ_9499,Nick Chubb He good via Browns ,30,216,2192,2408,photo
CompanyJ_9500,THERE GOES LAMAR via Ravens ,28,589,4045,4634,video
CompanyJ_9501,Tyreek is back via Chiefs ,26,2357,12862,15219,video
CompanyJ_9502,Diggs had to look back at the defense after burning them via NFL ,65,713,6498,7211,photo
CompanyJ_9503,Stefon Diggs is about to be much happier in Minnesota Two TDs 135 yards via NFL ,80,861,7786,8647,photo
CompanyJ_9504,O B J M G via Browns ,21,915,5971,6886,photo
CompanyJ_9505,THE SEAHAWKS ARE NSYNC via thecheckdown ,40,1380,9582,10962,video
CompanyJ_9506,On this play Tyreek Hill Scored a TD Danced Did a backflip via Chiefs ,70,349,2484,2833,video
CompanyJ_9507,Stefon Diggs is on another level Toe tap gives him his THIRD TD of the day via Vikings ,87,264,1725,1989,video
CompanyJ_9508,Lamar s got a career high 155 yards on the ground He s 26 yards away from Colin Kaepernick s QB rushing record 181 ,115,704,5829,6533,photo
CompanyJ_9509,Only QBs to ever rush for 150 yards in a game in the Super Bowl era Mike Vick Colin Kaepernick Lamar joined that list today ,124,5917,27278,33195,photo
CompanyJ_9510,Historic game for Lj_era8 brgridiron ,37,838,4264,5102,photo
CompanyJ_9511,Hyde had to let KC know brgridiron ,35,316,2262,2578,photo
CompanyJ_9512,Zo found Zion for the oop from DEEP via NBA ,44,2883,22788,25671,video
CompanyJ_9513,Rams really lateraled it on the turnover via thecheckdown ,58,225,3454,3679,video
CompanyJ_9514,Broadway Sam gets the Jets their first win of the season 23 32 passing 338 yards 2 TD 1 INT New York beats Dallas 24 22 brgridiron ,131,1518,9416,10934,photo
CompanyJ_9515,Even LaVine s preseason dunks are wild ,39,533,3711,4244,video
CompanyJ_9516,ALL RISE ALCS via YESNetwork ,29,491,1887,2378,video
CompanyJ_9517,JuJu Philip Rivers Respect via steelers ,40,886,12236,13122,video
CompanyJ_9518, CARLOS CORREA SAID SEE YOU IN THE BRONX WALK OFF HOME RUN TO WIN GAME 2 via MLB ,81,8091,36166,44257,video
CompanyJ_9519,Carlos Correa called game ,26,1947,11766,13713,photo
CompanyJ_9520, I couldn t hear anything so I just kept calling plays Russell Wilson s helmet communication shut down at the beginning of a 3rd quarter drive but he kept going and the Seahawks scored ,185,737,8715,9452,photo
CompanyJ_9521,His own teammate had to tackle him when he went the wrong way via 4huncho4 IG ,78,4216,21751,25967,video
CompanyJ_9522,The and she knows it ,21,2266,12337,14603,photo
CompanyJ_9523,This Niners defense is scary No 1 in passing YPG No 1 in rushing TD tied No 2 in YPG No 2 in passer rating No 2 in 1st downs per game No 2 in PPG No 6 in rushing YPG thecheckdown ,179,7362,42478,49840,video
CompanyJ_9524,Cowboys fans waking up realizing Jason Garrett hasn t been fired brgridiron ,76,2773,13999,16772,video
CompanyJ_9525,PSG confirm Neymar will be out for four weeks with a thigh injury He only returned from his previous injury a month ago ,120,219,1658,1877,photo
CompanyJ_9526,Khabib is wired different UFC lightweight champ training in a freezing river in Dagestan Russia via kingfarruh IG ,114,9047,52556,61603,video
CompanyJ_9527,The control is unreal via SeFutbol ,35,713,5028,5741,video
CompanyJ_9528,CR 7 0 0 Cristiano Ronaldo becomes only the 6th player ever to score 700 career goals brfootball ,97,3785,16115,19900,video
CompanyJ_9529,Could Cam really get traded If Carolina sticks with undefeated starter Kyle Allen the market for Newton would be robust with as many as 10 teams interested an AFC GM told mikefreemanNFL ,186,701,4661,5362,photo
CompanyJ_9530,Expect a lot of drama in the Champions house this season New episode dropping next Monday brfootball ,101,403,1880,2283,video
CompanyJ_9531,They had Manu on the Simba Cam at the Spurs games via spurs ,60,511,6999,7510,video
CompanyJ_9532,Tyler Herro just scored the Heat s first 14 points and hit 3 straight threes ,77,7531,39561,47092,video
CompanyJ_9533,JA via memgrizz ,16,2540,18922,21462,video
CompanyJ_9534,LeBron comments on Daryl Morey s China tweet I believe he wasn t educated on the situation at hand and he spoke via BenGolliver ,128,1381,9100,10481,video
CompanyJ_9535,RODGERS DROPPED THAT IN via thecheckdown ,41,1771,13676,15447,video
CompanyJ_9536,This move by Ja Morant ,23,933,8653,9586,video
CompanyJ_9537,Nats are one win away from the World Series Washington wins Game 3 8 1 to go up 3 0 in the NLCS ,96,715,3191,3906,photo
CompanyJ_9538,Aaron Rodgers comes back to get it done Packers win 23 22 at Lambeau ,69,2166,13223,15389,video
CompanyJ_9539,Zach Norvell Jr had Jordan Poole on all fours and the Lakers bench went WILD ,77,3287,16774,20061,video
CompanyJ_9540,SHE SAID NIGHT NIGHT via courtneybowiee ,40,10204,55451,65655,video
CompanyJ_9541,AIR MEEK via MeekMill ,22,4815,27064,31879,video
CompanyJ_9542, The records come naturally Ronaldo after his 700th career goal via Esp_Interativo brfootball ,94,215,1781,1996,video
CompanyJ_9543,The love is real in Baltimore This fan got Lamar to sign his arm after the win on Sunday It s Tuesday and he s already got it tattooed brgridiron via 97_stevo IG ,162,662,6761,7423,photo
CompanyJ_9544,It s been a long road to success for Last Chance U s Malik Henry ,65,956,7063,8019,video
CompanyJ_9545,Handles had the defenders scrambling via juan nba3 Instagram ,61,1067,6518,7585,video
CompanyJ_9546,AL Cy Young favorite Gerrit Cole looks to seal his 19th straight win today but his Astros teammates are already thinking ahead to his free agency It s going to be interesting Hopefully he s out of our division ,210,45,590,635,photo
CompanyJ_9547,ONE WEEK ,9,4508,23202,27710,photo
CompanyJ_9548,Rams have traded CB Marcus Peters to the Ravens per RapSheet ,61,2978,12787,15765,photo
CompanyJ_9549,The RB committee tries to figure out how to get paid like WRs GridironHeights playstation ,90,2790,11421,14211,video
CompanyJ_9550,Russell Wilson this year No 1 in passer rating T No 1 in total TDs T No 1 in game winning drives No 2 in completion 0 interceptions Seahawks 5 1 Coming for that MVP brgridiron ,176,2964,20612,23576,photo
CompanyJ_9551,Best Fortnite update being able to play catch with downed players BRGaming via timthetatman ,92,451,4136,4587,video
CompanyJ_9552,Breaking Jaguars trade CB Jalen Ramsey to Rams for two first round picks and a fourth round pick per AdamSchefter ,114,6580,22034,28614,photo
CompanyJ_9553,Aaron Donald and Jalen Ramsey on the same defense Sheesh ,57,5160,28883,34043,photo
CompanyJ_9554,Los Angeles is the city of stars brgridiron ,44,3567,23081,26648,photo
CompanyJ_9555,Nationals put up SEVEN 7 runs in the first inning Washington is making a statement one win away from their first World Series ,126,717,3345,4062,video
CompanyJ_9556,Carsen Edwards hit eight 3PTs in the 3Q alone ,46,14201,69028,83229,video
CompanyJ_9557,New CB1 jalenramsey brgridiron ,31,531,5010,5541,photo
CompanyJ_9558, MELOD1P got KD s blessing brkicks ,35,808,7998,8806,photo
CompanyJ_9559, NATIONALS ARE GOING TO THE WORLD SERIES Sweep the Cardinals 4 0 Punch ticket to first WS in franchise history Celebrate with champagne ,136,2453,11735,14188,photo
CompanyJ_9560,That first World Series feeling ,32,3404,22622,26026,video
CompanyJ_9561,Howie Kendrick Traded to Washington Ruptured his Achilles in May 2018 Played 121 games in 2019 while hitting 344 Wins NLCS MVP as Nationals go to World Series ,159,877,6616,7493,photo
CompanyJ_9562,October 15th 11 59 p m Nationals celebrate going to first World Series October 16th 12 00 a m Bryce Harper s 28th birthday ,123,5342,29904,35246,photo
CompanyJ_9563,Leo Messi received his historic sixth Golden Shoe and his kids got to give it to him via FCBarcelona ,101,898,7624,8522,video
CompanyJ_9564,The Nationals on May 24 12 games under 500 The Nationals now ,61,341,3247,3588,photo
CompanyJ_9565,Jamaal Charles called his mom and then girlfriend to talk him out of fighting Larry Johnson after the vet hazed him as a rookie on the Chiefs New Untold Stories with MasterTes ,176,699,4083,4782,video
CompanyJ_9566,15 years ago today 17 year old Leo Messi made his debut for Barcelona The rest is history brfootball ,101,732,4371,5103,photo
CompanyJ_9567,Did Kawhi lose or was he done winning in rock paper scissors via __delia_ Instagram ,84,161,2409,2570,video
CompanyJ_9568,Happy birthday to one of the greatest WNBA point guards of all time S10Bird 3x WNBA champ 11x All Star WNBA all time assist leader 2x NCAA champ 4 Olympic gold medals ,167,320,2037,2357,photo
CompanyJ_9569,Saquon is looking ready to play Sunday About to get scary in NY brgridiron ,75,318,2684,3002,photo
CompanyJ_9570,Oladipo Brogdon and the Pacers front office are slowly but surely building a contender Hopefully we get one or two of those guys who really pop ,144,177,1223,1400,photo
CompanyJ_9571,Top 5 2020 recruit Jalen Green showed out at USA Basketball Men s Junior National Team minicamp brhoops jalenromande ,117,190,1300,1490,video
CompanyJ_9572,Former Bucs and Falcons RB Warrick Dunn helped a single mom in Florida get a fully furnished home through Habitat for Humanity It s the 173rd home Dunn has worked on for a family in need via mo_unique_ ,202,2609,12886,15495,photo
CompanyJ_9573, brkicks ,9,470,3339,3809,photo
CompanyJ_9574,Pouring rain didn t stop practice via Inter_en ,47,542,5250,5792,video
CompanyJ_9575,51 years ago today Tommie Smith and John Carlos raised their fists at the 1968 Olympics to protest racial injustice ,116,3308,14487,17795,photo
CompanyJ_9576,Myles Garrett says a fan jumped out of his car to take a picture with him and then sucker punched him in the face ,114,2071,17950,20021,photo
CompanyJ_9577,15 years of Messi magic via brfootball ,39,1203,5578,6781,video
CompanyJ_9578, sergeibaka s cooking show How Hungry Are You is coming to B R SamsungMobileUS The premiere drops Mon 10 21 with one of Serge s former teammates ,145,134,801,935,video
CompanyJ_9579,Ben s still working on it ,26,193,3092,3285,photo
CompanyJ_9580, Jericho Hager Guevara Santana Ortiz Last week IAmJericho started wrestling s hottest team The Inner Circle and they re ready to shake things up on AEWrestling ,160,104,628,732,video
CompanyJ_9581,KD is the of Twitter beef and he proved it this offseason ,58,223,1870,2093,video
CompanyJ_9582,16 years ago today Aaron Boone cemented himself as a Yankees legend with a walk off HR vs the Red Sox in Game 7 of the ALCS ,124,386,2114,2500,photo
CompanyJ_9583,Boxer Patrick Day has died at age 27 after brain surgery following knockout loss on October 12 ,95,2850,10212,13062,photo
CompanyJ_9584,Trae Young reverse to end the 1Q via NBA ,41,1125,11135,12260,video
CompanyJ_9585,VINCE PUTTING ON A SHOW AT THE GARDEN via NBA ,46,1763,15883,17646,video
CompanyJ_9586,Dejounte Murray showing how to lock up Harden ,46,6989,41896,48885,video
CompanyJ_9587,The Inner Circle reigns supreme BRWrestling AEWDynamite via AEWrestling ,72,96,605,701,video
CompanyJ_9588,Trae Young before the buzzer Ridiculous via NBA ,48,1119,9887,11006,video
CompanyJ_9589,Vinsanity CLUTCH via NBA ,25,852,8788,9640,video
CompanyJ_9590,AD shows off his handles and finds Caruso via NBATV ,52,2999,25338,28337,video
CompanyJ_9591,D Lo nutmegged Dwight via warriors ,35,568,6027,6595,video
CompanyJ_9592,Bron found Dwight mid air via Lakers ,37,4051,29726,33777,video
CompanyJ_9593,This Bron no look pass was absurd via NBATV ,44,12234,60839,73073,video
CompanyJ_9594, MikeTyson still got it at 53 years old ,40,2578,14516,17094,video
CompanyJ_9595,Wizards and Bradley Beal agree to 2 year 72M max extension per wojespn The total value of the SG s deal is now 4 years 130M ,124,1238,8233,9471,photo
CompanyJ_9596,Alvin Kamara is a MACHINE Doing this with glasses that block his vision via doctor_reef ,88,822,8049,8871,video
CompanyJ_9597,Year 17 Not normal via Lakers ,30,9613,61738,71351,video
CompanyJ_9598,ANKLES via shoffman_14 WSUCougarSoccer ,39,6595,38215,44810,video
CompanyJ_9599,Buddy Hield says he sees the Kings four year 90M offer like an insult and is ready to find another home if they can t get a deal done by Monday I feel like I m worth more than that If you say I m your guy I just need you to show it via JandersonSacBee ,252,1528,8756,10284,photo
CompanyJ_9600,The 2019 20 GM Survey has been released by the NBA Favorite to win it all Clippers Most likely to win MVP Giannis back to back ,127,378,3240,3618,photo
CompanyJ_9601,JaVale is a mastermind for this ,32,4747,19697,24444,video
CompanyJ_9602,Odell says he d consider pulling a Deion Sanders and play a second pro sport in the event of an NFL lockout There s not much that I wasn t just naturally good at via PatMcManamon ,179,665,5949,6614,photo
CompanyJ_9603,Deshaun Watson calls himself the best QB in the game and says he s going to play until he can t walk Inside the mind of a football genius ,138,492,3373,3865,photo
CompanyJ_9604,Darnold gave the Jets life last week but New England is a different beast Time to sit Le Veon in fantasy dunkindonuts ,118,60,904,964,video
CompanyJ_9605,On this day in 2015 Michigan had trouble with the snap via MichiganStOnBTN ,75,1041,6540,7581,video
CompanyJ_9606, Champion talk KyrieIrving and CocoGauff met and he only had gems for the young phenom ,87,325,2296,2621,video
CompanyJ_9607,Luol Deng has retired from the NBA after 15 seasons Deng signed a contract with Chicago to retire as a Bull ,108,2412,18834,21246,photo
CompanyJ_9608,Adam Silver on Daryl Morey We were being asked to fire him by the Chinese government We said there s no chance that s happening There s no chance we ll even discipline him via TIME ,181,5881,30525,36406,photo
CompanyJ_9609,New superteam going to form ,28,781,6487,7268,photo
CompanyJ_9610,New season new looks ,21,985,6137,7122,video
CompanyJ_9611,Larry Fitz had to school the rook on Julio s greatness 11 dog You re gonna see some s t today via NFLFilms ,107,7168,47457,54625,video
CompanyJ_9612,Mahomes under pressure Money He becomes the fastest player ever to reach 7 500 career passing yards 24 games via thecheckdown ,126,773,7284,8057,video
CompanyJ_9613,Tyler Herro and MCW were going at each other ,45,6263,42648,48911,video
CompanyJ_9614,Broncos players showed support to Mahomes before he got helped off the field Respect via thecheckdown ,102,2561,27566,30127,video
CompanyJ_9615, His ass should have got thrown out Jimmy Butler on Tyler Herro s incident with MCW ,84,3043,20419,23462,video
CompanyJ_9616,Patrick Mahomes suffered a kneecap dislocation there was no break MRI will reveal if there s any ligament damage per JamesPalmerTV ,131,802,4233,5035,photo
CompanyJ_9617,Mahomes says he s good brgridiron ,34,1034,11063,12097,photo
CompanyJ_9618,Porzingis dominating everywhere ,32,2632,19712,22344,video
CompanyJ_9619,Luka put the moves on Kawhi ,28,1730,14116,15846,video
CompanyJ_9620,Nothing but respect for CC as he walks off the mound to a standing ovation after an apparent injury via MLBONFOX ,113,1106,7309,8415,video
CompanyJ_9621,Luka and Terance Mann had to get separated ,43,1359,12099,13458,video
CompanyJ_9622,Kawhi gets it done on both ends and PG is lovin it ,51,872,10046,10918,video
CompanyJ_9623, Astros inch closer to the World Series with 8 3 win over Yankees in Game 4 now lead series 3 1 ,96,1170,4930,6100,photo
CompanyJ_9624,Giannis on the court Drogba on the field burnaboy dissects the plays of famous African stars ,93,485,1653,2138,video
CompanyJ_9625,Zion Williamson is expected to miss a couple weeks to start the season due to knee injury no shortage of confidence he will be fully recovered per wojespn ,155,952,5515,6467,photo
CompanyJ_9626,Vince Carter s 22nd and final season will be an NBA record What a ride Vinsanity s career has been ,99,9274,33018,42292,video
CompanyJ_9627,Knee injuries can t hold back this type of talent Get well soon ,64,3730,31868,35598,photo
CompanyJ_9628,They were really playing basketball indoors on donkeys via Hayden_1100 IG ,74,3399,18785,22184,video
CompanyJ_9629,Luka and Boban all season Team chemistry on ,44,1040,11761,12801,video
CompanyJ_9630,Ronaldo really making more money on Instagram than on the field brfootball ,75,518,3277,3795,photo
CompanyJ_9631,The NBA title will go through L A but it won t be for the Lakers it will be the Clippers according to HowardBeck ,113,467,3085,3552,video
CompanyJ_9632,This Twitch streamer was so shocked by getting 20K viewers he woke up his mom to come and see brgaming via NiceWigg ,116,980,8003,8983,video
CompanyJ_9633,Elite guests eating nasty food KDTrey5 is on the premiere of How Hungry Are You dropping Monday and he s eating snake ,118,416,2750,3166,video
CompanyJ_9634,Shaq found a home for the family of a 12 year old boy who was paralyzed in a shooting and will pay a year s rent for them per 11AliveNews ,138,825,7682,8507,photo
CompanyJ_9635,DJ brings life back to the Bronx via MLB ,41,263,1767,2030,video
CompanyJ_9636,YANKEES CAME TO PLAY TODAY 3 run homer via MLBONFOX ,52,734,3288,4022,video
CompanyJ_9637,Kyrie gets his first bucket as a Net ,37,1787,16548,18335,video
CompanyJ_9638,Fournette still can t believe Ramsey s gone brgridiron ,55,1480,16039,17519,photo
CompanyJ_9639,Jah dunked on Mitchell Robinson and DSJ ,40,649,6306,6955,video
CompanyJ_9640, obj a real one for giving this kid his phone number and an IG follow via thecheckdown ,87,4647,40997,45644,video
CompanyJ_9641, Someone left the window open at MSG ,37,746,6490,7236,video
CompanyJ_9642,RJ drops the HAMMER ,20,670,6255,6925,video
CompanyJ_9643,After 3 quarters James Harden has 39 PTS 5 REBS 5 ASTS 4 STLS Beard behavior ,77,1289,11505,12794,video
CompanyJ_9644,New York stays alive Series goes back to Houston after Yankees beat Astros 4 1 in Game 5 ,89,583,3070,3653,photo
CompanyJ_9645,Kendrick Nunn went undrafted in 2018 Tonight he dropped 40 points for the Heat ,79,6968,41260,48228,video
CompanyJ_9646,Norvell drops Poole again ,26,4897,30753,35650,video
CompanyJ_9647,Bron ,5,5342,38368,43710,video
CompanyJ_9648,DLo s feelin it ,16,1042,9595,10637,video
CompanyJ_9649,Griezmann Messi and Suarez all score in the same game for Barcelona for the first time brfootball ,98,322,2612,2934,photo
CompanyJ_9650,Luka scored on his asst coach Jamahl Mosley and the first thing Mosley did was look around for the cameras via fanaticsview ,124,760,8040,8800,video
CompanyJ_9651,Too much talent for one award race ,35,503,3715,4218,photo
CompanyJ_9652,Zlatan knows he d still put in work at 38 if he left MLS brfootball ,68,116,1224,1340,photo
CompanyJ_9653,These custom chucks should be the Dame Winners brkicks via zach feuer IG ,73,352,4005,4357,video
CompanyJ_9654,Gucci Mane revealed that he lost over six figures and his Giannis jersey betting with Drake in the NBA Finals H T JalenandJacoby ,129,796,7420,8216,photo
CompanyJ_9655,If you re looking to the NBA for leadership on China HowardBeck says you re looking in the wrong place ,103,99,694,793,photo
CompanyJ_9656,This fake punt just wasn t it via CBSSportsHQ ,46,540,3383,3923,video
CompanyJ_9657, So rock me momma like a wagon wheel ,37,1867,12300,14167,photo
CompanyJ_9658,Jalen Hurts froze his defender via CFBONFOX ,44,455,4118,4573,video
CompanyJ_9659, Watch her ability to roll Nice roll Gus Johnson is a national treasure via CFBONFOX ,85,11880,54584,66464,video
CompanyJ_9660,Why d the ump climb up the fence like that via hgomez27 ,56,646,4431,5077,video
CompanyJ_9661,Pascal Siakam has agreed to a 4 year max contract extension with Raptors per wojespn and ZachLowe_NBA ,102,761,5964,6725,photo
CompanyJ_9662,New energy in Dallas luka7doncic and BobanMarjanovic need a show ,65,471,4217,4688,photo
CompanyJ_9663,ILLINOIS UPSETS NO 6 WISCONSIN Illini take down the Badgers 24 23 to steal one in Champaign ,92,3154,18328,21482,photo
CompanyJ_9664,Illinois played Jump Around after upsetting No 6 Wisconsin via JohnBoelWAVE3 ,77,1759,10577,12336,video
CompanyJ_9665, Jacob Eason via SeaTimesSports ,32,133,1171,1304,video
CompanyJ_9666,TCU s QB went BEAST MODE on this run via TCUFootball ,53,2701,14605,17306,video
CompanyJ_9667,Rashod Bateman looking like OBJ via BigTenNetwork ,50,303,2132,2435,video
CompanyJ_9668, JalenHurts is still hungry after 5 TDs and nearly 400 total yards today Built different ,89,3374,21951,25325,video
CompanyJ_9669,Four time cancer survivor Casey O Brien got his first hold for the Gophers Words can t do these type of moments justice via BigTenNetwork ,138,4035,22114,26149,video
CompanyJ_9670, SkyDigg4 gave everything she had ,34,4412,23308,27720,photo
CompanyJ_9671,The Crimson Tide are undefeated and their WR core is a big reason why ,70,288,1777,2065,video
CompanyJ_9672,Buddy Hield sent a not so subtle message to Vlade at the Kings Fan Fest via SeanCunningham ,91,1125,8486,9611,video
CompanyJ_9673,Harden and Russ trying to help the Astros reach the World Series any way they can via Cut4 ,91,4949,35746,40695,video
CompanyJ_9674,ASTROS TURN THE DOUBLE PLAY via MLB ,36,1982,9077,11059,video
CompanyJ_9675,Michigan fans losing to a top 10 opponent yet again ,52,777,5005,5782,video
CompanyJ_9676,YANKEES NOT DONE YET 4 4 in the 9th via YESNetwork ,51,1309,5688,6997,video
CompanyJ_9677,Astros move on to the World Series for the second time in three years Ice cold in their biggest moment of the postseason From B R X CoorsLight ,143,2038,7764,9802,video
CompanyJ_9678,HOUSTON WALK OFF TO THE WORLD SERIES WOW via FOXSports ,55,16095,59921,76016,video
CompanyJ_9679,Jose Altuve just ripped the heart out of the Yankees via Cut4 ,62,3811,18188,21999,video
CompanyJ_9680,ALTUVE LEFT NO DOUBT Houston goes crazy via napogh IG ,54,986,6081,7067,video
CompanyJ_9681,Division ALDS ALCS Let s go win this World Series via astros ,61,1324,7707,9031,video
CompanyJ_9682,The other side of the champagne popping ,40,421,3748,4169,photo
CompanyJ_9683,The high school jersey LeBron wore on the Chosen One cover auctioned for over 184K via GoldinAuctions sinow ,108,518,4145,4663,photo
CompanyJ_9684,This pick six is WILD via AF_Football ,38,1544,10873,12417,video
CompanyJ_9685,With the Cowboys and Eagles both at 3 3 who s your pick between the two to win the NFC East dunkindonuts ,105,308,1942,2250,status
CompanyJ_9686,A teenage Jose Altuve was once cut from an Astros tryout because he was too short Then he signed as an undrafted FA with a signing bonus of only 15K Now the 2017 AL MVP has led Houston to another World Series as ALCS MVP ,221,1630,9786,11416,photo
CompanyJ_9687,J J Watt repping Altuve via HoustonTexans ,42,840,13017,13857,video
CompanyJ_9688,Nobody touching Stefon Diggs cleat game this year brkicks via MACHE275 ,71,1349,11766,13115,photo
CompanyJ_9689,Uncle Drew in real life via thekingofunderdogs IG ,50,1517,10946,12463,video
CompanyJ_9690,Bye weeks putting holes in your roster We got you TheMattCamp is answering all your questions to help you get through a pivotal Week 7 on Your Fantasy Fire Drill starting NOW ,175,10,68,78,link
CompanyJ_9691,After missing just three games with a high ankle sprain Saquon is back today via NFL ,85,988,7719,8707,photo
CompanyJ_9692,Rashford puts Manchester United ahead via NBCSportsSoccer ,58,378,2037,2415,video
CompanyJ_9693,Behind the back Through the legs WHAT Ballislife isaiahrivera_1 ,64,8996,42399,51395,video
CompanyJ_9694,36 Man Utd score 38 VAR goal stands 45 Liverpool score 46 VAR goal disallowed 85 Liverpool equalize WHAT A GAME brfootball ,123,104,691,795,photo
CompanyJ_9695,FedEx Field is a slip n slide today via thecheckdown ,53,4377,33835,38212,video
CompanyJ_9696,T H I E L E N O E T A P via Vikings ,36,486,3723,4209,video
CompanyJ_9697,This guy really offered the ref 70 pregame br_betting via shane_ballenger IG cooper_ballenger IG ,97,509,4110,4619,video
CompanyJ_9698,Jalen Ramsey has arrived via thecheckdown ,42,1790,14167,15957,video
CompanyJ_9699,Julio ran right by Ramsey via NFL ,34,1589,12153,13742,photo
CompanyJ_9700,Eric Ebron catch of the day via NFL ,36,1115,7251,8366,video
CompanyJ_9701,Dirty Bird in ATL Gerald Everett didn t have to do that via thecheckdown ,73,1057,9035,10092,video
CompanyJ_9702,Aaron Rodgers is having an Aaron Rodgers game 5 TDs after three quarters ,73,994,6363,7357,photo
CompanyJ_9703,Aaron Donald just snatched it MEAN via NFL ,43,417,3259,3676,photo
CompanyJ_9704,Undefeated mood for SF via FOXSports ,37,3358,23833,27191,video
CompanyJ_9705,ARE YOU NOT ENTERTAINED Aaron Rodgers with TD No 6 ,51,2158,11351,13509,photo
CompanyJ_9706,Aaron Rodgers decided to remind everyone of his greatness today brgridiron ,75,1609,8997,10606,photo
CompanyJ_9707,Lamar launched it via NFL ,26,700,5877,6577,photo
CompanyJ_9708,Holding can t stop Tyler Lockett via NFL ,41,249,2425,2674,video
CompanyJ_9709,Jimmy G moved to 14 2 as an NFL starter today That s the length of a full season Franchise QB ,94,1330,12616,13946,photo
CompanyJ_9710,Six TDs today Packers 6 1 brgridiron ,37,2431,14532,16963,video
CompanyJ_9711,This return TD camera angle via ChicagoBears ,45,2615,16036,18651,video
CompanyJ_9712,LAMAR FOR THE LEAD via Ravens ,30,717,4258,4975,video
CompanyJ_9713,Fullback pitch to the QB staple in every NFL playbook via thecheckdown ,71,1508,13511,15019,video
CompanyJ_9714,LAMAR TOOK OFF via thecheckdown ,32,1371,11236,12607,video
CompanyJ_9715,Ravens scoop and score Dagger via Ravens ,41,636,3785,4421,video
CompanyJ_9716,Earl Thomas shows love to his former Seahawks teammates while he and Pete Carroll walk right past each other via NFLonFOX ,122,2228,20405,22633,video
CompanyJ_9717,Lamar even getting MVP chants in Seattle via Ravens ,52,2366,16776,19142,video
CompanyJ_9718,TAVON AUSTIN FROZE HIM via thecheckdown ,40,979,7212,8191,video
CompanyJ_9719,With nine games left to play Lamar Jackson s third 100 yard rushing game this season has already tied the NFL record for QBs brgridiron h t RyanMc23 ,149,701,4501,5202,photo
CompanyJ_9720,Wentz throws a DIME We got a game via thecheckdown ,51,338,4394,4732,video
CompanyJ_9721,Dak faked everybody for this TD via NFL ,40,591,4386,4977,video
CompanyJ_9722,Amari s route running is ridiculous via thecheckdown ,53,5085,36278,41363,video
CompanyJ_9723,Bronny threw down his first dunk at Sierra Canyon brhoops ,58,9433,58394,67827,video
CompanyJ_9724,Amari My goodness via thecheckdown ,35,2054,15996,18050,video
CompanyJ_9725,DAK TAKES IT HIMSELF FOR SIX via NFL ,37,467,3452,3919,video
CompanyJ_9726,Zeke was eating tonight brgridiron 147 yards TD Cowboys beat the Eagles 37 10 ,78,1498,8031,9529,photo
CompanyJ_9727,Dak makes history in Dallas campbellschunky ad ,47,223,1906,2129,video
CompanyJ_9728, CC_Sabathia officially retires with a heartfelt goodbye to baseball and New York ,82,1281,8738,10019,photo
CompanyJ_9729, Hell yeah Coach let s go for it Lj_era8 was all in on 4th down via Ravens ,75,8262,42841,51103,video
CompanyJ_9730,Cubs superstar javy23baez graces the cover of MLBTheShow 20 ,60,1154,5960,7114,photo
CompanyJ_9731,Melo s behind the back pass brhoops via NBL ,44,2148,14337,16485,video
CompanyJ_9732,Niners WR Dante Pettis pulled up to go sailgating and started passing food to other boats wendys ,97,50,372,422,video
CompanyJ_9733,What we want to see in the East Ben Simmons in the 3PT contest 3 ,65,393,3895,4288,photo
CompanyJ_9734,The curve on this goal is wild via ArsenalWFC ,46,337,3845,4182,video
CompanyJ_9735,Under 7 seconds Climber Aries Susanti Rahayu destroyed the women s speed climbing record Unreal via fpti_official ,114,127,830,957,video
CompanyJ_9736,2009 2019 The 09 draft class 10 years later ,44,1529,10410,11939,photo
CompanyJ_9737,Basketball is back B R NBA writers predict who will win the NBA championship MVP and more ,90,165,1092,1257,photo
CompanyJ_9738,Won the championship so coach turned on the moves via reece wagner11 IG ,72,220,2620,2840,video
CompanyJ_9739,Fans tip off the NBA season all around the city ,48,191,1461,1652,video
CompanyJ_9740,KD eats snake with sergeibaka Serge cooks for KDTrey5 as the new Net talks about his devastating injury his relationship with Russ playing with Kyrie and more on the premiere of How Hungry Are You SamsungMobileUS Watch FULL episode ,232,1420,5590,7010,video
CompanyJ_9741,Imagine this in the West ,25,2865,18840,21705,photo
CompanyJ_9742,The Celtics and Jaylen Brown have agreed to a four year 115M contract extension per wojespn ,92,1959,12845,14804,photo
CompanyJ_9743,Whoa via Andriragettli ,23,1197,6277,7474,video
CompanyJ_9744,What a good game pollokfc ,26,635,5518,6153,photo
CompanyJ_9745,Spurs and Dejounte Murray agree to 4 year 64M extension per ShamsCharania ,74,1738,10923,12661,photo
CompanyJ_9746,Breaking Zion Williamson out for 6 8 weeks after successful surgery for a torn lateral meniscus in his right knee ,114,2738,13817,16555,photo
CompanyJ_9747,Liverpool throw themselves an insufferable party and everybody hates it The Champions PlayStation ,98,299,1330,1629,video
CompanyJ_9748,Over the summer Patrick Mahomes visited with a young fan named Whitney Wells who has a rare brain tumor He was given a wristband with her name on it that says You got this The reigning MVP has been wearing it all year via ChiefsLotJ nfldraftscout brgridiron ,258,894,7848,8742,photo
CompanyJ_9749, ,1,8300,40261,48561,video
CompanyJ_9750,KD was confident Watch the premiere of How Hungry Are You ,58,387,2500,2887,photo
CompanyJ_9751,Patriots with their 15th interception of the year No other team even has 10 via NFL ,84,1297,8001,9298,video
CompanyJ_9752,It s getting ugly after a quarter on MNF Patriots 17 points 141 yards 12 minutes 34 seconds Jets 0 points 14 yards Two minutes 26 seconds ,138,592,4213,4805,photo
CompanyJ_9753,Patriots have taken a 20 point lead in five of their seven games this year via JoeTessESPN ,91,437,3201,3638,photo
CompanyJ_9754,When Belichick speaks the whole squad listens via thecheckdown ,63,1695,16423,18118,video
CompanyJ_9755,Patriots have 17 picks on the year They ve allowed one passing TD This defense is special ,90,4950,29906,34856,photo
CompanyJ_9756,Patriots defense making it scary out here brgridiron ,53,878,4779,5657,photo
CompanyJ_9757,Sam Darnold has five turnovers The Jets have zero points ,57,404,3024,3428,photo
CompanyJ_9758,Tom knows exactly how much time he has via thecheckdown ,56,1870,22899,24769,video
CompanyJ_9759,Need to catch up with this guy postgame via WEEI ,49,2470,15607,18077,video
CompanyJ_9760,7 0 mood via thecheckdown ,26,1602,13155,14757,video
CompanyJ_9761,MJ on Steph Curry Still a great player Not a Hall of Famer yet though He s not via TODAYshow ,93,2929,15064,17993,video
CompanyJ_9762,NBA BACK TODAY FINALLY ,23,23458,83508,106966,photo
CompanyJ_9763,Patriots are trading a second round pick for Falcons WR Mohamed Sanu per adamschefter The rich get richer ,106,3322,17161,20483,photo
CompanyJ_9764,Hours after destroying the Jets and moving to 7 0 the Patriots trade a 2nd for Mo Sanu This man never stops brgridiron ,119,2727,18447,21174,photo
CompanyJ_9765,Welcome to a new era in basketball ,35,18257,53883,72140,video
CompanyJ_9766,Today is stacked ,17,985,4164,5149,photo
CompanyJ_9767,This is the Lamar show now brgridiron ,38,1246,5475,6721,photo
CompanyJ_9768,Timed the spare perfectly via zachjbacon2 IG ,45,4135,31367,35502,video
CompanyJ_9769,Jokic in the top 10 Westbrook just outside Where do the NBA s elite rank in B R s Top 100 heading into the 2019 20 NBA season ,126,98,791,889,photo
CompanyJ_9770,The NBA landscape has shifted to dynamic duos ,46,1424,7200,8624,video
CompanyJ_9771,Only a matter of time before these NBA sons go pro brhoops ,59,1255,6871,8126,video
CompanyJ_9772,Creative Efficient Playmaker SteveNash says Kevin De Bruyne is the CP3 of brfootball ,85,74,627,701,video
CompanyJ_9773, Franchise record 107 wins Two Cy Young worthy pitchers MVP candidate The 2019 Astros are in the conversation for best team ever There are no weaknesses ,153,254,1696,1950,photo
CompanyJ_9774,This young fan s reaction to getting a player s shirt is everything via ClubBrugge ,83,335,3228,3563,video
CompanyJ_9775,Emmanuel Sanders has been traded to 49ers per MikeKlis ,55,2953,14304,17257,photo
CompanyJ_9776,The guy who bet more than 10M is looking for more br_betting is following MattressMack ahead of Game 1 ,103,87,377,464,link
CompanyJ_9777,Kawhi is ready to bring glory to his hometown Clippers the same way he did for Toronto newbalancehoops ,103,388,3284,3672,video
CompanyJ_9778,Keeper went full UFC brfootball ,32,90,973,1063,video
CompanyJ_9779,Mbappe making sure he didn t leave any kids out brfootball ,59,189,3157,3346,video
CompanyJ_9780,This Lakers tape will have you hyped for tonight SHOWTIME ,58,11352,34810,46162,video
CompanyJ_9781,The run The finish Raheem Sterling cut the defense open brfootball ,67,191,1569,1760,video
CompanyJ_9782,52 Subbed on 61 Scores first goal 63 Assists 79 Scores second goal 83 Hat trick Kylian Mbappe brfootball ,105,1018,6439,7457,photo
CompanyJ_9783,Brady s former backups are balling and Tom is freaking out PlayStation GridironHeights ,87,1338,5907,7245,video
CompanyJ_9784,The battle of LA begins tonight ,32,1905,8895,10800,video
CompanyJ_9785,NBA is officially back It s time to look for a new brkicks Sneaker King Who you got ,84,118,764,882,video
CompanyJ_9786, HOHLive Season 2 is HERE Featuring NickSwagyPYoung jackharlow amp CousinStizz ,79,21,84,105,link
CompanyJ_9787,Every Raptors fan in attendance is gonna walk away with this replica championship ring via lloydjulian IG ,106,4064,34617,38681,video
CompanyJ_9788,THE NBA IS HERE but Zion isn t ,31,7373,41947,49320,video
CompanyJ_9789,Welcome to the family DwyaneWade ,33,2236,12222,14458,video
CompanyJ_9790, NickSwagyPYoung is in the building Tune in to HOHLive ,55,33,134,167,link
CompanyJ_9791, NickSwagyPYoung says he hasn t retired yet Watch him on HOHLIVE ,65,64,443,507,video
CompanyJ_9792,Raptors receive their championship rings ,41,2082,14182,16264,video
CompanyJ_9793,Raptors hang their first banner ,32,1732,8952,10684,video
CompanyJ_9794,LONZO STARTING THE SEASON FIRING ,33,3657,29323,32980,video
CompanyJ_9795,He even knew he was out via ufc ,32,522,2994,3516,video
CompanyJ_9796,Custom championship rings for Drake ,36,1737,11028,12765,photo
CompanyJ_9797,BI faked out Lowry ,19,755,6065,6820,video
CompanyJ_9798,Zo already back to dropping dimes ,34,786,5864,6650,video
CompanyJ_9799,Did Zo just try Harden s one legged shot ,41,1296,13375,14671,video
CompanyJ_9800,BI making some ridiculous shots tonight ,40,376,3202,3578,video
CompanyJ_9801,Juan Soto is 20 years old and dominating his first World Series via MLBONFOX ,77,1139,6799,7938,video
CompanyJ_9802,Bron Bucket First of many ,26,1368,8796,10164,video
CompanyJ_9803,Bron fadeaway on Kawhi Tough ,29,12403,61476,73879,video
CompanyJ_9804,AD is a problem in the paint ,29,1906,14698,16604,video
CompanyJ_9805,AD s reach ,11,1413,11918,13331,video
CompanyJ_9806,MVP chants for Bron at Staples ,31,1037,6262,7299,video
CompanyJ_9807,Lakers fans booing Kawhi in his first Clippers game at Staples ,63,864,5749,6613,video
CompanyJ_9808,Kawhi s first bucket as a Clipper ,34,255,2210,2465,video
CompanyJ_9809,Kawhi hits the first 3 Bron hits the next Battle of LA living up to the hype so far ,84,2040,17085,19125,video
CompanyJ_9810,7 straight buckets for Fun Guy ,31,1866,13403,15269,video
CompanyJ_9811,Kawhi was near perfect for the Clips in the 1st half 20 PTS 8 11 FG ,68,1375,7574,8949,video
CompanyJ_9812,Nationals come out on top in Game 1 Washington wins 5 4 to take a 1 0 lead vs Astros in World Series Gerrit Cole suffers his first loss since May 22 ,149,898,4375,5273,photo
CompanyJ_9813,This view of Bron s fadeaway on Kawhi Cinematic via NBA ,56,17576,96572,114148,video
CompanyJ_9814,LEBRON IS FED UP STARE DOWN AFTER THE ,38,4336,20789,25125,video
CompanyJ_9815,LeBron chasedowns will never get old ,37,5628,32049,37677,video
CompanyJ_9816,LAKERS COME ALIVE LATE IN THE 3Q ,33,1623,8511,10134,video
CompanyJ_9817,Steve Ballmer ripped his shirt reacting to the game ,52,297,3103,3400,video
CompanyJ_9818,Jar3 d Dudley delivers from deep ,33,411,3869,4280,video
CompanyJ_9819,It s a new day in LA ,21,4852,18063,22915,video
CompanyJ_9820, Lakers are LA s best team Kawhi ,33,12811,67257,80068,video
CompanyJ_9821,Kawhi 30 PTS amp Lou Will 21 PTS handle the Lakers at Staples on Opening Night ,79,1327,6911,8238,video
CompanyJ_9822,Kawhi is the Fresh Klaw of LA via HoHighlights ,47,14668,43077,57745,video
CompanyJ_9823,Worth the wait ,15,1037,10717,11754,photo
CompanyJ_9824,After getting smoked by the Rams for their fifth straight loss Julio gave an emotional speech in the Falcons locker room supporting coach Dan Quinn This man has done everything for us It s on us via ZachKleinWSB ,212,922,9150,10072,photo
CompanyJ_9825,Juan Soto HR and 2 RBI double in first World Series appearance Kylian Mbappe Involved in 4 of PSG s 5 goals 3 goals 1 assist Both only 20 ,138,282,2427,2709,photo
CompanyJ_9826, J_No24 s crib is wild Giraffe rug Vibrating bed Personal barbershop Life sized Batman painting New Ditch the Playbook with AdamLefkoe StateFarm ,145,263,1585,1848,video
CompanyJ_9827,Neymar has played in only half of PSG s games since his record breaking 263M move brfootball ,93,117,1124,1241,photo
CompanyJ_9828,11 game slate tonight ,22,5327,27433,32760,photo
CompanyJ_9829,This fan really got Commissioner Silver to present him with his replica ring via k_jiwani IG ,93,3800,41817,45617,video
CompanyJ_9830, ,1,562,4798,5360,photo
CompanyJ_9831,Bring it on brfootball ,23,17,234,251,link
CompanyJ_9832,Lavar is restructuring BBB plans to launch a new website A BBB rep says The Big Baller Brand is alive and well per ramonashelburne brkicks ,139,173,1289,1462,photo
CompanyJ_9833,Ty Lue and Rich Paul via nickp_13th IG ,39,3403,21033,24436,video
CompanyJ_9834,The ref made him stand up to get the yellow card Savage ,56,549,6036,6585,video
CompanyJ_9835,THIS GOAL WOW brfootball ,25,3461,18683,22144,video
CompanyJ_9836,Pulisic with the assist Batshuayi with the finish via brlive ,61,398,2284,2682,video
CompanyJ_9837,Bosh will always ride for the Heatles ,38,523,3843,4366,photo
CompanyJ_9838,Messi is the first player to score in 15 consecutive Champions League seasons brfootball ,89,485,3124,3609,video
CompanyJ_9839,Kawhi may have been booed by Lakers fans during his home debut as a Clipper but the Finals MVP stole the show at Staples newbalancehoops ,137,806,6067,6873,video
CompanyJ_9840,World Cup champion Alex Morgan and husband Servando Carrasco announce they re expecting their first child ,106,397,4625,5022,photo
CompanyJ_9841,Patrick Beverley criticized TV programs that routinely show highlights of LeBron in defeats and challenged the media to report the facts after Lakers Clippers via ChrisBHaynes ,176,2523,15349,17872,photo
CompanyJ_9842,Firmino got fancy with it brfootball ,37,308,2628,2936,video
CompanyJ_9843,Outside of his foot from outside the box brfootball ,52,529,4308,4837,video
CompanyJ_9844,Josh Gordon is out for the year Patriots are placing the WR on IR with a knee injury per FieldYates ,100,804,4064,4868,photo
CompanyJ_9845,Seems like this is new to Josh Gordon Gordon believes he s close to returning to play could be available for other teams as a free agent soon per MikeGarafolo ,159,548,2676,3224,photo
CompanyJ_9846,Chuck on Kawhi vs Bron I don t hesitate At this point Kawhi s a better player than LeBron via BenGolliver ,106,2583,16101,18684,video
CompanyJ_9847,New era begins in Brooklyn tonight ,35,1057,7853,8910,photo
CompanyJ_9848,D Rose CROSSED Malcolm Brogdon ,31,15939,78151,94090,video
CompanyJ_9849,KD officially introduced in Brooklyn ,37,1362,8897,10259,video
CompanyJ_9850,Kyrie got emotional while addressing Nets fans for the first time ,66,1492,11913,13405,video
CompanyJ_9851,Uncle Drew off to a hot start in Brooklyn ,42,829,5679,6508,video
CompanyJ_9852,Ja Morant adjusting quickly ,28,1462,10759,12221,video
CompanyJ_9853,Kyrie really pointed at every defender after this finish ,57,3555,21843,25398,video
CompanyJ_9854,DJJ JUST THREW IT IN ,21,2906,12668,15574,video
CompanyJ_9855,Kyrie had Jake Layman confused ,31,827,6356,7183,video
CompanyJ_9856, ABREG_1 picked the perfect time for his 1st HR this WorldSeries Game 2 tied via MLB ,85,803,3602,4405,video
CompanyJ_9857, Simone_Biles first pitch via corte4 ,37,414,3496,3910,video
CompanyJ_9858,MARKELLE FULTZ DUNK IN TRANSITION ,34,5856,34885,40741,video
CompanyJ_9859,Cody Rhodes punched through the glass and threw Chris Jericho on the Dippin Dots cart BRWrestling ,98,552,3358,3910,video
CompanyJ_9860,Tyler Herro dropped Grayson Allen ,34,4583,29600,34183,video
CompanyJ_9861,Welcome to Brooklyn Uncle Drew 43 PTS and counting ,51,5887,30257,36144,video
CompanyJ_9862,Luka picking up where he left off ,34,1261,7943,9204,video
CompanyJ_9863,KYRIE 50 BALL IN NETS DEBUT ,28,3171,19455,22626,photo
CompanyJ_9864,Despite the loss Kyrie had an unforgettable Nets debut 50 PTS most points ever in Nets debut 8 REB 7 AST ,105,7582,38069,45651,video
CompanyJ_9865,Kyrie almost knocked down the buzzer beater ,44,3246,22340,25586,video
CompanyJ_9866,DAME DOLLA OH MY via NBATV ,27,22949,101914,124863,video
CompanyJ_9867,Deandre Ayton was HYPED after this Oubre dunk ,46,901,7821,8722,video
CompanyJ_9868,Bradley Beal got ejected ,25,608,4919,5527,video
CompanyJ_9869,CP3 did everything in his power to slow down this fast break ,61,525,5883,6408,video
CompanyJ_9870,Nationals are feeling themselves with this home run celebration via MLBONFOX ,77,1143,7102,8245,video
CompanyJ_9871,The Joker and Nuggets open the season with a win over Portland ,63,655,4890,5545,photo
CompanyJ_9872,Derrick Jones caught a BODY ,28,3418,17951,21369,video
CompanyJ_9873,LAMELO WITH THE GROWN MAN PUTBACK via NBL ,42,8598,46271,54869,video
CompanyJ_9874,Conor McGregor announces his comeback fight will be Jan 18 at T Mobile Arena in Las Vegas Donald Cerrone is the front runner to be his opponent per arielhelwani ,161,2452,9157,11609,photo
CompanyJ_9875,If Kyrie hit a game winner with an NBA Street move in his Brooklyn debut ,73,9914,69789,79703,video
CompanyJ_9876,RJ denied LaMelo via NBL ,25,580,5394,5974,video
CompanyJ_9877,A record 22nd and final season for Vince Carter Legend newbalancehoops ,71,1259,7339,8598,video
CompanyJ_9878,Would ve been crazy brgridiron ,31,484,5181,5665,photo
CompanyJ_9879,This Russ Lockett elevator is genius via RudyWillingham ,56,6074,52908,58982,video
CompanyJ_9880,Donovan Mitchell isn t going to get off easy The opponent s top defender having to guard you So now it s Klay Thompson It s Paul George It s Kawhi Now you re the target ,169,143,1871,2014,photo
CompanyJ_9881,What it s like guarding Steph off the ball NSFW via HoHighlights SupremeDreams_1 ,81,4848,24914,29762,video
CompanyJ_9882,This rally is wild via andersonaguia IG ,40,6084,35388,41472,video
CompanyJ_9883,Could you really sit Odell vs New England this week dunkindonuts ,65,63,910,973,video
CompanyJ_9884,Happy birthday to the sideline champion Drake has worn many jerseys but his heart is in Toronto ,96,1048,8526,9574,photo
CompanyJ_9885,Harry Maguire s first game as Manchester United captain completely forgot he had to do the coin toss via brfootball ,116,691,4499,5190,video
CompanyJ_9886,7 6 Tacko Fall says a low ceiling was the reason he was in concussion protocol per RedsArmy_John ,97,1310,11253,12563,photo
CompanyJ_9887,New routine JoelEmbiid picks a wedgie before each free throw via talentedmrcj IG ,81,1061,8217,9278,video
CompanyJ_9888,Yesterday was one year after Kyrie s grandfather s death Dropped 50 for him ,76,1550,13868,15418,photo
CompanyJ_9889,Don t sleep on Utah ,20,619,6535,7154,photo
CompanyJ_9890,Breaking Astros have fired assistant GM Brandon Taubman after inappropriate comments directed toward one or more reporters ,123,468,2771,3239,photo
CompanyJ_9891,FREE KICK WINNER IN THE 92ND MINUTE via brlive ,47,418,2508,2926,video
CompanyJ_9892, The artist who did it sucked J_No24 isn t a fan of the life sized Batman painting in his house StateFarm ,106,175,1574,1749,video
CompanyJ_9893, NateDiaz209 says he s out of UFC 244 after being told he tested with elevated levels ahead of Jorge Masvidal fight NSFW ,121,1700,6469,8169,photo
CompanyJ_9894,Shaq s sister Ayesha Harrison Jex died of cancer at 40 years old this morning The Inside crew send their condolences via NBAonTNT ,130,19329,94763,114092,video
CompanyJ_9895,Vince checks in 22 seasons History made ,40,2152,14157,16309,video
CompanyJ_9896,Trae dropped 16 points in the first 10 minutes That s cold ,59,1003,7280,8283,video
CompanyJ_9897,From OKC to H Town Russ makes his Rockets debut tonight ,56,722,4515,5237,video
CompanyJ_9898,Russ got his old dance partner back via NBAonTNT ,49,3273,21672,24945,video
CompanyJ_9899,Trae Young buried the 3 then started doing push ups ,52,1842,14823,16665,video
CompanyJ_9900,Russ and Harden already going back and forth ,45,7656,54169,61825,video
CompanyJ_9901, ,1,10095,46424,56519,video
CompanyJ_9902,Trae Young shoots from wherever ,32,1571,13395,14966,video
CompanyJ_9903,Deandre Ayton is facing a 25 game suspension for testing positive for a diuretic per wojespn ,93,938,4752,5690,photo
CompanyJ_9904,AP still doin work via NFL ,27,608,5073,5681,video
CompanyJ_9905,Ice Trae looking to make the leap 38 PTS 9 AST 7 REB ,53,2237,15766,18003,photo
CompanyJ_9906,GIANNIS CHASES DOWN HARDEN ,27,2930,17251,20181,video
CompanyJ_9907, Beard to Brodie ,17,3247,17783,21030,video
CompanyJ_9908,Brodie chants in H Town ,24,603,4543,5146,video
CompanyJ_9909,Chase Center gives Klay Thompson a standing ovation ,52,1253,13656,14909,video
CompanyJ_9910,Loading DLo with the first 10 PTS at Chase Center ,50,2761,19663,22424,video
CompanyJ_9911,Steph heating up ,17,498,5333,5831,video
CompanyJ_9912,Kawhi ,6,1991,20163,22154,video
CompanyJ_9913,He was having too much fun brfootball ,38,864,8673,9537,video
CompanyJ_9914,Caught the defender jumping on the pass only to put him on a poster Sheesh via humanwindmill ,93,2019,16264,18283,video
CompanyJ_9915,Which quarterback do you think will stay undefeated longer dunkindonuts,71,208,1206,1414,status
CompanyJ_9916,People in the NFL think J_No24 is weird but he s cool with it StateFarm ,72,35,427,462,video
CompanyJ_9917,Zlatan went off brfootball ,27,785,5490,6275,photo
CompanyJ_9918,If the Chiefs star QB doesn t play this weekend Kansas City could be in serious trouble StateFarm ,98,61,636,697,video
CompanyJ_9919,KD isn t dwelling on his time in OKC He s happy to see his former teammates flourishing We accomplished some crazy things to be that young samsungmobileus ,155,829,5579,6408,video
CompanyJ_9920,Draymond keeping it real ,25,376,3781,4157,photo
CompanyJ_9921,HOFer John Randle gifted this high school team all new equipment and got them fired up before a big game From Ford X B R PFHOF ,127,125,756,881,video
CompanyJ_9922, ,1,9188,45630,54818,photo
CompanyJ_9923,Auburn s Bo Nix was born to be an elite QB he s lived and breathed football since he was a child Bo basically came out of the womb wanting a ball in his hands ,159,65,573,638,photo
CompanyJ_9924,Kyrie on the Nets We re going to take over the entire city via Jengabcel ,73,860,7497,8357,video
CompanyJ_9925,14 years old and dunking with ease brhoops via toby fournier IG ,64,2987,21716,24703,video
CompanyJ_9926,Kyrie vs RJ Knicks vs Nets Battle of the boroughs goes down tonight at Barclays newbalancehoops ,96,340,3353,3693,video
CompanyJ_9927,Kyrie receiving boos at the free throw line in Barclays Knicks fans are out in Brooklyn ,88,915,9582,10497,video
CompanyJ_9928,Nats had the Avengers theme playing during player intros via MLB ,65,1247,9346,10593,video
CompanyJ_9929,Kyrie and Theo Pinson had to impersonate Caris LeVert s hesi ,61,3207,24598,27805,video
CompanyJ_9930,Thunder rookie Darius Bazley did his best Kawhi impression ,59,5683,41508,47191,video
CompanyJ_9931,JERAMI GRANT ,13,3410,21478,24888,video
CompanyJ_9932,KYRIE DAGGER ,13,12975,70343,83318,video
CompanyJ_9933,Win No 1 in Brooklyn Family first ,34,1676,14425,16101,video
CompanyJ_9934,Luka step back 3 Clutch ,24,1704,10439,12143,video
CompanyJ_9935,Murray dropped Booker ,22,3861,22995,26856,video
CompanyJ_9936,Bron AD Lakers duo looking good via NBATV ,42,1059,10132,11191,video
CompanyJ_9937,AD went for the lob and ended up with a bucket via NBATV ,57,1700,19610,21310,video
CompanyJ_9938,Torrey Craig blocks Devin Booker to win the OT game in Denver ,62,570,4264,4834,video
CompanyJ_9939,Dame right in front of the logo Cash ,37,5389,41969,47358,video
CompanyJ_9940,Bron put it where only AD could get it WOW via NBATV ,53,2862,24323,27185,video
CompanyJ_9941, rihanna ,9,3948,32423,36371,video
CompanyJ_9942,The Big Ten has represented well thus far this season ,54,159,1444,1603,photo
CompanyJ_9943,Jonathan Taylor amp Chuba Hubbard are the real deal ,52,175,1526,1701,video
CompanyJ_9944,On this day in 1984 Michael Jordan made his NBA debut Led all players in minutes played 40 Finished with 16 PTS 7 AST 6 REB 4 BLK 2 STL The beginning of a career ,162,1803,9909,11712,photo
CompanyJ_9945, brfootball ,12,380,3525,3905,photo
CompanyJ_9946,Kyrie s go ahead three from courtside Too clutch via jackgiamanco3 ,67,2126,16763,18889,video
CompanyJ_9947,Breaks the tackle after a wild hurdle And LloydMarshawn still in high school via MonSportsNet ,94,440,2630,3070,video
CompanyJ_9948,Christian Pulisic to get first start for Chelsea in the Premier League since August 31 brfootball ,98,109,2051,2160,photo
CompanyJ_9949,The most dramatic strikeout call today via hgomez27 ,52,6834,34397,41231,video
CompanyJ_9950,CeeDee Hurts flea flicker Lincoln Riley s playbook via CBSSportsHQ ,67,195,1577,1772,video
CompanyJ_9951,Christian Pulisic scores his first Chelsea goal brfootball ,59,320,3249,3569,photo
CompanyJ_9952,Been a long time coming for cpulisic_10 Via NBCSportsSoccer ,60,593,3232,3825,link
CompanyJ_9953,This 50 yard TD run is straight out of a video game via BigTenNetwork ,70,341,2885,3226,video
CompanyJ_9954,Pulisic is ready for more brfootball ,37,225,2066,2291,photo
CompanyJ_9955,First start since August Hat trick No big deal brfootball ,58,1018,8287,9305,photo
CompanyJ_9956,First career hat trick for Pulisic What a moment via NBCSportsSoccer ,69,895,4799,5694,video
CompanyJ_9957, I can t sign that DwyaneWade always staying loyal to the brand brkicks via itskage_official IG ,96,725,7977,8702,video
CompanyJ_9958,Ohio State marching band took the fans on a trip to Bikini Bottom at halftime via CFBONFOX ,91,13864,48711,62575,video
CompanyJ_9959,Time to put Chase Young at the top of your Heisman rankings Matchup NIGHTMARE via CFBONFOX ,91,1093,5670,6763,video
CompanyJ_9960, Jump Around in Columbus The disrespect via CFBONFOX ,53,753,4246,4999,video
CompanyJ_9961,Justin Fields put on a show in Columbus 12 22 for 167 passing yards 2 TDs 0 INTs 1 rushing TD Led Buckeyes to a 38 7 win over No 13 Wisconsin ,142,356,2027,2383,photo
CompanyJ_9962,Christian Pulisic became the youngest Chelsea player to score a hat trick in Premier League The Pennsylvania native is only 21 brfootball ,138,267,2360,2627,photo
CompanyJ_9963,Drew Brees to start for Saints vs Cardinals on Sunday after missing last 5 games with hand injury per diannaESPN ,113,715,3412,4127,photo
CompanyJ_9964, No 5 Oklahoma UPSET Unranked KSU takes down the Sooners 48 41 ,63,1687,9020,10707,photo
CompanyJ_9965,This is how close OU was to recovering an onside kick to potentially force OT or win the game ,94,287,2610,2897,video
CompanyJ_9966, OSU WR WENT BEAST MODE via CowboyFB ,37,2430,11315,13745,video
CompanyJ_9967, You make me proud son Raptors GM Masai Ujiri went back to Nigeria to surprise his parents with the championship trophy RealSportsHBO is streaming on HBO ,154,3398,16201,19599,video
CompanyJ_9968,Florida State out here playing Backyard Football via accnetwork ,64,1463,9920,11383,video
CompanyJ_9969,Bryan Edwards one handed catch UNBELIEVABLE via SECNetwork ,59,650,3440,4090,video
CompanyJ_9970,THIS HIT via Vol_Football ,26,4580,24889,29469,video
CompanyJ_9971,Down goes Oklahoma ,19,922,6189,7111,video
CompanyJ_9972,No 2 LSU remains undefeated holds off No 9 Auburn 23 20 Joe Burrow 34 42 for 321 yards 1 TD 1 INT Clyde Edwards Helaire 26 carries for 136 yards 1 TD Ja Marr Chase 8 catches for 123 yards ,188,475,2589,3064,photo
CompanyJ_9973,GIANNIS FORCES OT ,18,1586,9831,11417,video
CompanyJ_9974,Markelle Fultz s first 3 pointer with the Magic ,48,1465,14237,15702,video
CompanyJ_9975,Tristan Thompson hit his first career 3PT and Kevin Love loved it ,66,4210,38321,42531,video
CompanyJ_9976,It s a party in Houston before every game ,42,1114,7914,9028,video
CompanyJ_9977,Trae stole the ball and pulled up from DEEP with the defense closing in ,72,1138,9411,10549,video
CompanyJ_9978,Harden hit himself in the face and Josh Hart couldn t believe it ,65,58180,233997,292177,video
CompanyJ_9979,D Rose getting MVP chants in Detroit ,37,9215,55418,64633,video
CompanyJ_9980,IT s first bucket of the year ,30,1027,11169,12196,video
CompanyJ_9981,TRAE YOUNG IS TOO COLD ,23,5035,25538,30573,video
CompanyJ_9982,Brodie bringing the house down ,31,3082,22113,25195,video
CompanyJ_9983,Tacko Fall made his presence felt in his NBA debut ,51,2224,17631,19855,video
CompanyJ_9984,Zaire threw it down in front of LeBron D Wade and Gab brhoops ,62,1757,16939,18696,video
CompanyJ_9985,Bregman GRAND SLAM via MLB ,27,1545,6503,8048,video
CompanyJ_9986,Ouch ,5,4131,27917,32048,video
CompanyJ_9987,Russ stands alone at second all time in triple doubles ,55,1090,6496,7586,photo
CompanyJ_9988,The Beard literally went off after this no call ,48,2758,18438,21196,video
CompanyJ_9989,Devin Booker fouled out Pat Beverley and the Suns bench started waving bye ,75,8626,58454,67080,video
CompanyJ_9990,Trae Young over the first two games 77 points 18 assists 14 rebounds 11 3s ,75,5809,46599,52408,photo
CompanyJ_9991,Clint Dempsey and cpulisic_10 are the only two Americans to ever score Premier League hat tricks brfootball ,108,234,2772,3006,photo
CompanyJ_9992,Drew Brees returns to the Saints today Teddy Bridgewater held it DOWN in his absence 5 0 as starter 9 TD 2 INT 69 7 completion 103 7 QB rating League s highest paid backup for a reason ,185,3886,31378,35264,photo
CompanyJ_9993,Time to start talking about Rodgers in the MVP convo statefarm ,63,148,1248,1396,video
CompanyJ_9994,There are people in the Patriots organization who can t predict if Tom Brady will return to New England move to another team or retire this summer Two biggest advantages for the Patriots Belichick and Kraft via adamschefter ,224,213,2130,2343,photo
CompanyJ_9995,Melo is a bucket Went off for 16 PTS 10 REB 7 AST via NBL ,58,702,4965,5667,video
CompanyJ_9996,A pivotal week in the fantasy season TheMattCamp has you covered with advice injury updates and more on Your Fantasy Fire Drill Watch NOW ,138,7,68,75,link
CompanyJ_9997,Zaire to Bronny had DWade and Bron hyped brhoops ,49,8326,53455,61781,video
CompanyJ_9998,Messi says the best ever striker was Ronaldo brfootball ,56,357,2909,3266,photo
CompanyJ_9999,Lou Williams turns 33 today Drafted 45th overall in 2005 Played for six teams 3x 6th Man of the Year One of the best players ever to come off the bench Game is aging like fine wine ,181,2333,18011,20344,photo
CompanyJ_10000,It took Harry Kane less than a minute to score vs Liverpool via NBCSportsSoccer ,80,195,1527,1722,video
CompanyJ_10001,Jags mascot really came dressed as a ghost against Darnold and the Jets via BenMurphyTV ,88,1235,8811,10046,video
CompanyJ_10002, TWO HOPS THIS TIME via thecheckdown ,37,854,6786,7640,video
CompanyJ_10003,Simply no defending this via thecheckdown ,42,542,6362,6904,video
CompanyJ_10004,DK Metcalf s pacifier mouthpieces are always fire ,50,435,4829,5264,photo
CompanyJ_10005,2 2 0 YARDS Cooper Kupp is racking up ridiculous yardage with over 25 minutes left in the game ,95,413,3878,4291,photo
CompanyJ_10006,SAQUON RUNNING MEAN via thecheckdown ,37,13491,68874,82365,video
CompanyJ_10007,Troll game in Jacksonville is next level Ghostbusters song on the Darnold blooper mix via mistochristopho ,106,959,5666,6625,video
CompanyJ_10008,Another Patriots Defensive TD via NFL ,38,672,4652,5324,video
CompanyJ_10009,George Kittle having a great time out there today via thecheckdown ,67,756,11782,12538,video
CompanyJ_10010,Patriots D ST has more touchdowns 6 this year than Odell Julio Hopkins Fournette Kamara Le Veon Mike Thomas Kelce Keenan Diggs JuJu ,132,2165,9673,11838,photo
CompanyJ_10011, ,1,8373,35955,44328,video
CompanyJ_10012,,0,14757,71543,86300,photo
CompanyJ_10013, Now y all know how it feels ,29,1967,16858,18825,video
CompanyJ_10014,CMC trying to put the Panthers on his back via thecheckdown ,60,235,2489,2724,video
CompanyJ_10015,Uncle Drew Nasty ,17,10689,55844,66533,video
CompanyJ_10016,Morant Mean Mug ,16,1351,11487,12838,video
CompanyJ_10017,Deshaun Watson is ridiculous Broke the sack Got kicked in the face Threw the TD WOW brgridiron via NFL ,103,2986,16697,19683,video
CompanyJ_10018,Brady sends Baker home with an L Pats move to 8 0 brgridiron ,61,4745,18144,22889,video
CompanyJ_10019,Texans fear J J Watt may have suffered a torn pec and could miss the rest of the season per RapSheet ,101,505,3030,3535,photo
CompanyJ_10020,Pats defense is scary brgridiron ,33,812,5458,6270,photo
CompanyJ_10021,HC Frank Vogel says Lakers have not closed the door on DeMarcus Cousins returning to the team this season after torn ACL ,121,531,4251,4782,photo
CompanyJ_10022,Kristaps 3PT step back ,23,1524,13040,14564,video
CompanyJ_10023, JJWatt confirms he s out for the year Prayers up ,50,535,3729,4264,photo
CompanyJ_10024,JA Kid is special ,18,7173,45304,52477,video
CompanyJ_10025, CLUTCH JA ,11,916,6406,7322,video
CompanyJ_10026,Morant put the clamps on Kyrie ,31,1979,14147,16126,video
CompanyJ_10027,Tiger wins in Japan Woods is now the 2nd to reach 82 PGA Tour wins ,67,979,5891,6870,photo
CompanyJ_10028,CROWDER FOR THE WIN ,20,6081,34793,40874,video
CompanyJ_10029,Ja vs Kyrie was a BATTLE Ky 37 7 7 Ja 30 4 9 ,45,4335,23244,27579,video
CompanyJ_10030,WIGGINS TAKING OVER FROM 3 ,27,1148,6775,7923,video
CompanyJ_10031,Correa bomb Astros heating up via MLB ,38,631,3235,3866,video
CompanyJ_10032,Spo called out each ref individually ,37,1769,14712,16481,video
CompanyJ_10033,Aaron Rodgers is on another planet via NFL ,43,3943,21766,25709,video
CompanyJ_10034,Aaron Jones 67 yards TD via thecheckdown ,41,519,5633,6152,video
CompanyJ_10035,ALEX CARUSO TAKES FLIGHT ,25,7741,53951,61692,video
CompanyJ_10036,Bron pulls up from 3 then hypes up Staples ,43,2726,24220,26946,video
CompanyJ_10037,Dwight Howard was everywhere for the Lakers tonight 16 PTS 10 REB amp 4 BLK on 8 8 FG against his former team ,110,5743,42091,47834,video
CompanyJ_10038,LeBron says he plays NBA 2K just like he does in real life which makes a lot of his friends upset via BenGolliver ,114,1873,16174,18047,video
CompanyJ_10039,Ronaldo gifted every player on the Portugal U17 women s team new cleats after they advanced in Euro qualification brfootball ,125,292,3093,3385,photo
CompanyJ_10040,Jae Crowder s OT game winner from the stands via zbeller ,57,517,7300,7817,video
CompanyJ_10041,Cardinals are trading a conditional 2020 pick to the Dolphins for RB Kenyan Drake per AdamSchefter ,99,440,3232,3672,photo
CompanyJ_10042,Reminder Bronny s only a freshman brhoops ,42,1324,14708,16032,video
CompanyJ_10043,Dabo Swinney said any team that passed on drafting Deshaun Watson was passing on Michael Jordan Jon Gruden saw the same greatness on Sunday brgridiron ,151,361,3373,3734,photo
CompanyJ_10044,AD and Bron were playing football pregame via pablo024 IG ,58,9597,73139,82736,video
CompanyJ_10045,18 year old Sergino Dest has officially chosen to represent the USMNT brfootball ,81,1208,12162,13370,video
CompanyJ_10046,Sergino Dest is so smooth with it ,34,577,5133,5710,video
CompanyJ_10047,Kawhi s team has filed a trademark for WHAT IT DO BABY for a brand of clothing per JoshGerben ,94,2847,21381,24228,video
CompanyJ_10048,Good to see John Wall hooping again via HoopDistrictDC ,55,1811,11400,13211,video
CompanyJ_10049,WR Decoldest ToEvaDoIt Crawford has committed to LSU Yrncold ,61,7206,32726,39932,photo
CompanyJ_10050,Thunder vs Rockets CP3 vs Russ The revenge game is here ,56,1275,8664,9939,video
CompanyJ_10051,Tom Brady and his son Ben waited outside the visiting locker room after Patriots Browns so Ben could meet obj The QB WR and nine year old had a lengthy chat well after both locker rooms had cleared out via nicolecyang ,218,2452,25127,27579,photo
CompanyJ_10052,HOFer Anthony Munoz will never forget where he got his start It feels great to give back to youth sports From Ford X B R PFHOF ,127,66,351,417,video
CompanyJ_10053,Deshaun Watson took a foot directly to the face and threw a touchdown with one eye Built different via NFLFilms ,112,5310,32538,37848,video
CompanyJ_10054,Gotta time the hurdle right via i64sports ,42,1386,9068,10454,video
CompanyJ_10055,Sent him sliding brfootball ,28,356,3268,3624,video
CompanyJ_10056,KD on FC Barcelona KDTrey5 says he d love to play a final season overseas Watch How Hungry Are You ,99,1455,5862,7317,video
CompanyJ_10057,Looks like EWeezy_For3eezy still got the assist tho via EuroLeagueWomen ,72,348,2445,2793,video
CompanyJ_10058,Dwight is dressed as Thanos for Halloween via DwightHoward ,59,1012,9464,10476,video
CompanyJ_10059,Kerr on Steph s usage We could turn him into James Harden and give him the ball every play but that s hard to do via anthonyVslater ,132,495,4724,5219,video
CompanyJ_10060,Trae gotta relax ,17,6778,42157,48935,video
CompanyJ_10061,Embiid through his own legs ,28,667,6767,7434,video
CompanyJ_10062,Ice Trae went full court with this pass ,40,284,3405,3689,video
CompanyJ_10063,Mitchell Robinson inscribed DSJ 5 on his sneakers tonight for Dennis Smith Jr who s back home in NC mourning the death of his stepmom brkicks ,142,880,8327,9207,photo
CompanyJ_10064,Raptors rocking the throwbacks and got the court to match ,58,1369,12090,13459,photo
CompanyJ_10065,Mike Scott got ejected for this ,32,433,3408,3841,video
CompanyJ_10066,Straight up disrespectful joelembiid ,37,2578,11403,13981,video
CompanyJ_10067,Steph heard the slander and pulled up from DEEP ,48,1286,9713,10999,video
CompanyJ_10068,VanVleet did Fultz too dirty ,29,11974,62071,74045,video
CompanyJ_10069,Brandon Ingram taught Jordan Poole not to jump with him ,56,4620,30354,34974,video
CompanyJ_10070,D Rose coming through in the clutch ,36,2395,15444,17839,video
CompanyJ_10071,Russ still taking rebounds from Steven Adams ,45,2646,23514,26160,video
CompanyJ_10072,This two man game from D Lo and Steph ,38,5028,31144,36172,video
CompanyJ_10073,JuJu with the Monday Night Mossing via Steelers ,48,573,3917,4490,video
CompanyJ_10074,This Russ dime was NASTY ,25,915,5967,6882,video
CompanyJ_10075,RICHAUN HOLMES ON MASON PLUMLEE ,32,867,6204,7071,video
CompanyJ_10076,LILLARD TIME Dame just scored the last 16 points for the Blazers ,65,2097,12239,14336,video
CompanyJ_10077,Steph and D Lo were hyped for their first W of the season via poormanscommish ,78,1433,13254,14687,video
CompanyJ_10078, KAWHI ,7,485,4848,5333,video
CompanyJ_10079,IT already won Halloween via kayla_jasmin_ Instagram ,53,3246,29301,32547,photo
CompanyJ_10080,Kelly Oubre Jr went right through Gobert ,41,2406,18194,20600,video
CompanyJ_10081,Kawhi knows the memes and impersonations are all in good fun People love me I guess and like the things I say via NotoriousOHM ,127,2125,19449,21574,video
CompanyJ_10082, Hola España Guess what I m coming back Ibra_official to La Liga ,65,1079,6639,7718,video
CompanyJ_10083,Kyrie Irving s mood swings are an unspoken concern that makes Brooklyn officials queasy Nets sources say an episode happened on their trip to China leaving the team confused per Jackie MacMullan ,195,4817,28242,33059,photo
CompanyJ_10084,On court Russ is not your friend ,33,373,4185,4558,photo
CompanyJ_10085,Kawhi on the Clippers bench after Montrezl Harrell s dunk ,58,4152,40600,44752,video
CompanyJ_10086,DAMN via LBSUSoccer ,20,1246,7650,8896,video
CompanyJ_10087,Dougie John Wall is undefeated via kayla_jasmin_ IG ,52,4381,24557,28938,video
CompanyJ_10088, DeAndreHopkins with an early contender for Halloween costume of the year ,74,3997,31062,35059,video
CompanyJ_10089,He hadn t seen his brother in months so he ran out of the game to give him a hug via thtcountryboy1134 IG ,106,2548,31651,34199,video
CompanyJ_10090,Kenny Atkinson addresses the recent report on Kyrie Irving That is completely false in my experience with him so far it s absolutely not true via SNYtv ,152,537,2957,3494,video
CompanyJ_10091,NCAA s governing board voted unanimously to allow student athletes the opportunity to benefit from their names images and likenesses ,133,5406,23282,28688,photo
CompanyJ_10092,Knicks announce the death of Reggie Bullock s sister He had another sister who was killed in 2014 ,98,3045,24961,28006,photo
CompanyJ_10093,Steve Nash hooping at Venice Beach in a full suit and tie via evan_naka IG ,75,10944,69757,80701,video
CompanyJ_10094,16 years ago today KingJames made his pro debut 25 PTS 6 REBS 9 ASTS 4 STLS And the rest is history ,100,4145,21728,25873,video
CompanyJ_10095,Decoldest Crawford might be the best name in sports ,52,495,3550,4045,video
CompanyJ_10096,Bron sent a taco truck to feed the first responders fighting the Getty fire It s an amazing job what they do and their commitment with what s going on right now per mcten ,171,3880,29572,33452,photo
CompanyJ_10097,5 0 career free kicks for Leo Messi Unreal brfootball ,54,674,4155,4829,photo
CompanyJ_10098,An evil clown is terrorizing the town and giving the 04 draft class nightmares Special extended GridironHeights x IT episode playstation ,137,1110,4855,5965,video
CompanyJ_10099,Messi with the smoothest nutmeg via LaLigaEN ,45,3422,16876,20298,video
CompanyJ_10100,After KD said he would like to play overseas at Barcelona in his last year FCBarcelona got a jersey ready for him ,114,843,7958,8801,photo
CompanyJ_10101,Messi has now passed Ronaldo in club goals scored in 118 fewer games brfootball ,80,4457,14784,19241,photo
CompanyJ_10102,Jimmy Butler off to a perfect 4 4 start in his Heat debut ,58,692,6290,6982,video
CompanyJ_10103,Jimmy Butler crossed Tyrone Wallace out of the frame ,53,2459,16027,18486,video
CompanyJ_10104,Alex Bregman knew it was gone NO DOUBT via MLB ,47,1367,7128,8495,video
CompanyJ_10105,Tyler Herro WENT OFF for 19 PTS in the 2Q ,42,2347,15249,17596,video
CompanyJ_10106,CAM REDDISH ON TYLER HERRO ,27,1692,8955,10647,video
CompanyJ_10107,He scored the goal lacrosse style Goal of the year candidate via NHL ,69,562,3880,4442,video
CompanyJ_10108,JUAN SOTO CRUSHED IT NATS LEAD via MLB ,39,1027,5891,6918,video
CompanyJ_10109,Alex Bregman carried his bat to first base after homering Juan Soto made sure he did too when he gave the Nationals the lead via FOXSports ,139,3016,20020,23036,video
CompanyJ_10110,Anthony Rendon sends one deep after the controversial call at first base Ball don t lie via MLBONFOX ,101,1061,5809,6870,video
CompanyJ_10111,Bron amp AD on the same page ,29,1406,10552,11958,video
CompanyJ_10112,AD at the buzzer ,17,507,5353,5860,video
CompanyJ_10113,GAME 7 Nationals beat Astros 7 2 to force winner take all Game 7 in the World Series ,85,1567,8233,9800,photo
CompanyJ_10114,Anthony Davis through three quarters 40 PTS 20 REB 26 27 FT 2 BLK Deserved this standing ovation ,97,14376,69899,84275,video
CompanyJ_10115,Bron got the crowd to chant Taco Tuesday ,41,6830,36174,43004,video
CompanyJ_10116,AD became the first Lakers player since Shaq March 2003 to post 40 PTS 20 REB in a game He did it in 31 minutes which is the fastest 40 20 game in NBA history ,159,4785,24739,29524,photo
CompanyJ_10117,Coach had to let the team know he still had bounce Bodied via connorbenedict IG ,80,3151,27231,30382,video
CompanyJ_10118,He s a baller with one arm via ClasicoBoyonDom ,47,620,4737,5357,video
CompanyJ_10119,Teddy Bridgewater set himself up to get paid by going 5 0 without Brees Several team officials believe the QB could get 20M 30M yearly as a free agent this summer per mikefreemanNFL ,182,2562,20057,22619,photo
CompanyJ_10120,Former All Pro CB CRO31 says kneeling in 2016 led to his release from the Colts and ended his NFL career New Untold Stories with MasterTes ,139,905,2382,3287,video
CompanyJ_10121,That AD Bron connection via ryanbox91 IG ,41,2164,20087,22251,video
CompanyJ_10122,Kobe says he wouldn t make an NBA comeback even if he was 100 percent guaranteed to win another title No I like my rings the hard way via Candace_Parker and KristenLedlow ,171,6925,39243,46168,photo
CompanyJ_10123,Baker was fed up via clevelanddotcom ,37,1230,8715,9945,video
CompanyJ_10124,Dirk unveils Nowitzki Way to a massive crowd of Mavs fans outside the arena via townbrad ,89,1468,9638,11106,video
CompanyJ_10125, Come on LeBron give us Taco Tuesday King couldn t resist via trentblewitt IG ,78,16494,88082,104576,video
CompanyJ_10126,Ja s looking bouncy ,20,717,5973,6690,video
CompanyJ_10127,Got the Juan Soto bat flip special via howtobarber IG ,54,359,3412,3771,video
CompanyJ_10128,Chemistry clicking early New teammates Cam Reddish and De Andre Hunter teamed up to do an escape room From B R x jcpenney ,122,88,586,674,video
CompanyJ_10129,Jamal Adams was hurt the Jets listened to offers for him at the deadline The Rams don t take calls on Aaron Donald The Patriots don t take calls on Tom Brady via snyjets ,170,3705,23331,27036,video
CompanyJ_10130,This Zion illustration is unreal via joelochrisart ,51,188,2450,2638,photo
CompanyJ_10131,45 years ago today Muhammad Ali knocked out George Foreman in the Rumble in the Jungle using his rope a dope tactic ,116,1562,7979,9541,photo
CompanyJ_10132,TEN goals A last minute equalizer Liverpool wins on penalties Madness brfootball ,81,349,2255,2604,photo
CompanyJ_10133,Kyle Kuzma will make his season debut this Friday vs Dallas per ShamsCharania ,78,2923,18133,21056,photo
CompanyJ_10134,He pulled up to the game in a full Matisse Thybulle uniform via sixers ,71,2231,26509,28740,video
CompanyJ_10135,Ben didn t have to do Embiid like that ,39,289,4015,4304,video
CompanyJ_10136,Kyrie s handles will never get old ,35,5552,31036,36588,video
CompanyJ_10137,KAT and Embiid GOING AT IT Wow ,31,31709,116764,148473,video
CompanyJ_10138,Embiid was laughing at KAT after they got separated ,52,1547,9347,10894,video
CompanyJ_10139,Did Ben Simmons really put KAT in a chokehold ,46,7003,39687,46690,video
CompanyJ_10140, ,1,1941,11123,13064,photo
CompanyJ_10141,COLLIN SEXTON CAUGHT A BODY ,28,4572,22370,26942,video
CompanyJ_10142,Harden just messing with him ,29,1811,11339,13150,video
CompanyJ_10143,Kemba put Giannis on skates via celtics ,40,3526,22367,25893,video
CompanyJ_10144, ,1,647,4272,4919,video
CompanyJ_10145,ISO Harden Beard up to 54 PTS and counting ,43,1344,9019,10363,video
CompanyJ_10146,RUSS TOUGH ,11,2216,11377,13593,video
CompanyJ_10147,Beard dropped 59 PTS in the win ,32,1923,10122,12045,video
CompanyJ_10148,,0,1357,8251,9608,photo
CompanyJ_10149, ,1,5338,22442,27780,photo
CompanyJ_10150,No mercy from JoelEmbiid ,25,3133,17473,20606,photo
CompanyJ_10151,From Wild Card berth to World Series champions What a run Nationals win their first ever World Series ,102,9349,33479,42828,photo
CompanyJ_10152,That first World Series win feeling Chills via MLB ,51,2521,14010,16531,video
CompanyJ_10153,Your World Series MVP is Stephen Strasburg 2009 No 1 pick to 2019 World Series MVP ,83,2082,11685,13767,photo
CompanyJ_10154,Four champions did it for the first time ever this year Nationals Raptors Blues Mystics New faces on top everywhere ,116,1587,7334,8921,photo
CompanyJ_10155,Breaking Stephen Curry has a broken left hand per ThompsonScribe ,65,5483,20148,25631,photo
CompanyJ_10156,Get well soon StephenCurry30 ,29,6972,32282,39254,photo
CompanyJ_10157,Max Scherzer couldn t hold back the tears Congrats to the legend ,65,2268,21088,23356,video
CompanyJ_10158, World Series shower time ,26,1147,6081,7228,video
CompanyJ_10159, C H A M P S ,13,728,3793,4521,photo
CompanyJ_10160,KAT claps back NSFW ,20,7594,46164,53758,photo
CompanyJ_10161,KD gone No Klay No Steph Tough go for Warriors fans ,52,7687,38756,46443,video
CompanyJ_10162,Kyrie with the spooky handle ,29,8326,42408,50734,video
CompanyJ_10163,The best way to celebrate your team s first World Series via KelynSoong ,72,3609,20619,24228,video
CompanyJ_10164,KD kept it real ,16,921,7232,8153,photo
CompanyJ_10165,Minnesota says Ben Simmons used dangerous choke hold on Karl Anthony Towns Sixers communicated to the NBA that they believe KAT was aggressor doubled down on ref assessment that Simmons was peacemaker per wojespn ,213,505,3963,4468,photo
CompanyJ_10166,This fan couldn t believe Kyrie s gift via kevin abner IG NSFW ,63,1763,20840,22603,video
CompanyJ_10167,Soccer teams biggest fears brfootball ,38,157,1864,2021,video
CompanyJ_10168,He really jump roped on his head via headspin_trainer IG ,57,460,3196,3656,video
CompanyJ_10169, ,1,1191,7346,8537,photo
CompanyJ_10170,One year ago today D Rose exploded for an unforgettable 50 points ,66,19260,85054,104314,video
CompanyJ_10171,2019 is the year of San Diego State alumni June Kawhi Leonard Finals MVP October Stephen Strasburg World Series MVP ,116,1005,6541,7546,photo
CompanyJ_10172,Lakers in the Halloween spirit ,31,3874,22941,26815,photo
CompanyJ_10173,Jared Hefty Lefty Lorenzen broke the ground for a lot of big guys who wanted to be quarterback Inside the life and death of the former NFL QB who died from weight related issues at 38 this July ,194,146,906,1052,photo
CompanyJ_10174,Beard dropped 5 9 and Book destroyed the Dubs Hot hands all over the league last night ,87,142,1336,1478,video
CompanyJ_10175,Next generation bringing the scary dunks this season brhoops ,61,153,935,1088,video
CompanyJ_10176,Steph still all smiles ,23,578,4814,5392,photo
CompanyJ_10177,Trent Williams says he had a rare form of cancer DFSP and nearly lost his life Williams says the growth on his head was found 5 6 years ago but the Redskins medical staff diagnosed it as something minor The star tackle has no trust in the team ,244,4505,18647,23152,photo
CompanyJ_10178,Lions don t have much of a running game and the Raiders are beatable through the air Matt Stafford time dunkindonuts ,117,58,666,724,video
CompanyJ_10179,This Halloween convo between Belichick and Randy Moss will never get old via thecheckdown ,90,5738,34677,40415,video
CompanyJ_10180,Embiid and KAT suspended for 2 games for last night s fight no fine for Ben Simmons per James_HamNBCS ,102,464,3141,3605,photo
CompanyJ_10181,Simmons always got Embiid s back via SANDin_mypANTs ,52,533,6327,6860,video
CompanyJ_10182,Chuck called the Embiid KAT fight a snuggle party via NBAonTNT ,63,2955,17228,20183,video
CompanyJ_10183,Why d TB do Peyton like that ,29,2850,22137,24987,photo
CompanyJ_10184,Kenyan Drake in Miami this year Season long rush of 11 0 touchdowns Kenyan Drake s first Cardinals drive 36 yard run Touchdown Via NFL ,135,612,5953,6565,video
CompanyJ_10185,JJ Redick has won Halloween ,28,17832,93237,111069,video
CompanyJ_10186,George Kittle is a FORCE via NFL ,33,842,6521,7363,video
CompanyJ_10187,Kendrick Nunn has the most points through 1st five games by an undrafted player in NBA history with 112 Dropped 28 PTS 10 15 FG 4 6 3PT in win over Hawks tonight ,162,3381,18222,21603,video
CompanyJ_10188,Two games two scores for Emmanuel Sanders SF has its WR1 ,57,602,6818,7420,photo
CompanyJ_10189,GARY HARRIS INCOMING realchriswebber you good ,46,426,2951,3377,video
CompanyJ_10190,MPJ checks in and gets first NBA bucket in debut ,49,1624,15302,16926,video
CompanyJ_10191,Jimmy G heard all the noise about getting carried In three quarters tonight 22 28 252 yards 4 TDs 143 8 rating ,111,1741,13850,15591,photo
CompanyJ_10192,Mike Scott s He Got Game reenactment is too accurate NSFW via mikescott ,72,2808,15560,18368,video
CompanyJ_10193,Kyler s COLD Murray hooks up with Andy Isabella for 88 yard TD to cut the Niner lead to 28 25 with five minutes to go via NFL ,126,795,6442,7237,video
CompanyJ_10194,Still unbeaten Jimmy G throws four touchdowns to hold off Cardinals 28 25 as Niners move to 8 0 ,96,1148,7280,8428,photo
CompanyJ_10195,That 8 0 feeling via thecheckdown ,34,1778,22906,24684,video
CompanyJ_10196,Zion accidentally hit Jaxson Hayes in the face on this celebration Hayes decided to move seats ,95,1907,22524,24431,video
CompanyJ_10197,Kawhi handled the Spurs on both ends of the floor 38 PTS 12 REB 4 STL ,70,3075,22595,25670,video
CompanyJ_10198, Who He Play For is back Chuck wasn t ready via NBAonTNT ,57,2795,16260,19055,video
CompanyJ_10199, Are you me for Halloween A kid dressed up as Freddie Freeman and then met him via chelseafree5 ,96,5831,52055,57886,video
CompanyJ_10200,Whoops brfootball ,18,1638,14282,15920,video
CompanyJ_10201,After losing Stephen Curry the Warriors as we knew them no longer exists HowardBeck still sees a positive opportunity for this season ,134,572,4201,4773,video
CompanyJ_10202,Kawhi s son is his motivation to stay on top of postgame treatment I want to be able to play basketball with him via BenGolliver ,129,2081,21708,23789,video
CompanyJ_10203, StephenCurry30 gives brkicks an exclusive look at the Curry 7s and the story behind them I ve always felt underrated it s part of my DNA underarmour ,150,201,1461,1662,video
CompanyJ_10204,Can do over 700 keepy uppies This six year old baller is unreal brfootball ,75,2400,13553,15953,video
CompanyJ_10205,Bron on how the Lakers can stop Luka s razzmatazz hop skiddily doo via TheMulf ,79,5333,33156,38489,video
CompanyJ_10206,Inside the life of cadet athletes at Army We re doing all this practice just in case we go to war ,98,58,510,568,photo
CompanyJ_10207,Stephen Curry underwent successful surgery for his broken left hand and is expected to miss at least three months ,114,1868,11683,13551,photo
CompanyJ_10208,From potential safety to TD via getpaidlilfrank IG ,51,1020,8701,9721,video
CompanyJ_10209,Canelo s head movement makes him nearly untouchable Canelo vs Kovalev is Saturday night on DAZN_USA ,100,9300,39279,48579,video
CompanyJ_10210, TheRock seems ready for UFC 244 via ufc ,41,1411,8034,9445,video
CompanyJ_10211, MattressMack bet more than 12M on the Astros to win the World Series br_betting tracked him down and spent Game 1 with him ,124,53,367,420,video
CompanyJ_10212,Harden put the moves on Kyrie via NBATV ,40,6291,34361,40652,video
CompanyJ_10213,D Rose got MVP chants in Chicago and converted the and one ,59,9312,51337,60649,video
CompanyJ_10214,D Rose splits the defense and dunks it ,39,9825,59158,68983,video
CompanyJ_10215,Thanasis Antetokounmpo with the poster and Giannis LOVES it ,60,4892,30090,34982,video
CompanyJ_10216,KP gets the step back to go vs AD via dallasmavs ,49,465,3590,4055,video
CompanyJ_10217,TATUM GAME ,11,3589,17018,20607,video
CompanyJ_10218,Tatum s game winner is even better from this angle via nealwoodall1 ,68,6939,40905,47844,video
CompanyJ_10219,This Fox finish ,16,1170,10202,11372,video
CompanyJ_10220,Luka got LeBron with some razzmatazz hop skiddily doo via dallasmavs ,69,1953,13556,15509,video
CompanyJ_10221,Only right D Lo pulls up from Steph range in the first game without him 3 ,74,1239,12016,13255,video
CompanyJ_10222,Luka hits AD with a step back 3 Nasty via dallasmavs ,53,1068,7569,8637,video
CompanyJ_10223,ALEX CARUSO FLYING IN via NBATV ,32,7908,47946,55854,video
CompanyJ_10224,LEBRON IS LOCKED IN via NBATV ,30,13628,64391,78019,video
CompanyJ_10225,Danny Green to send it to OT BANG via NBATV ,44,7584,46351,53935,video
CompanyJ_10226,Will we witness another shocker ,32,37,801,838,photo
CompanyJ_10227,LeBron s force is undeniable ,29,6764,39461,46225,video
CompanyJ_10228,Messi scored his first Champions League goal on this day in 2005 He now holds the record for most for one club brfootball ,122,114,1220,1334,photo
CompanyJ_10229, Ronaldo s mom got something to say brfootball ,47,149,1677,1826,photo
CompanyJ_10230,Draymond s son going to the bench to talk with dad All The Feels Via NBCSWarriors ,82,3169,37546,40715,video
CompanyJ_10231,Russ a real one via HoustonRockets ,35,5547,33665,39212,video
CompanyJ_10232,Sergey Kovalev s jab is MEAN Kovalev defends his light heavyweight title vs Canelo tonight on DAZN_USA ,103,153,943,1096,video
CompanyJ_10233, ,1,3171,27942,31113,photo
CompanyJ_10234,SADIO MANE FOR THE WIN IN THE 94TH MINUTE via NBCSportsSoccer ,62,656,3066,3722,video
CompanyJ_10235,This pass is unreal via NBCSportsSoccer ,40,654,4148,4802,video
CompanyJ_10236,How d he complete this catch via CFBONFOX ,42,1185,8688,9873,video
CompanyJ_10237,Nate Diaz ready to keep fatherin all kinds of these little motherf kers tonight NSFW via ufc ,93,671,3180,3851,video
CompanyJ_10238,Christian Pulisic s fourth goal in his last two Premier League games via NBCSportsSoccer ,89,496,3975,4471,video
CompanyJ_10239,Teddy was feelin himself brgridiron via Supa_BlackGirl ,55,1750,13453,15203,video
CompanyJ_10240,A N K L E S via CFBONFOX ,25,716,5033,5749,video
CompanyJ_10241,One hand Up the sideline WHAT A CATCH via CBSSports ,52,1224,7591,8815,video
CompanyJ_10242,HAMIDOU DIALLO PLEASE CALM DOWN Broke out the windmill in the game ,67,2897,27202,30099,video
CompanyJ_10243,No 8 Bulldogs go to Florida and beat No 6 Gators 24 17 ,55,322,1672,1994,photo
CompanyJ_10244,This FIFA save via Yasser_Harthi ,33,721,4916,5637,video
CompanyJ_10245,That touch is crazy ,20,1151,12341,13492,video
CompanyJ_10246,Josh Hart pulled a Harden ,26,7862,48669,56531,video
CompanyJ_10247,Canelo knocked him out with a body punch Canelo vs Kovalev is about to be a MOVIE Watch on DAZN_USA ,100,720,4514,5234,video
CompanyJ_10248,MVP doing what he does best ,28,881,7389,8270,video
CompanyJ_10249,Evander Holyfield s son Evan just made his pro boxing debut and crushed his opponent Looking like the real deal via DAZN_USA ,125,8247,34841,43088,video
CompanyJ_10250,Jokic could ve hit the jumbotron with this much arc on the fadeaway Cashed out ,79,1912,24710,26622,video
CompanyJ_10251,Head kick KO A story in two acts by Kevin Lee ,46,835,4966,5801,photo
CompanyJ_10252,Good luck guarding Dame all the way out here ,45,4551,37769,42320,video
CompanyJ_10253,Dame is absolutely unconscious right now Flamethrower mode activated ,69,1288,11481,12769,video
CompanyJ_10254,The Rock makes his entrance at UFC244 Electrifying via ufc ,59,1791,9196,10987,video
CompanyJ_10255,Anfernee Simons CLUTCH ,23,749,6022,6771,video
CompanyJ_10256,This go ahead shot was Furkan crazy ,36,2342,14153,16495,video
CompanyJ_10257,Jorge Masvidal beats Nate Diaz by TKO doctor s stoppage going into round 4 Doctor stopped the fight due to Diaz s cut over his eye ,131,2159,8941,11100,photo
CompanyJ_10258,Nate wants to go again NSFW via ufc ,36,2179,11888,14067,video
CompanyJ_10259,Canelo is hard to hit and he hits hard via DAZN_USA ,52,1651,9907,11558,video
CompanyJ_10260,Canelo Alvarez knocks out Sergey Kovalev to become the WBO light heavyweight champion He s now a FOUR division boxing champion via DAZN_USA ,140,18126,55535,73661,video
CompanyJ_10261,Nate came for The Rock after the BMF bout via UFC NSFW ,55,2833,15212,18045,video
CompanyJ_10262,Canelo s W was punishing in slow mo via DAZN_USA ,49,2778,12706,15484,video
CompanyJ_10263,On this day in 1996 an 18 year old rookie guard made his NBA debut wearing No 8 for the Lakers He played six minutes and scored zero points Quiet start to an epic career ,170,7676,41040,48716,photo
CompanyJ_10264,Game just comes easy to LaMelo Season high 19 points in the NBL brhoops ,72,751,5624,6375,video
CompanyJ_10265,Dana White says the cuts that ended the BMF fight were much worse then they looked on TV ,89,781,5229,6010,photo
CompanyJ_10266,Seahawks were doing their due diligence on Antonio Brown before claiming Josh Gordon per AdamSchefter Russell Wilson was pushing the team to sign AB ,149,1128,7886,9014,photo
CompanyJ_10267,Big name guys have been quiet in London TheMattCamp is here to help He s revealing everything you need ahead of Week 9 s action on Your Fantasy Fire Drill Watch now and use hashtag FantasyFireDrill to ask questions ,215,11,68,79,link
CompanyJ_10268,Neymar tried to pull a LeBron brfootball ,41,549,7198,7747,video
CompanyJ_10269,Duke said WEIGHT ROOM via NFL ,30,2722,18711,21433,photo
CompanyJ_10270,Houston has had to play through it brgridiron ,46,1509,14231,15740,photo
CompanyJ_10271,Adrian Peterson will be running hard until the end of time via NFL ,67,900,7355,8255,video
CompanyJ_10272,This clip is mesmerizing via thecheckdown ,42,1940,19957,21897,video
CompanyJ_10273,Minkah Fitzpatrick in six games since the Steelers gave up a 1st round pick 25 tackles 4 picks 1 forced fumble TD via NFL ,122,2073,11893,13966,video
CompanyJ_10274,2017 NFL Draft Browns Myles Garrett Bears after trading up Mitch Trubisky Chiefs Mahomes Texans Deshaun ,104,2817,17638,20455,photo
CompanyJ_10275,Vintage Adrian Peterson today This man is too strong via Redskins ,66,1017,7946,8963,video
CompanyJ_10276,Midnight Madness at Sierra Canyon was on another level brhoops ,63,631,4638,5269,video
CompanyJ_10277,DJ Moore did everything on this play Bobbled the ball Made the catch Got his feet down Showed the ref where he toe tapped via NFL ,130,351,2638,2989,video
CompanyJ_10278,Tyreek was the only one catching Damien Williams on this 91 yard TD via Chiefs ,79,5576,36115,41691,video
CompanyJ_10279,Panthers hosted 21 pediatric cancer patients and waved to them during the game via NFL ,87,542,4183,4725,photo
CompanyJ_10280,C MAC GOES 5 8 FOR HIS 3RD TOUCHDOWN via NFL ,45,767,5731,6498,video
CompanyJ_10281,Dolphins after beating the Jets while tanking brgridiron ,57,2665,20982,23647,photo
CompanyJ_10282,COURTLAND SUTTON TURNED INTO RANDY MOSS via NFL ,48,1571,10366,11937,video
CompanyJ_10283,Daryl Worley with one hand Wild via thecheckdown ,49,653,4599,5252,video
CompanyJ_10284,Panthers dedicated their win to LB Mario Addison whose brother was killed in a shooting last weekend via Panthers ,114,1042,9011,10053,video
CompanyJ_10285, ,1,6453,30229,36682,photo
CompanyJ_10286,Odell making it look too easy via thecheckdown ,47,5275,42151,47426,video
CompanyJ_10287,Messi and Ronaldo finally sit down for dinner together Catch the new episode of The Champions early exclusively in the B R app PlayStation ,139,128,1170,1298,video
CompanyJ_10288,This Bron pass ,15,3476,23906,27382,video
CompanyJ_10289,Browns fans after falling to 2 6 brgridiron ,44,1012,7952,8964,photo
CompanyJ_10290,That Dwight AD connection ,26,2498,21594,24092,video
CompanyJ_10291, FOX ,5,730,4988,5718,video
CompanyJ_10292,Lamar TD Too easy via NFL ,26,1217,9154,10371,video
CompanyJ_10293,Fox put on a show at The Garden ,32,1040,8219,9259,video
CompanyJ_10294,Lamar faked out the skycam via thecheckdown ,44,612,6800,7412,video
CompanyJ_10295,They let Snoop Dogg do the Lakers play by play ,47,13788,58538,72326,video
CompanyJ_10296,FLEX ON EM DWIGHT ,18,1653,10451,12104,video
CompanyJ_10297, Body built by Taco Bell Legend via thecheckdown ,49,2723,13691,16414,video
CompanyJ_10298,Lakers have won five straight games and sit atop the Western Conference standings at 5 1 Lookout ,97,11151,58198,69349,photo
CompanyJ_10299,Brady Perfect throw White Perfect catch via SNFonNBC ,53,431,3426,3857,video
CompanyJ_10300,Kawhi too smooth with it ,25,3462,30227,33689,video
CompanyJ_10301,Ravens scoop up Edelman s fumble for 6 70 yard return via NFL ,62,587,4466,5053,video
CompanyJ_10302,Lamar Incredible via NFL ,25,3833,24323,28156,video
CompanyJ_10303,EARL THOMAS PICKS OFF BRADY via NFL ,36,800,6977,7777,video
CompanyJ_10304,Lamar picking the Pats D apart by himself via NFL ,50,1148,10001,11149,video
CompanyJ_10305,Lamar with ANOTHER rushing TD Ravens go up 37 20 on New England via SNFonNBC ,77,600,4239,4839,video
CompanyJ_10306,Lamar and the Ravens hand the Pats their first loss of the season brgridiron ,77,12590,67133,79723,photo
CompanyJ_10307,The last undefeated team in the NFL ,36,2419,14747,17166,photo
CompanyJ_10308,Brady and Lamar hug it out postgame Respect via Ravens ,55,1133,13281,14414,video
CompanyJ_10309,The KLAW Wow via NBA ,21,7737,55090,62827,video
CompanyJ_10310,Colin Kaepernick turned 32 on Sunday He spent the day handing out food and supplies to the homeless in Oakland Respect via TMZ_Sports yourrightscamp ,149,9701,50572,60273,video
CompanyJ_10311, brgridiron ,12,425,4522,4947,photo
CompanyJ_10312,Fans made sure the Red River Rivalry was as heated at the tailgate as it was on the field Wendys ,97,29,379,408,video
CompanyJ_10313,This dragon tifo is unreal via ADSportsTV ,42,555,3440,3995,video
CompanyJ_10314,Lamar told Brady he s the GOAT postgame via Ravens ,51,1953,17468,19421,video
CompanyJ_10315,Frank Gore is a true OG Bills vet made sure Adrian Peterson took time to talk with rookie RB Devin Singletary via thadbrown7 ,125,18049,108180,126229,video
CompanyJ_10316, ,1,2123,18074,20197,photo
CompanyJ_10317,Went between the legs and then top shelf via NCAAIceHockey ,59,495,4697,5192,video
CompanyJ_10318,Dez Bryant pulled up to interview the Lakers and Boogie was caught off guard What questions you got Man get the f k outta here via fanaticsview ,144,2761,16855,19616,video
CompanyJ_10319, Yeah run away like you ran away from La Liga Messi and Ronaldo have the most awkward dinner ever TheChampions Playstation ,123,450,2189,2639,video
CompanyJ_10320,AD still thinks Chicago is the Mecca of basketball They say New York but it s not even close via E_Woodyard ,108,1502,11748,13250,video
CompanyJ_10321,Kyrie Irving gives brkicks an exclusive look at the Kyrie 6 on the newest Unboxed ,82,428,2145,2573,video
CompanyJ_10322,KD and Kyrie weren t impressed with Temple s dunk ,50,2019,19243,21262,video
CompanyJ_10323,THERE S JA ,11,3683,22342,26025,video
CompanyJ_10324,KD s face after that Kyrie move ,32,3520,26332,29852,video
CompanyJ_10325,GOLDEN TATE ARE YOU KIDDING ME via thecheckdown ,48,9479,65803,75282,video
CompanyJ_10326,Cat ran on the field and found the end zone via Giants ,55,1452,8679,10131,video
CompanyJ_10327,Kevin Harlan did a play by play of the cat on the field via ChasingSnyder ,74,500,2992,3492,video
CompanyJ_10328,BI WAS HOOPIN 40 PTS career high 17 24 FG 5 REB 5 AST ,54,5171,28662,33833,video
CompanyJ_10329,OG and next up Brodie s got Ja ,31,3558,30606,34164,video
CompanyJ_10330,Dak Amari Touchdown Cowboys trying to leave NY with a W via NFL ,64,694,4371,5065,video
CompanyJ_10331,Harden with the step back dagger Ice cold From B R x coorslight ,64,673,4248,4921,video
CompanyJ_10332,MVP chants for D Book tonight 40 PTS 15 19FG 4 REBS Suns are 5 2 and just handed the Sixers their first L of the season ,120,9393,52507,61900,video
CompanyJ_10333,Rookie big man Eric Paschall went 3 3 from deep in the first quarter From B R x UnderArmour ,92,221,2389,2610,video
CompanyJ_10334,Warriors rookie epaschall has dropped 61 total points in his last two games After being drafted in the second round back in June spidadmitchell let him know he deserved to be in the league NSFW via CAA_Basketball ,213,1380,10383,11763,video
CompanyJ_10335,Their cats ran over to watch the MNF cat via Brat1st ,53,4633,33237,37870,video
CompanyJ_10336,The Champions League is back again brfootball ,46,213,1595,1808,photo
CompanyJ_10337,NBA is suspending John Collins 25 games without pay for violating the league s Anti Drug policy Hawks big man tested positive for a growth hormone ,147,1084,5714,6798,photo
CompanyJ_10338,Ice Trae is back tonight ,25,4086,27531,31617,video
CompanyJ_10339,IT after his first start The Wizards looked me in the eye and told me they would give me an opportunity via washwizards ,120,2342,21895,24237,video
CompanyJ_10340,This strike Still unreal via brlive ,36,552,4726,5278,video
CompanyJ_10341,C Mac is on pace for an all time RB season brgridiron ,54,1551,9546,11097,photo
CompanyJ_10342,Oregon has a collapsible toilet on the sideline for the players via jcmack03 ,77,6720,57917,64637,video
CompanyJ_10343,JR s a Cowboys fan and went wild roasting everybody after they beat the Giants via TheRealJRSmith ,98,940,5423,6363,video
CompanyJ_10344,The Beard passes The Answer ,28,544,4118,4662,photo
CompanyJ_10345,Messi turned up in a sweater covered in crowns brfootball ,58,316,4386,4702,video
CompanyJ_10346,Breaking Cam Newton has been placed on IR and is out for the season ,68,1513,9259,10772,photo
CompanyJ_10347,What a goal this would ve been from Messi brfootball ,53,277,3193,3470,video
CompanyJ_10348,Dwight Howard s second stint in LA is exactly what Superman needed ,67,2208,17584,19792,video
CompanyJ_10349,Still got the header brfootball ,32,113,1286,1399,video
CompanyJ_10350,When Slavia Prague was drawn into the UCL Group of Death they actually laughed They just held Barcelona scoreless at the Camp Nou ,130,194,1848,2042,video
CompanyJ_10351,Dak has been lights out against the Giants CampbellsChunky ad ,62,110,705,815,video
CompanyJ_10352,Ziyech s assist Pinpoint brfootball ,36,223,1667,1890,video
CompanyJ_10353,OH MY HAKIM ZIYECH ,19,5622,25858,31480,video
CompanyJ_10354,Off the face ,13,634,4998,5632,video
CompanyJ_10355,OBJ came in and changed the game Happy 27th to one of football s most gifted ,77,2261,14343,16604,photo
CompanyJ_10356,Two red cards two goals and a disallowed goal in a span of 10 minutes alone ,76,497,3388,3885,photo
CompanyJ_10357, Two goals in the first four minutes Two red cards at the same time Eight goals total Chelsea come back from 4 1 to draw 4 4 Chelsea Ajax was box office brfootball ,164,416,2146,2562,photo
CompanyJ_10358,Wentz takes Foles under his wing to help him get his Big Nick Energy back PlayStation GridironHeights ,102,947,3875,4822,video
CompanyJ_10359, TiffanyHaddish went full Kawhi when she met celebrity crush Leonardo DiCaprio What it do baby SamsungMobileUS Watch the latest How Hungry Are You with SergeIbaka ,163,122,803,925,video
CompanyJ_10360,5 star guard Cade Cunningham has verbally committed to Oklahoma State brhoops ,78,616,3576,4192,photo
CompanyJ_10361,Kawhi Leonard is out tomorrow vs the Bucks due to load management ,66,707,6953,7660,photo
CompanyJ_10362,Bulls trolled LeBron with a person dressed as a taco during introductions via kylegoon ,87,735,6567,7302,video
CompanyJ_10363,Jordan Nwora one handed oop via accnetwork ,43,472,3286,3758,video
CompanyJ_10364,Shai put the moves on T Ross ,29,668,5546,6214,video
CompanyJ_10365,PJ Washington stared him down after the nasty poster ,53,427,3075,3502,video
CompanyJ_10366,Scary Terry s step back got MJ out of his seat ,47,857,7807,8664,video
CompanyJ_10367,Gordon Hayward is officially back 39 PTS career high 8 AST 7 REB ,65,3141,21206,24347,video
CompanyJ_10368,First CFP rankings Did they get it right ,41,392,2335,2727,photo
CompanyJ_10369,Trae is just RIDICULOUS ,24,11647,66405,78052,video
CompanyJ_10370,DWIGHT DOING IT ALL Bron loving it ,35,4655,26268,30923,video
CompanyJ_10371, Name a more dynamic duo ,25,9397,72827,82224,video
CompanyJ_10372,Bron was on a tear during the Lakers road trip At Mavs 39 PTS 16 AST 12 REB At Spurs 21 PTS 13 AST 11 REB At Bulls 30 PTS 11 AST 10 REB All wins Year 17 ,153,12086,52773,64859,photo
CompanyJ_10373,The win wasn t enough for DwightHoward ,39,2014,21416,23430,video
CompanyJ_10374,MPJ checked in late and made the most of his first Nuggets home game ,69,684,8268,8952,video
CompanyJ_10375,No 2 Kentucky upsets No 1 Michigan State 69 62 Tyrese Maxey freshman 26 PTS 5 REB ,82,2032,12645,14677,photo
CompanyJ_10376,Kentucky freshman TyreseMaxey iced the game at MSG to beat No 1 MSU in front of John Wall brhoops NSFW ,103,1405,11082,12487,video
CompanyJ_10377,Bounced around different teams since 2016 Struggled with injuries for most of 2018 19 Traded by the Wizards and then waived by the Grizzlies And now Dwight Howard is looking like his old self with the Lakers ,208,2631,21933,24564,photo
CompanyJ_10378,Took on the entire team and then skied it via brfootball ,57,444,6125,6569,video
CompanyJ_10379,Texas guard Andrew Jones played real minutes last night for the first time since being diagnosed with leukemia in January 2018 20 points career high 8 13 FG 4 5 3PT I can t even explain the feeling ,198,5318,36221,41539,photo
CompanyJ_10380,The ball boy got to join Arsenal for their warm up via Arsenal ,63,257,3493,3750,video
CompanyJ_10381, Yeah they re screwed Rams punter JHekker shows realtuffjuice AdamLefkoe and SNL alum TaranKillam how hard it is to catch punts in the NFL New Ditch the Playbook StateFarm ,172,70,540,610,video
CompanyJ_10382,Kylian Mbappe s been a problem since returning from injury brfootball ,70,162,2108,2270,photo
CompanyJ_10383,Some teams believe that if the Browns struggles spill into next year OBJ could get traded again per mikefreemanNFL ,115,464,3260,3724,photo
CompanyJ_10384,Bron s been locking up on defense this year ,44,11451,60993,72444,video
CompanyJ_10385,This assist was too good ,25,194,1966,2160,video
CompanyJ_10386,Kid saw his opportunity and took it ,36,973,10839,11812,video
CompanyJ_10387,KD getting healthy via Krisplashed ,35,822,5505,6327,video
CompanyJ_10388,Former NBA stars are coaching the next generation ,50,639,4946,5585,video
CompanyJ_10389,Bill Polian infamously said Lamar should play WR Since 12 3 as starter 28 total TDs 4 346 total yards Youngest QB to start playoff game Youngest with perfect passer rating No 1 scoring offense 2019 Beat undefeated Patriots brgridiron ,234,3047,13726,16773,photo
CompanyJ_10390,Douglas Costa got past everyone to score the last minute winner brfootball ,75,1253,8387,9640,video
CompanyJ_10391,18 year old Rodrygo scored TWICE for Real Madrid in the first seven minutes brfootball ,87,725,4844,5569,video
CompanyJ_10392,What just happened ,19,2508,16859,19367,video
CompanyJ_10393,On Sunday Heung min Son left the field in tears after seriously injuring Everton s Andre Gomes When Son scored today his celebration was respectful brfootball ,159,1315,12045,13360,video
CompanyJ_10394,Ederson was subbed off and Claudio Bravo got a red card so Manchester City are finishing with Kyle Walker a defender in goal via brlive ,136,638,3906,4544,video
CompanyJ_10395,18 years old Champions League hat trick Rodrygo is the real deal brfootball ,76,1029,6879,7908,photo
CompanyJ_10396,LaVine throws down 360s like it s nothing ,42,1234,12031,13265,video
CompanyJ_10397,Caruso jokes LeBron injures him every time they chest bump He doesn t understand the physics of that He s got like 60 80 pounds on me via Lakers ,145,5902,49866,55768,video
CompanyJ_10398,Checking in on the Wizards ,27,172,2206,2378,video
CompanyJ_10399,She really looks like Trevor Lawrence bellamartinaaaa tiktok ,61,3060,23670,26730,video
CompanyJ_10400,Cole Anthony showed out in his UNC debut 34 PTS 11 REB 5 AST No 9 UNC held off Notre Dame 76 65 brhoops ,104,6299,30463,36762,photo
CompanyJ_10401,Andre Drummond didn t know how to react ,40,447,5629,6076,video
CompanyJ_10402,ABSOLUTE CHAOS to end AEW AEWDynamite via AEWonTNT h t BRWrestling ,67,87,669,756,video
CompanyJ_10403,Aaron Gordon got called for B2B offensive fouls in crunch time ,63,583,5658,6241,video
CompanyJ_10404,H Town ,7,1756,14678,16434,photo
CompanyJ_10405,You can t do that Bledsoe ,26,1950,12743,14693,video
CompanyJ_10406,Giannis 4 7 was feeling it from 3PT land tonight ,49,1061,9408,10469,video
CompanyJ_10407,Which one is worse ,19,12117,68156,80273,video
CompanyJ_10408,Greek Freak making more history ,32,1795,11957,13752,photo
CompanyJ_10409,Kalin Bennett s first bucket for Kent State He becomes the first player with autism to score in a D1 game via MitchMeyersTV ,124,17939,84818,102757,video
CompanyJ_10410,Four months after leaving for Boston Kemba Walker makes an emotional return to Charlotte tonight ,97,3388,18189,21577,video
CompanyJ_10411,OKAY RJHampton14 brhoops via NBL ,33,152,1459,1611,video
CompanyJ_10412,Shoot your shot kid ,20,3488,35521,39009,video
CompanyJ_10413,Nate Diaz squashed the rematch talk fast ,41,663,5066,5729,photo
CompanyJ_10414,Steve Clifford on the load management debate Michael used to tell them every year you re paid to play 82 games per SBondyNYDN ,126,1461,8433,9894,photo
CompanyJ_10415,6 3 363 lbs And in sixth grade via big73miller ,47,2522,17071,19593,video
CompanyJ_10416,Double header game winner via RichieCozz ,41,234,3006,3240,video
CompanyJ_10417,Lamar s leadership Ravens QB ran in to help both of his linemen up via thecheckdown ,84,4761,44438,49199,video
CompanyJ_10418,CMC is poised to go OFF this Sunday YahooFantasy ,49,38,478,516,video
CompanyJ_10419,Anthony Martial had EVERYBODY sliding via brlive ,49,764,5703,6467,video
CompanyJ_10420,Bron s feeling GOOD right now via Lakers ,41,2997,23195,26192,video
CompanyJ_10421,Kings star swipathefox talks trash and goes 1v1 with four time Call of Duty champ Censor during a game of Black Ops 4 Swipa held his own Battlestations Watch the full episode ,175,71,600,671,video
CompanyJ_10422, I have no clue Raiders Johnathan Abram tried his luck at That s My Guy ,72,61,595,656,video
CompanyJ_10423,Throw up the DezBryant is putting in work for the NFL comeback via drobalwayzopen ,82,1338,10251,11589,video
CompanyJ_10424,NBA has fined Clippers 50K for Doc Rivers statements on Kawhi Leonard s health status per wojespn ,98,444,3755,4199,photo
CompanyJ_10425, Suck it Lefkoe Rams punter JHekker roasted AdamLefkoe for losing in a punt catching competition StateFarm ,107,67,608,675,video
CompanyJ_10426,Welcome back SHAQ via NBAonTNT ,31,1490,13210,14700,video
CompanyJ_10427,Kemba Walker gets a standing ovation in his return to Charlotte ,64,1852,16712,18564,video
CompanyJ_10428, You didn t know I had that kind of swag did you Ravens DC Don Wink Martindale is a legend ,91,3704,19817,23521,video
CompanyJ_10429,Rivers might want to stop throwing near Erik Harris Oakland safety s second pick of the 1st quarter goes back to the house 6 Via NFL ,133,444,2994,3438,video
CompanyJ_10430,CODY MARTIN POSTER ,19,738,4226,4964,video
CompanyJ_10431,Dejounte out here making ridiculous shots ,42,876,8950,9826,video
CompanyJ_10432,Melvin Gordon looking like Melvin Gordon again At half vs Raiders 16 touches 96 yards TD ,89,297,3823,4120,photo
CompanyJ_10433,Jimmy Butler lost a shoe and still got the and 1 ,49,1058,10942,12000,video
CompanyJ_10434,Kemba showing love to every player on the Hornets postgame Respect ,67,641,7069,7710,video
CompanyJ_10435,Not your normal rookie Josh Jacobs scores the go ahead touchdown with one minute to go vs the Chargers ,103,420,3883,4303,photo
CompanyJ_10436,More than half the season is done The Raiders are over 500 ,59,571,6620,7191,photo
CompanyJ_10437,Coach Prime Deion Sanders has emerged as a candidate for the head coaching job at Florida State per RapSheet and MikeGarafolo ,126,2362,13156,15518,photo
CompanyJ_10438,Anfernee Simons has taken over the 4Q ,38,685,6287,6972,video
CompanyJ_10439,Pat Bev on Dame Relentless ,27,1454,13484,14938,video
CompanyJ_10440, SWEET LOU ,11,1025,8366,9391,video
CompanyJ_10441,Hassan Whiteside responded to Shaq and Chuck s comments from halftime I expect Shaq to diss Dame killed him in a rap battle We ain t going to hear anything positive from Shaq ever again via BenGolliver ,202,1033,9246,10279,video
CompanyJ_10442,Kawhi s shirt was made by students at the LA and Moreno Valley schools where he donated a million backpacks ,108,9701,67968,77669,photo
CompanyJ_10443, swipathefox games every day but you won t catch him playing 2K Watch Battlestations ,85,124,1266,1390,video
CompanyJ_10444,Jimmy isn t here for the video bombs ,37,1830,15792,17622,video
CompanyJ_10445,Shaq showed no mercy for Charles Barkley via NBAonTNT ,54,11430,60521,71951,video
CompanyJ_10446,Can you catch a punt AdamLefkoe realtuffjuice and SNL alum TaranKillam learned how hard it is in the NFL StateFarm ,115,33,322,355,video
CompanyJ_10447,Kendrick Nunn has been making a strong case for ROY in Miami ,61,1869,12762,14631,video
CompanyJ_10448,The Warriors had their time Now the league wants revenge It got old with the antics Now that they ve come back to reality you want to beat the hell out of them and see Steph with that towel over his head in the fourth ,218,1359,8437,9796,photo
CompanyJ_10449,Skylar Diggins is back to playing the game she loves In her third game since becoming a mom she dropped 19 PTS 6 AST 4 REB for Team USA via usabasketball ,154,850,7097,7947,video
CompanyJ_10450,James Harden on load management Even if I m a little banged up I try to push through to a certain extent Have you ever seen me not play because of load management via mshap2 ,174,1179,8785,9964,video
CompanyJ_10451,The King has been goat d in LA via ButlerTheBully ,50,8572,52154,60726,video
CompanyJ_10452, Melo is ready ,15,1420,8480,9900,photo
CompanyJ_10453,Stephen Curry unlikely to play the remainder of the season per B R s RicBucher ,79,2821,13646,16467,photo
CompanyJ_10454,Putting Kenny Omega through glass tables Barbed Wire Bats JonMoxley is bringing the chaos to his unsanctioned match at AEWrestling Full Gear BRWrestling ,153,103,616,719,video
CompanyJ_10455,These goals were recreated on FIFA and it s on point brfootball ,64,302,2299,2601,video
CompanyJ_10456, SergeIbaka would rather drink cricket tea than talk about his breakup with Keri Hilson New How Hungry Are You SamsungMobileUS ,127,349,1666,2015,video
CompanyJ_10457,Breaking NCAA has ruled Memphis James Wiseman ineligible ,57,1313,6658,7971,photo
CompanyJ_10458,James Wiseman will be able to play tonight after judge rules to put hold on NCAA s ineligibility ruling pending further litigation per mgiannotto munzly ,153,854,3313,4167,photo
CompanyJ_10459,Nobody in sports is touching swipathefox in CoD Battlestations ,63,84,1157,1241,photo
CompanyJ_10460,KAT flew in to send this shot toward the seats ,47,287,3565,3852,video
CompanyJ_10461,De Aaron Fox threw that DOWN ,29,3873,25796,29669,video
CompanyJ_10462,CASSIUS STANLEY via accnetwork ,31,3334,20777,24111,video
CompanyJ_10463,Siakam s spin was too much for Josh Hart ,41,406,3575,3981,video
CompanyJ_10464,That s all she wrote via ScottCoker ,36,949,4522,5471,video
CompanyJ_10465,Rui Hachimura was HYPED after dropping the hammer ,50,301,2662,2963,video
CompanyJ_10466,FRANK TRIED IT ON KP ,21,308,2680,2988,video
CompanyJ_10467,Logo D Lo 31 points in 3 quarters ,34,1074,9774,10848,video
CompanyJ_10468,Embiid said ,12,604,5476,6080,video
CompanyJ_10469,Dame pulls up from wherever he wants against whoever he wants ,62,940,8513,9453,video
CompanyJ_10470,DLO CLUTCH Career high 45 PTS ,30,2138,14769,16907,video
CompanyJ_10471,WIGGINS PUTTING THE T WOLVES ON HIS BACK ,41,730,5101,5831,video
CompanyJ_10472,AD s move was so good Dwight had to do his own version ,55,2583,23571,26154,video
CompanyJ_10473,James Johnson got out of Alex Caruso s way REAL quick ,54,9679,60829,70508,video
CompanyJ_10474,JOKIC FOR THE WIN ,18,1757,9860,11617,video
CompanyJ_10475,Caruso Bron Bron Caruso Caruso Bron for two points ,51,2439,22543,24982,video
CompanyJ_10476,BOJAN CALLED GAME ,18,2488,12869,15357,video
CompanyJ_10477,LeBron had the lane wide open ,30,2941,23976,26917,video
CompanyJ_10478,Dame 5 0 ,9,932,8094,9026,video
CompanyJ_10479,Kyrie is lethal from this spot on the court ,44,699,6243,6942,video
CompanyJ_10480,Dame dropped 60 D Lo dropped 52 But they both lost ,51,9201,61339,70540,photo
CompanyJ_10481,1 000 career 20 point games for the ,36,2417,17933,20350,photo
CompanyJ_10482,Lakers are undefeated 7 0 when Alex Caruso plays Legit hooper and difference maker for LA ,90,8417,50659,59076,photo
CompanyJ_10483,No slowing down cpulisic_10 He s got five goals in three Premier League games brfootball ,89,315,3088,3403,photo
CompanyJ_10484,Pulisic had him sliding via NBCSportsSoccer ,44,161,1877,2038,video
CompanyJ_10485,OSU DE Chase Young to be suspended four games tied to monetary value of what he received in 2018 per KirkHerbstreit He could potentially be the No 1 pick in the 2020 NFL draft ,176,353,1889,2242,photo
CompanyJ_10486,Season high 24 points for MELOD1P Whether it s a behind the back pass or pulling up from deep LaMelo been in his bag via NBL ,125,1062,6108,7170,video
CompanyJ_10487,Pulisic brought the dance moves overseas too Via ChelseaFC ,59,400,4123,4523,video
CompanyJ_10488,Unlimited bounce in game from JalenRomande Via HomeTeamHoops ,61,3432,19847,23279,video
CompanyJ_10489,ROW THE BOAT Minnesota scores again via BigTenNetwork ,54,280,2891,3171,video
CompanyJ_10490,Dwight Howard thinking about a return to the Dunk Contest in 2020 I have thought about it but winning the championship is the most important thing I m getting my legs back per TMZ_Sports ,187,630,7292,7922,photo
CompanyJ_10491,Minnesota fans seeing 24 13 halftime lead Tanner Morgan 10 12 for 240 yards 3 TDS 0 INT Antoine Winfield Jr with 2 INTs ,120,226,2454,2680,photo
CompanyJ_10492,Gus Johnson has lost all interest in this Ohio State blowout via CFBONFOX ,74,928,8896,9824,video
CompanyJ_10493,They went up the court and got the bucket without laying a finger on the ball or letting it touch the ground via hfm17 nock kortuh aria eskandari5 IG ,150,8479,52746,61225,video
CompanyJ_10494,No words just watch via ufc ,28,7397,28214,35611,video
CompanyJ_10495,These comparisons for the Minnesota linemen ,44,1158,12293,13451,photo
CompanyJ_10496,Tigers Crimson Tide SEC West foes take center stage ,52,168,1143,1311,photo
CompanyJ_10497,Penn State s playoff hopes before playing Minnesota vs after playing Minnesota ,79,992,7397,8389,photo
CompanyJ_10498,Coach had to drop and break the hammer after the team won their championship via KropFBTwitr ,93,96,872,968,video
CompanyJ_10499,LSU forces the Tua fumble on 3rd amp goal via CBSSports ,56,346,2195,2541,video
CompanyJ_10500,Burrow Chase LSU strikes first via CBSSports ,45,549,2676,3225,video
CompanyJ_10501,LSU defense is giving Tua issues via CBSSports ,47,204,1442,1646,video
CompanyJ_10502, WADDLE HOUSE CALL via CBSSports ,33,1510,7987,9497,video
CompanyJ_10503,Blake Griffin lower body to make his season debut on Monday vs Minnesota after missing first 10 games per wojespn ,114,333,3444,3777,photo
CompanyJ_10504,TUA DIME via CBSSports ,23,326,2440,2766,video
CompanyJ_10505,Thaddeus Moss living up to the name on the back of his jersey Randy has to be proud of his kid via CBSSports ,109,2809,15873,18682,video
CompanyJ_10506,Same energy ,12,1243,8535,9778,photo
CompanyJ_10507,Najee Harris body control on this TD catch Incredible via CBSSports ,68,345,2452,2797,video
CompanyJ_10508,Gordon Hayward suffered a fractured left hand vs Spurs ,55,533,3951,4484,photo
CompanyJ_10509,Bama on their way back ,23,233,1361,1594,photo
CompanyJ_10510,Everything clicking for the Roll Tide late via CBSSports ,57,109,817,926,video
CompanyJ_10511,LSU wouldn t be denied Tigers answer right back via CBSSports ,62,390,2114,2504,video
CompanyJ_10512,DEVONTA SMITH IS A BURNER Game isn t over yet via CBSSports ,60,652,3672,4324,video
CompanyJ_10513,Tigers pick up their biggest win of the year in Tuscaloosa ,59,1862,10516,12378,photo
CompanyJ_10514,Tide came close ,16,196,2211,2407,photo
CompanyJ_10515,Joe Burrow might have locked up the Heisman against Bama 31 39 for 393 yards 3 TDs 0 INTs Led No 2 over No 3 Bama 46 41 on the road ,132,4202,20697,24899,photo
CompanyJ_10516,Coach O says Joe Burrow is one of the best LSU s ever had after big time win over No 3 Bama via CBSSports ,106,1158,8369,9527,video
CompanyJ_10517,Malik Monk EMPHATIC ,20,6275,40403,46678,video
CompanyJ_10518,CeeDee over three defenders Can t stop this guy via CFBONFOX ,61,644,4367,5011,video
CompanyJ_10519,Man of the hour ,16,1033,10432,11465,photo
CompanyJ_10520,HAMIDOU DIALLO WAS OUT TO END MARQUESE CHRISS ,46,2180,13625,15805,video
CompanyJ_10521,Dion Waiters had a panic attack during Heat flight to Los Angeles after taking an edible per WindhorstESPN wojespn ,115,4106,24125,28231,photo
CompanyJ_10522,Harden took over vs the Bulls in the Rockets 117 94 win 42 PTS 10 REB 9 AST Poured in nine 3 pointers ,102,1219,8169,9388,video
CompanyJ_10523,LSU spun out of Alabama s grasp to take home the W From B R X exxonmobil ,73,1450,10620,12070,video
CompanyJ_10524,Liverpool vs Manchester City The undefeated Premier League leaders vs the back to back champions brfootball ,108,112,945,1057,photo
CompanyJ_10525,Cam Newton returning to the Panthers next year is highly unlikely per RapSheet A trade involving the former MVP appears to be the most likely option ,149,2593,14382,16975,photo
CompanyJ_10526,52 free kick goals 34 La Liga hat tricks 8 goals in 7 league games this season Leo Messi is a cheat code brfootball ,116,204,1758,1962,photo
CompanyJ_10527, You re working so hard This dad was brought to tears when the family got him tickets to a Packers game via brockdickerson0 ,124,1404,12262,13666,video
CompanyJ_10528,This post win moment between LSU s Clyde Edwards Helaire and his father They said you wasn t no running back YOU SHOWED EM via CodyWorsham ,139,6089,45358,51447,video
CompanyJ_10529,Antonio Brown is not expected to play again this season per adamschefter If AB got a contract offer the league would be prepared to put him on the commissioner s exempt list ,174,357,2569,2926,photo
CompanyJ_10530,14 6 PTS 6 AST 6 9 REB through 9 games LaMelo s got eyes on No 1 brhoops ,73,516,4650,5166,photo
CompanyJ_10531,The fantasy playoff hunt is upon us TheMattCamp is dishing on everything you need to know ahead of NFL Week 10 Watch Your Fantasy Fire Drill and use hashtag FantasyFireDrill to ask questions ,191,14,65,79,link
CompanyJ_10532,WHAT A GOAL Liverpool with the early lead over Manchester City via NBCSportsSoccer ,83,395,2256,2651,video
CompanyJ_10533,The cross from Robertson The finish from Salah Liverpool on fire via NBCSportsSoccer ,85,342,1921,2263,video
CompanyJ_10534,Load management in the NFL RB Shady McCoy is inactive because this is a predetermined rest week and the Chiefs want him fresh down the stretch per JamesPalmerTV ,161,199,1768,1967,photo
CompanyJ_10535, Beat the reigning champions Undefeated through 12 8 points clear at the top of the table Catch Liverpool if you can brfootball ,128,142,553,695,video
CompanyJ_10536,Pep Guardiola thanking the refs after Manchester City is denied two VAR calls in their loss to Liverpool via NBCSportsSoccer ,125,376,2601,2977,video
CompanyJ_10537,Browns had eight chances to score from the goal line Bills stopped them ALL EIGHT TIMES via thecheckdown ,105,2698,25294,27992,video
CompanyJ_10538,Lamar to RGIII Ravens offense is so dangerous via NFL ,54,1977,15382,17359,video
CompanyJ_10539,Child s play for LJ vs the Bengals today 10 10 171 yards 2 TD ,62,844,6563,7407,photo
CompanyJ_10540,Larry Fitz forever via NFL ,27,735,5149,5884,video
CompanyJ_10541, GIMME THAT Jamal Adams via nyjets ,35,1667,8791,10458,video
CompanyJ_10542,Lamar Jackson is a superhero via NFL ,37,27564,98938,126502,video
CompanyJ_10543,Lamar s 47 yard TD run is longer than these backs longest runs this year brgridiron __________________ Zeke Kamara Lindsay Gurley Gordon Conner Le Veon Ekeler Aaron Jones AP Michel Gore Singletary Freeman via Ravens ,216,2562,13107,15669,video
CompanyJ_10544,Lamar Jackson today 15 17 223 passing yards 65 rushing yards 4 total touchdowns Perfect passer rating Run of the year Electrifying ,131,6707,34681,41388,photo
CompanyJ_10545,The MVP is back and he s making jump passes Mahomes is ridiculous via thecheckdowns ,84,1539,12761,14300,video
CompanyJ_10546,It s a new era Lj_era8 via Ravens ,34,3188,22745,25933,video
CompanyJ_10547,Even on the road Lj_era8 is getting MVP chants brgridiron via Ravens ,69,1131,10950,12081,video
CompanyJ_10548,JARVIS CLUTCH via NFL ,22,391,2933,3324,video
CompanyJ_10549,THE TITANS Ryan Tannehill marches down the field for a game winning touchdown to beat the Chiefs ,97,1297,7396,8693,video
CompanyJ_10550,BLOCKED KICK TITANS BEAT THE CHIEFS via NFL ,44,729,4636,5365,video
CompanyJ_10551,Dion Waiters suspended by team for 10 games without pay after edible incident Thursday night per ShamsCharania ,111,745,4617,5362,photo
CompanyJ_10552,Birds of a feather brgridiron Lj_era8 MichaelVick ,50,2185,12658,14843,photo
CompanyJ_10553,Rodgers caught the flag after the Panthers were called for roughing the passer via NFLonFOX ,92,1077,11898,12975,video
CompanyJ_10554,Lamar s run will live on campbellschunky ad ,44,136,1250,1386,video
CompanyJ_10555,Run had NO chance against Gerald McCoy via Panthers ,52,430,3595,4025,video
CompanyJ_10556, Almost stuck the landing via FOXSports ,40,828,5416,6244,video
CompanyJ_10557,Joe Haden gave the ball to his wife in the stands after coming up with the INT via steelers ,92,700,9812,10512,video
CompanyJ_10558,MSU holds a moment of silence for Cassius Winston s brother Zachary who died last night Cassius will play tonight via BigTenNetwork ,132,3183,20136,23319,video
CompanyJ_10559, ,1,851,11264,12115,photo
CompanyJ_10560, Fake to Cook Cousins lob Rudolph one handed catch TD via NFL ,62,321,3220,3541,video
CompanyJ_10561,Cowboys announced the cat as a starter tonight via dallascowboys ,65,1461,8478,9939,video
CompanyJ_10562,Kyrie too crafty ,17,2299,16769,19068,video
CompanyJ_10563,DeAndre wasn t feeling the pushups ,35,456,4955,5411,video
CompanyJ_10564,GIANNIS MEAN ,13,1085,6896,7981,video
CompanyJ_10565,Giannis last 5 games 36 PTS 15 REBS 8 ASTS 34 PTS 15 REBS 6 ASTS 38 PTS 16 REBS 9 ASTS 30 PTS 13 REBS 4 ASTS 35 PTS 16 REBS 3 ASTS Another MVP season ,150,6626,44105,50731,photo
CompanyJ_10566,Dak LAUNCHES it on the free play for the TD via dallascowboys ,62,248,1753,2001,video
CompanyJ_10567,DIGGS ARE YOU SERIOUS via NFL ,30,704,6389,7093,video
CompanyJ_10568,Dak you good via NFL ,21,860,7988,8848,photo
CompanyJ_10569,COOP WOW via NFL ,17,1681,9869,11550,video
CompanyJ_10570,Again ,6,1586,9426,11012,photo
CompanyJ_10571,LeBron and Siakam had different opinions on this call ,54,1702,17804,19506,video
CompanyJ_10572,Kevin Huerter and Dame going back and forth OT in Portland ,59,607,5671,6278,video
CompanyJ_10573,Raptors upset Lakers on the road 113 104 LA s 7 game winning streak snapped Siakam 24 PTS 11 REB 4 AST James 13 PTS 13 REB 15 AST ,130,1252,9191,10443,photo
CompanyJ_10574, JalenHurts and Oklahoma showed support to 12 year old Rayden Overbay following the Sooners game yesterday after a video of him getting bullied went viral ,155,2975,26224,29199,video
CompanyJ_10575,Dancing Dak is everywhere brgridiron ,37,7193,37177,44370,video
CompanyJ_10576,Steelers were 0 2 when they gave up a 1st for Minkah Since 5 2 17 1 PPG allowed 3 4 forced turnovers per game Difference maker ,127,1242,8455,9697,photo
CompanyJ_10577,Cassius Winston posts an emotional tribute to his late brother Zachary ,71,5880,34541,40421,photo
CompanyJ_10578,Mark Ingram had Ravens fans in Cincinnati chanting MVP for Lamar ,65,839,7772,8611,video
CompanyJ_10579,LSU players supposedly went over to Bama s recruits and told them to reconsider their decision after the win via ByronRuff ,123,4688,35585,40273,video
CompanyJ_10580,Answering spicy questions and eating worm salad Watch How Hungry Are You with sergeibaka From BR x SamsungMobileUS ,115,43,352,395,video
CompanyJ_10581,32 years old and averaging a goal or assist every 45 minutes in La Liga Messi is not slowing down brfootball ,109,276,2118,2394,photo
CompanyJ_10582, You changed the game You know how many little kids in this country are gonna be wearing No 8 playing QB for the next 20 years This Harbaugh Lamar convo is so real via Ravens ,175,20727,95342,116069,video
CompanyJ_10583,LeBron s not holding back brhoops ,34,490,4905,5395,photo
CompanyJ_10584,Isaiah Thomas was in a really bad place the last few years But now I got my joy back ,85,378,4042,4420,photo
CompanyJ_10585,Through the legs Baseball behind the back No way via maxwellpearce ,67,4335,26600,30935,video
CompanyJ_10586,Antoine Griezmann really out here looking like he s in The Joker brfootball ,76,419,5134,5553,photo
CompanyJ_10587,Suns are scorching to open 2019 20 6 3 record No 1 assists No 1 FG No 4 3PT No 5 scoring Booker 25 8 PPG 54 5 FG ,113,3274,23298,26572,photo
CompanyJ_10588,Jalen Ramsey said pregame that JuJu was no AB JuJu s response after getting the W via bepryor ,94,2383,25422,27805,video
CompanyJ_10589,Khris Middleton is expected to miss several weeks with a left leg injury per ShamsCharania ,91,189,1977,2166,photo
CompanyJ_10590, sergeibaka might be the NBA fashion king Raptors forward shows off his different styles in the latest edition of What Are You Wearing ,135,87,681,768,video
CompanyJ_10591,Richard Sherman and the Niners look to rewrite history vs Seattle on MNF brgridiron Can they stay undefeated ,109,556,5741,6297,video
CompanyJ_10592,Luka kicked Smart where it hurts and still got the AND 1 ,57,1122,13128,14250,video
CompanyJ_10593,Wyd Dejounte ,13,593,5122,5715,video
CompanyJ_10594,Luka hit em with the MJ shrug _ ツ _ ,36,1489,12343,13832,video
CompanyJ_10595,Andrew Wiggins last 4 games 30 PTS 6 ASTS 2 STLS 40 PTS 5 REBS 7 ASTS 25 PTS 4 REBS 5 ASTS 33 PTS 6 REBS 5 ASTS Breakout year ,126,3345,26502,29847,video
CompanyJ_10596,Tartt with the TD saving forced fumble via 49ers ,49,372,2750,3122,video
CompanyJ_10597,Stephen Curry says he expects to return this season sometime in early spring ,77,465,4915,5380,photo
CompanyJ_10598,Kemba went off 29 PTS 8 threes 5 REBS 5 ASTS C s have won 8 in a row ,69,1359,8685,10044,video
CompanyJ_10599,The touch Russ put on this TD throw What a catch via NFL ,57,744,7628,8372,video
CompanyJ_10600,D Lo putting the Warriors on his back 16 straight points ,57,2309,13429,15738,video
CompanyJ_10601, I feel lucky that I was a part of something that may not ever happen again Spurs give Tony Parker a tribute video ,115,1995,9427,11422,video
CompanyJ_10602,Tony Parker s jersey is officially retired ,43,7191,42212,49403,video
CompanyJ_10603,49ERS TIE IT UP 47 yarder is good to even things at 24 We re going to OT via NFL ,81,773,6323,7096,video
CompanyJ_10604,Russell Wilson is a gamer Pulled this out of nowhere via NFL ,61,731,5033,5764,video
CompanyJ_10605,49ers pick off Russell Wilson in OT via NFL ,44,969,5774,6743,video
CompanyJ_10606,49ERS MISS THE FIELD GOAL ,26,1632,11728,13360,photo
CompanyJ_10607,The 49ers missed game winning field goal attempt landed in the tunnel via jenniferleechan ,90,4183,26008,30191,video
CompanyJ_10608,SEAHAWKS TAKE DOWN THE 49ERS Last second field goal in OT gives Seattle the 27 24 win San Francisco suffers their first loss falling to 8 1 ,140,1691,8221,9912,photo
CompanyJ_10609,Siakam getting MVP chants at Staples Center ,44,746,7101,7847,video
CompanyJ_10610,First Warriors ejection at Chase Center goes to Dray in his first game back ,76,685,6933,7618,video
CompanyJ_10611,BOUCHER STUFFED HARRELL ,24,882,5820,6702,video
CompanyJ_10612,Kawhi threads the needle and Montrezl rocks the rim ,52,299,2908,3207,video
CompanyJ_10613,Stole the cone and almost put it back via FOXSportsSouth ,57,1990,12507,14497,video
CompanyJ_10614,Russ has his eyes on MVP 8 2 record No 1 touchdowns No 1 passer rating No 1 game winning drives 5 Took down undefeated Niners ,126,1900,15264,17164,photo
CompanyJ_10615,A club in Argentina used a CGI lion to celebrate their stadium reopening via diarioas ,86,6326,40662,46988,video
CompanyJ_10616,15 years ago today ,19,9389,40941,50330,photo
CompanyJ_10617,LJ looking like the modern Mike via nflthrowback ,49,4560,29611,34171,video
CompanyJ_10618,Next big money transfer a loyal champion or colossal bust You decide Make every decision along the way and choose your path BRFootball Play on the YouTube mobile app or desktop ,177,23,307,330,video
CompanyJ_10619,Today marks a decade since DwyaneWade bodied Anderson Varejao Still mean 10 years later ,88,7843,32303,40146,video
CompanyJ_10620,Breaking Paul George plans to make his Clippers debut this Thursday vs Pelicans per ChrisBHaynes ,97,1534,10407,11941,photo
CompanyJ_10621,1 minute and 16 seconds of Booker sinking every three via Suns ,63,2339,15589,17928,video
CompanyJ_10622,This was FIFA in real life via brfootball ,42,675,5251,5926,video
CompanyJ_10623,Giannis not letting anybody hold a pair brkicks via Giannis_An34 ,65,1028,10433,11461,video
CompanyJ_10624,The Brodie turns 31 today 2017 MVP 8x All Star 2x All Star Game MVP 2x scoring and assist leader Averaged a triple double for 3 straight seasons ,145,3208,16370,19578,photo
CompanyJ_10625,The Bosa brothers are terrorizing the league but the Watt bros aren t having it playstation GridironHeights ,108,866,4696,5562,video
CompanyJ_10626,Colin Kaepernick informed NFL teams he s holding a private workout in Atlanta on Saturday that includes on field work and an interview per AdamSchefter All teams are invited to attend ,184,5945,31356,37301,photo
CompanyJ_10627, WashedKing Nope HowardBeck says KingJames is still the most devastating all around force in the NBA ,101,1378,6211,7589,video
CompanyJ_10628,New CFP rankings Bama and Oregon first two on the outside Did the committee get it right ,89,267,1724,1991,photo
CompanyJ_10629,Tristan Thompson is hitting 3s and letting the 76ers bench hear about it ,73,4330,37426,41756,video
CompanyJ_10630,CHILL OUT dariusgarland22 ,26,1179,7577,8756,video
CompanyJ_10631,Kris Dunn got hit with some friendly fire ,42,205,2113,2318,video
CompanyJ_10632, Evansville UPSETS No 1 Kentucky 67 64 ,39,7821,36343,44164,photo
CompanyJ_10633,AD went right at Rubio for the poster ,38,1390,10975,12365,video
CompanyJ_10634,Trae Young not playing fair ,28,2001,14598,16599,video
CompanyJ_10635,Coby White set a Bulls record for most 3PTs in a single quarter with 7 in the 4Q ,81,3819,21737,25556,video
CompanyJ_10636,COBY WHITE 7th three of the quarter was unfair ,47,1401,9129,10530,video
CompanyJ_10637,Trae stared down the Nuggets bench after this nasty nutmeg and bucket ,70,5408,32241,37649,video
CompanyJ_10638,Trae said ,10,629,4341,4970,video
CompanyJ_10639, Kuz in the clutch ,19,3002,15530,18532,video
CompanyJ_10640,Bron Kyler brgridiron ,22,1881,23773,25654,video
CompanyJ_10641,Ice Trae dropped a season high 42 PTS in a W against the Nuggets ,65,4318,34923,39241,video
CompanyJ_10642,Bron had to give Kuz props after his best game of the season ,61,1581,15627,17208,video
CompanyJ_10643, If possible could you come to more games Because I haven t shot like that in a long time Coby White thanks Roy Williams for attending his game after a career night for the Bulls ,179,6316,45230,51546,video
CompanyJ_10644,,0,24128,100567,124695,photo
CompanyJ_10645,CM Punk is back with WWE BRWrestling After speculation Punk has joined WWE Backstage as an analyst It s his first WWE appearance since abruptly leaving the company in 2014 via WWEonFOX ,185,5146,17967,23113,video
CompanyJ_10646,Victor Oladipo s vocals on point via Original_Turner ,53,1563,12861,14424,video
CompanyJ_10647,A wild night in Miami after an L resulted in ChrisJohnson28 and some Titans teammates paying 140K total in team fines New Untold Stories with MasterTes ,152,222,1238,1460,video
CompanyJ_10648,Kawhi has supporters for load management but not everyone is a fan of it ,73,205,2197,2402,video
CompanyJ_10649,LeBron s signature move in slo mo is mesmerizing via sawtelly IG ,65,17043,95830,112873,video
CompanyJ_10650,Don t sleep ,12,2791,15920,18711,photo
CompanyJ_10651,Lamar s newest receiver via Ravens ,35,962,9764,10726,video
CompanyJ_10652,What could have been ,21,1887,12725,14612,video
CompanyJ_10653,The NFL says Colin Kaepernick s workout is in no way a PR stunt per wyche89 One team executive believes many teams are scouting Kap to judge his readiness for next season ,171,446,3103,3549,photo
CompanyJ_10654,Linebacker Jamie Collins casually doing backflips at Patriots practice via ruthiepolinsky MHershgordon wpri12 ,110,824,6682,7506,video
CompanyJ_10655, Who keeps putting the towels on the top shelf Damn 5 6 Tarik Cohen in the ChicagoBears locker room ,100,12694,62475,75169,video
CompanyJ_10656,Joe Burrow proved he could handle the big stage against Alabama now he s looking like a lock for the No 1 pick SoutheastToyota ,127,94,801,895,video
CompanyJ_10657,KD back in the gym taking shots in the vintage Kukoc uni via ___devonte___ IG ,78,3908,23201,27109,photo
CompanyJ_10658,This Kawhi drawing is unreal via bluejaysart ,45,1222,7901,9123,video
CompanyJ_10659,Zlatan confirms he has left LA Galaxy I gave you Zlatan You are welcome brfootball ,83,1401,10950,12351,photo
CompanyJ_10660,The Bengals prepared for the Ravens by having Andy Dalton emulate Lamar Jackson s savvy on the scout team brgridiron via GeoffHobsonCin ,136,448,4193,4641,photo
CompanyJ_10661,This was Zlatan s first ever MLS goal Still unbelievable via LAGalaxy ,70,4381,26192,30573,video
CompanyJ_10662,Mets Jacob deGrom wins the NL Cy Young Award back to back years ,64,684,2841,3525,photo
CompanyJ_10663,Astros Justin Verlander wins the AL Cy Young Award for the second time in his career ,85,417,3307,3724,photo
CompanyJ_10664,Zlatan had a lot to say during his time with the LA Galaxy brfootball ,70,791,4360,5151,photo
CompanyJ_10665,Post birthday vibes for Russ in H Town via HoustonRockets ,58,746,4730,5476,video
CompanyJ_10666,John Wall s already dunking again via NBCSWizards ,50,1571,13149,14720,video
CompanyJ_10667,Malik Monk ONE HANDED ,22,514,5051,5565,video
CompanyJ_10668,Miles Bridges jumped over Valanciunas for the putback ,54,714,5750,6464,video
CompanyJ_10669,KAT not backing down from anyone this season ,45,3307,25458,28765,video
CompanyJ_10670,JA FOR THE WIN ,15,6803,33972,40775,video
CompanyJ_10671,First career NBA game winner Only took the rook 11 games ,57,2547,22027,24574,photo
CompanyJ_10672,Ja celebrated his first NBA game winner with his dad on the court ,66,3919,34190,38109,video
CompanyJ_10673,Bruh ,5,2298,15765,18063,photo
CompanyJ_10674,Austin Rivers wanted the refs to give his dad a tech ,53,20900,87811,108711,video
CompanyJ_10675,Harden put up 47 PTS for the Rockets fifth straight win ,56,1111,6731,7842,photo
CompanyJ_10676,Beard Dagger That s cold From B R x CoorsLight ,47,446,2765,3211,video
CompanyJ_10677,Russ on Pat Bev s defense He trick y all man He just running around doing nothing via MarkBermanFox26 ,102,7707,35499,43206,video
CompanyJ_10678,Russ not buying Pat Bev s antics ,33,1035,6980,8015,photo
CompanyJ_10679, ,1,1076,8363,9439,video
CompanyJ_10680,JaVale dunked on the Warriors during Klay s interview He s athletic Good for JaVale ,84,1160,12055,13215,video
CompanyJ_10681,Lakers 9 2 are off to their best start since 2010 ,50,7868,47415,55283,photo
CompanyJ_10682,Ja Morant went Super Saiyan in the closing seconds ,51,1300,11481,12781,video
CompanyJ_10683,Seven years ago today Zlatan hit the best goal of 2012 Still unreal brfootball ,79,1686,13139,14825,video
CompanyJ_10684,LeBron doesn t find it weird playing this version of the Warriors via kylegoon ,79,919,7575,8494,video
CompanyJ_10685,Rage quitting against opponents Using cheat codes in GTA Playing with your homie for hours joshhart opens up about gaming as he adjusts to life in NOLA Battlestations BRGaming Watch full episode ,195,75,617,692,video
CompanyJ_10686,Lamar is nothing like his competition brgridiron ,49,843,7617,8460,photo
CompanyJ_10687,James Wiseman has been declared ineligible for competition by Memphis will immediately apply for his reinstatement ,115,394,2392,2786,photo
CompanyJ_10688,Ronda Rousey took her first UFC loss four years ago today Incredible consistency from HollyHolm via ufc ,104,3499,17940,21439,video
CompanyJ_10689,Lamar Jackson will keep the burners on with the Texans in the house YahooFantasy ,81,51,569,620,video
CompanyJ_10690,Flash catching for an MVP candidate now brgridiron ,51,282,3861,4143,photo
CompanyJ_10691,Retired DwyaneWade is an MVP dad via itsgabrielleu ,51,5268,36459,41727,video
CompanyJ_10692,Ronaldo Filthy via TUDNUSA ,27,701,3536,4237,video
CompanyJ_10693,KD coming back one day at a time via __devonte__ IG ,52,1158,8249,9407,video
CompanyJ_10694,9th international hat trick 98 Portugal goals CR7 is unreal brfootball ,71,508,2803,3311,photo
CompanyJ_10695,NFL confirms the following teams will attend Kap s workout Patriots Dolphins Broncos Lions Cardinals Falcons Browns Giants Jets Bucs Redskins More expected to come too brgridiron ,179,5644,27753,33397,photo
CompanyJ_10696,Kalin Bennett couldn t walk until age 3 and couldn t talk until age 7 Now he s the first player diagnosed with autism to play D I hoops ,136,2507,13864,16371,video
CompanyJ_10697,Dodgers Cody Bellinger named NL MVP ,36,1030,4408,5438,photo
CompanyJ_10698,Knicks front office told people they were turned off by an AD trade because dealing multiple firsts and young players would undercut their long range plan per WindhorstESPN ,173,514,3685,4199,photo
CompanyJ_10699,Angels Mike Trout named AL MVP ,31,1065,5913,6978,photo
CompanyJ_10700,KP makes his return to The Garden tonight HowardBeck says the Mavs won the Porzingis trade and it s not even close ,115,135,1173,1308,video
CompanyJ_10701,Fiz on the Knicks iso basketball I don t hear anybody b tching about Houston isolating they hold the ball the whole game but they score 1 000 points via sny_knicks ,164,602,4614,5216,video
CompanyJ_10702, He s like Michael Jordan to kids my age Kyler was starstruck when the King dapped him mid game via AZCardinals ,112,529,6919,7448,video
CompanyJ_10703,Knicks fans boo KP during intros in his first game back to MSG via MasterTes ,77,459,2972,3431,video
CompanyJ_10704,Carmelo Anthony is back in the NBA Melo is signing with the Trail Blazers per wojespn ,86,38102,124636,162738,photo
CompanyJ_10705,Dame CJ and Melo That s a lotta buckets ,40,1901,11108,13009,photo
CompanyJ_10706,Blazers play the Rockets on Monday ,35,4523,24389,28912,photo
CompanyJ_10707,RJ s spin move on Luka ,23,1248,9172,10420,video
CompanyJ_10708,371 days since we ve seen Melo in the league Buckets coming soon ,65,2205,14025,16230,video
CompanyJ_10709,Knicks fans started an assh e chant when KP was shooting free throws ,69,353,2707,3060,video
CompanyJ_10710,Trae nutmegged Rubio ,21,4165,30340,34505,video
CompanyJ_10711,Luka was HYPED after this KP putback ,37,749,6404,7153,video
CompanyJ_10712,Melo showing up to Rip City ,28,1762,10331,12093,video
CompanyJ_10713,Morris step back FOR GAME That s cold From B R x CoorsLight ,60,562,4005,4567,video
CompanyJ_10714,Melo s Banana Boat brothers are happy he s back ,48,941,6732,7673,photo
CompanyJ_10715,Over the summer Mike Tomlin made a yawning gesture when asked about facing Odell twice a year OBJ didn t forget brgridiron ,123,3129,22968,26097,photo
CompanyJ_10716,Myles Garrett just ripped Mason Rudolph s helmet off and struck him in the head with it Steelers linemen throwing punches Wow ,126,4397,24403,28800,photo
CompanyJ_10717,CHAOS ,6,1068,7941,9009,photo
CompanyJ_10718,Baker calls what Myles Garrett did inexcusable brgridiron ,58,421,4533,4954,photo
CompanyJ_10719,Mason Rudolph not holding back brgridiron ,42,347,4067,4414,photo
CompanyJ_10720,Gigi with the fadeaway Like father like daughter via kobebryant ,64,5969,41161,47130,video
CompanyJ_10721, joshhart threw the controller so hard Battlestations brgaming Watch the full episode ,86,82,895,977,video
CompanyJ_10722,Space Jam premiered 2 3 years ago today MJ year ,48,4935,28441,33376,photo
CompanyJ_10723,Defender wasn t having it via hugo passos IG ,45,1467,9846,11313,video
CompanyJ_10724,Breaking NFL has suspended Myles Garrett indefinitely without pay ,66,3567,19319,22886,photo
CompanyJ_10725,18 year old Deni Avdija could be a top five pick and the NBA s next international star Just don t call him the next Luka ,121,78,725,803,photo
CompanyJ_10726,Only took Messi 13 minutes to score in his first game for Argentina since July via beINSPORTSUSA ,97,227,1939,2166,video
CompanyJ_10727,19 year old Sergino Dest had to choose between representing the Netherlands and the USMNT And he chose the US They believed in me in the hard times brfootball ,159,93,865,958,video
CompanyJ_10728,Superclasico de las Americas Messi finally wins an international trophy ,72,465,3179,3644,photo
CompanyJ_10729,Still going KingJames ,22,5303,37460,42763,photo
CompanyJ_10730,The Suns are HOT this season ,29,1239,7374,8613,video
CompanyJ_10731, More than 24 teams are expected to attend Colin Kaepernick s workout on Saturday in Atlanta per AdamSchefter ,110,1489,10034,11523,photo
CompanyJ_10732,Jay Z reportedly pressured Roger Goodell to set up a Colin Kaepernick workout because he took a reputational bullet for the commissioner when their partnership was announced per dpshow ,185,3066,13887,16953,photo
CompanyJ_10733,Carmelo Anthony not expected to make Trail Blazers debut before Tuesday s game against Pelicans per wojespn ,108,330,3582,3912,photo
CompanyJ_10734, ,1,142,2286,2428,link
CompanyJ_10735,D Rose with the handles and finish ,35,2197,17229,19426,video
CompanyJ_10736,Pelicans guard joshhart says playing hours of video games with Larrydn22 helped their chemistry Battlestations ,111,97,1120,1217,video
CompanyJ_10737,Ja with a layup of the year candidate via NBA ,46,6676,40902,47578,video
CompanyJ_10738, ,1,101,1558,1659,photo
CompanyJ_10739,KAT didn t have to hand Wagner the ball after this ,51,538,5285,5823,video
CompanyJ_10740,MALIK MONK STUNS THE PISTONS Blake s reaction says it all ,58,5073,25418,30491,video
CompanyJ_10741,Ja is electric via memgrizz ,28,767,6156,6923,video
CompanyJ_10742,44 PTS 10 AST and the W behind Bradley Beal for the Wizards Magical ,68,637,5559,6196,photo
CompanyJ_10743,James Harden has been on FIRE in his last 6 games 44 PTS 8 REB 5 AST 47 PTS 6 REB 7 AST 39 PTS 4 REB 9 AST 42 PTS 10 REB 9 AST 36 PTS 4 REB 13 AST 44 PTS 10 REB 6 AST All W s ,175,2089,10304,12393,photo
CompanyJ_10744,Hit the three let em know ,26,1542,13886,15428,video
CompanyJ_10745,No look Between the legs Three points Bron and Kuz have that chemistry ,71,1093,10873,11966,video
CompanyJ_10746,LEBRON POSTER ASDFGHJKL ,24,49701,172047,221748,video
CompanyJ_10747,Almost exactly 15 years apart ,30,4561,27004,31565,photo
CompanyJ_10748,JR s reaction to LeBron s dunk ,31,2670,20690,23360,photo
CompanyJ_10749,LeBron just toying with em now ,31,8256,52436,60692,video
CompanyJ_10750,Ball got stuck on top of the backboard and Buddy Hield tried everything to get it down ,87,391,4361,4752,video
CompanyJ_10751,Game on the line AD s defense wins it for the Lakers ,53,1688,10558,12246,video
CompanyJ_10752,Kemba with the dagger Ice cold From B R x CoorsLight ,53,306,2679,2985,video
CompanyJ_10753,Celtics have won 10 straight games and sit at first place in the NBA standings Don t sleep on this team ,104,3298,20611,23909,photo
CompanyJ_10754,Celtics got synced up after the rebound ,40,2188,19266,21454,video
CompanyJ_10755,Year 17 KingJames ,18,3300,24070,27370,photo
CompanyJ_10756,On this day in 2003 a 16 year old Lionel Messi made his first team debut for Barcelona Since then 612 goals 247 assists 34 major trophies 5 Ballons d Or brfootball ,164,805,4927,5732,video
CompanyJ_10757,Down 55 in garbage time Monmouth s George Papas steals the ball dunks and gets a tech ,86,1381,12832,14213,video
CompanyJ_10758,Bron turned him to dust ,24,16701,70915,87616,video
CompanyJ_10759,From unknown rookie to standout star Brandon Boykin s Georgia comeback was one for the books This story has been supplemented by aflac ad ,138,75,623,698,video
CompanyJ_10760,The HoHighlights show is LIVE in Auburn with special guest Young_Slay2 ahead of No 4 Georgia vs No 12 Auburn ,109,9,71,80,link
CompanyJ_10761,Missed the penalty and broke the light via NickDillam ,54,1058,7310,8368,video
CompanyJ_10762,Tua getting carted off after getting tackled ,45,837,4656,5493,photo
CompanyJ_10763, OmarHOH predicts Auburn will beat Georgia 57 0 via HoHighlights ,65,36,372,408,video
CompanyJ_10764,The crowd goes wild for a condom balloon touchdown via PaddyCotter ,67,676,4867,5543,video
CompanyJ_10765, He went flying out the camera frame Young_Slay2 broke down one of the most absurd hits you ll see this year via HoHighlights ,126,70,360,430,video
CompanyJ_10766,When hurdles go completely wrong ,33,348,2614,2962,video
CompanyJ_10767,He did it all in college Now Deshaun Watson is showing everyone there s no ceiling for what he can do in the NFL brgridiron ,124,116,709,825,video
CompanyJ_10768,This one handed catch is wild via grizzlyathletes ,50,1396,10541,11937,video
CompanyJ_10769,First the punch celebrations now this Rutgers TD celebrations this season have been something else via BigTenNetwork ,117,289,2782,3071,video
CompanyJ_10770,Breaking Tua Tagovailoa is ruled out for the season with a dislocated hip per AaronSuttles ,91,4170,16391,20561,photo
CompanyJ_10771,Footage of Kap s workout Still got that big arm via JRSportBrief ,65,6544,38641,45185,video
CompanyJ_10772,Kap knows he s still ready to be an NFL QB brgridiron ,54,1627,9581,11208,photo
CompanyJ_10773,Auburn bench celebrations Can t beat it via CBSSports ,54,418,3385,3803,video
CompanyJ_10774, Ball is in their court we re ready to go Kap addressed the media after his workout via DanWolken ,98,20657,83865,104522,video
CompanyJ_10775, No 20 Iowa UPSETS No 8 Minnesota 23 19 ,40,575,4382,4957,photo
CompanyJ_10776,Giannis dunked on two Pacers then swatted a shot on the other end MVP for a reason ,83,2123,15128,17251,video
CompanyJ_10777,James Harden is a scoring machine 30 points in the first half like it s nothing ,80,985,7053,8038,video
CompanyJ_10778,Luka got two defenders to go flying on the pump fake then kicked it out for 3 ,78,1661,16314,17975,video
CompanyJ_10779,Devonte Graham cold blooded in MSG Hit nine 3 pointers to help the Hornets get the 103 102 win over the Knicks ,111,1985,13059,15044,video
CompanyJ_10780,Georgia s locker room after winning the SEC East via GeorgiaFootball ,69,496,2978,3474,video
CompanyJ_10781,Pop got ejected so Becky Hammon and Tim Duncan took over to coach the Spurs ,76,2231,18034,20265,video
CompanyJ_10782,Baylor has blown a 28 3 lead Oklahoma has tied things at 31 Bears and Falcons fans ,83,1229,9682,10911,photo
CompanyJ_10783,Jalen Hurts and Oklahoma do the impossible come back from 28 3 deficit to stun Baylor 34 31 Hurts 30 43 passing 411 total yards 4 TDs INT ,138,1602,8263,9865,photo
CompanyJ_10784,Nik Bonitto stopped Baylor with the game sealing INT Clutch ,60,575,4073,4648,video
CompanyJ_10785,Paul George already has 25 PTS in the first half No rust for PG ,64,1715,13339,15054,video
CompanyJ_10786,James Harden My goodness ,25,9071,54944,64015,video
CompanyJ_10787, MJ shrug Off the backboard lob to Montrezl Harrell Gets Standing O at Staples Center Most points scored in Clippers home debut with 37 PTS Paul George doing it all in 20 min tonight ,183,3113,20109,23222,video
CompanyJ_10788,1 6 points 8 boards 6 dimes Handle on point Game is easy for LaMelo brhoops via NBL ,84,481,3446,3927,video
CompanyJ_10789,Lamar and Deshaun have been battling for top honors since college Week 11 should be fun SHO_RayDonovan ,103,211,1505,1716,video
CompanyJ_10790,The majority of NFL teams didn t attend Kap s rescheduled workout In attendance Chiefs Eagles Redskins Niners Jets Several others via ProFootballTalk JimTrotter_NFL ,165,414,2994,3408,photo
CompanyJ_10791,WOAH via helmetmake IG thekingofunderdogs IG ,45,4571,27412,31983,video
CompanyJ_10792,Gronk has a big announcement this week Deadline to return this year is Nov 30 ,78,1591,9712,11303,video
CompanyJ_10793,The young fan s smile says it all Dabo 25 minutes before kickoff via KacyHintz ,79,306,3449,3755,video
CompanyJ_10794,Start or sit Sleepers Injury updates TheMattCamp is dishing out everything you need this week in fantasy Watch Your FantasyFireDrill NOW ,137,9,82,91,link
CompanyJ_10795,70 points combined in two games as a Clipper Healthy PG is a scary sight ,73,1740,14817,16557,photo
CompanyJ_10796,Diggs cleats level up every week brkicks via MACHE275 ,54,8820,48359,57179,photo
CompanyJ_10797,9 9 for Ronaldo brfootball ,27,199,1609,1808,photo
CompanyJ_10798,Marlon Mack said via thecheckdown ,34,964,8441,9405,video
CompanyJ_10799,Lamar on the MONEY Second TD of the day via NFL ,48,808,6468,7276,video
CompanyJ_10800,GALLUP WHAT via nfl ,20,813,4795,5608,video
CompanyJ_10801,Falcons before and after their bye week brgridiron ,51,1155,8372,9527,photo
CompanyJ_10802, LAMAR via NFL ,15,7261,45724,52985,video
CompanyJ_10803,The touchdown didn t count but Quenton Nelson s celebration will live forever via Colts ,88,2305,12981,15286,video
CompanyJ_10804,Your weekly ridiculous numbers from Lamar Jackson 17 24 223 yards 4 TD 86 rushing yards Beating Texans 34 0 ,108,7094,36084,43178,photo
CompanyJ_10805,Mark Ingram juked him clean Via NFL ,36,443,3204,3647,video
CompanyJ_10806,Dak Zeke via FOXSports ,23,1651,10529,12180,video
CompanyJ_10807,Russell Wilson and Lamar Jackson this season brgridiron ,56,1664,10134,11798,photo
CompanyJ_10808,What if Brady caught this in Super Bowl LII Pats Eagles rematch brgridiron ,75,155,1741,1896,video
CompanyJ_10809,Lamar and the Ravens looking good after another W brgridiron ,61,1155,9201,10356,video
CompanyJ_10810,Forget the future They got now ,31,5609,32976,38585,photo
CompanyJ_10811,Mark Ingram drops the intro of the year for Lamar Jackson Every second of this is perfect via Ravens ,101,12355,50926,63281,video
CompanyJ_10812,The end of the Celtics Kings game was brutal for Boston Buddy kicked it right into the stands ,94,1939,13053,14992,video
CompanyJ_10813,QB Julian Edelman finds Phillip Dorsett for 6 Pats take the lead in Philly via NFL ,83,429,3061,3490,video
CompanyJ_10814,Ja too nice with it ,20,2020,17914,19934,video
CompanyJ_10815,Kyler was off to the races Cardinals retake the lead via NFL ,61,576,4997,5573,video
CompanyJ_10816,Get up Markelle ,16,1117,9190,10307,video
CompanyJ_10817,Kirk Cousins was ice cold with 3 TDs in the Vikings big comeback win From B R x CoorsLight ,91,126,994,1120,video
CompanyJ_10818,DROPPED HIM ,12,911,6162,7073,video
CompanyJ_10819,Eagles fans right now brgridiron ,33,3135,13523,16658,photo
CompanyJ_10820,MARKELLE CLUTCH ,16,3863,23258,27121,video
CompanyJ_10821,Looks like Markelle found a home in Orlando He scored a career high 19 points tonight ,86,786,6415,7201,video
CompanyJ_10822,LA reppin Candace Parker and Todd Gurley swapped jerseys before SNF Ivia LA_Sparks ,83,1582,16961,18543,video
CompanyJ_10823,Caught A Body ,14,373,3425,3798,video
CompanyJ_10824,Showtime starting early tonight ,32,3454,18924,22378,video
CompanyJ_10825,Bron daps up Kobe then immediately hits a 3 ,44,10456,63711,74167,video
CompanyJ_10826,LeBron gets the and 1 and Kobe s loving it ,43,2132,18065,20197,video
CompanyJ_10827,DANNY GREEN GOT UP ,19,30234,150010,180244,video
CompanyJ_10828,Evan Turner crossed Bron ,25,13302,62245,75547,video
CompanyJ_10829,Bears have benched Mitchell Trubisky ,37,943,7765,8708,photo
CompanyJ_10830,SHOWTIME AT STAPLES ,20,1423,10972,12395,video
CompanyJ_10831,Staples Center gives Kobe a standing O as he walks out ,55,5967,45819,51786,video
CompanyJ_10832, ⅹ All smiles ,14,8594,45956,54550,photo
CompanyJ_10833, What do I have to do to help you Redskins rookie Dwayne Haskins to his offensive line via NBC4Sports ,102,2183,18609,20792,video
CompanyJ_10834,From one legend to another KingJames ,37,2332,15198,17530,photo
CompanyJ_10835,White Chocolate forever Happy 44th to one of the coldest ball handlers ever via NBA ,84,15394,60408,75802,video
CompanyJ_10836,Tua feeling good before surgery via kekeprewitt ,48,962,10140,11102,video
CompanyJ_10837,Cristiano Ronaldo age 34 More goals for Portugal than any other year 14 LeBron James age 34 Leads NBA in assists 2nd in triple doubles Lionel Messi age 32 Averaging a goal or assist every 45 minutes in La Liga ,210,1913,11287,13200,photo
CompanyJ_10838,Ultimate respect between Deshaun Watson and Lamar Jackson Lamar called Deshaun the GOAT Deshaun called Lamar the MVP ,117,704,6014,6718,photo
CompanyJ_10839,Bit of a height difference in this U15 Ajax vs Sparta Rotterdam game John Groeneweg ,84,809,6507,7316,photo
CompanyJ_10840,Bron got left hanging ,22,2211,21747,23958,video
CompanyJ_10841,Arizona high school RB Adonis Watt is blind and he s out here scoring TDs StateFarm Meet the RB from Phoenix his lack of vision doesn t define him ,147,635,2879,3514,video
CompanyJ_10842,Lamar Jackson over Baltimore s six game winning streak 67 6 completion 1 148 passing yards 550 rushing yards 14 total TD 3 INT 103 5 QB rating Beat Brady Wilson Watson Overtook Russ as MVP favorite Ridiculous brgridiron ,220,2882,16611,19493,photo
CompanyJ_10843,Belichick was waiting for this one brgridiron ,46,4922,38002,42924,photo
CompanyJ_10844,All love now between Kobe and Dwight via Lakers ,48,1097,12631,13728,video
CompanyJ_10845,Malcolm Brogdon being Queen Latifah s cousin had Joe Harris shook Nets sharpshooter plays That s My Guy ,104,156,1089,1245,video
CompanyJ_10846,James Harden and the Rockets are putting the league on notice ,62,1570,8270,9840,video
CompanyJ_10847,LeBron James on Gigi Bryant Kobe s got one of the greatest female basketball players that s about to come up sitting next to him via kobebryant ,144,1165,11737,12902,video
CompanyJ_10848,De Andre Hunter ready to hand out Ls as an animation From B R x jcpenney ,73,55,517,572,video
CompanyJ_10849,Instead of scoring the TD himself he hands it off to his teammate so he can score in his last college game What a play via utpbfalcons ,135,12170,93568,105738,video
CompanyJ_10850,Dave Chappelle is working on his stepback jumper at Lakers practice via mcten ,78,1267,10209,11476,video
CompanyJ_10851,Danny Green shocked the world last night ,41,2710,20288,22998,photo
CompanyJ_10852,Things you see at the Knicks game ,34,5073,29093,34166,video
CompanyJ_10853, Bucks went full WWE before the game ,37,3513,24254,27767,video
CompanyJ_10854,Wendell Carter Jr s reaction to Giannis airball ,48,621,5652,6273,video
CompanyJ_10855, I lost a piece of my heart but you guys keep me going Cassius Winston thanks MSU fans for their support after the death of his brother Zachary via BigTenNetwork ,162,1068,9566,10634,video
CompanyJ_10856,Harden makes it look too easy ,30,2210,14540,16750,video
CompanyJ_10857,Flat out dropped him ,21,2113,13183,15296,video
CompanyJ_10858, New career high for Luka 42 PTS 11 REBS 12 ASTS 6th triple double of the year ,79,7359,43580,50939,video
CompanyJ_10859,Mudiay with the behind the back fake ,37,7685,49611,57296,video
CompanyJ_10860,Mike Williams went UP and got it via Chargers ,46,682,5209,5891,video
CompanyJ_10861,Chiefs pick off Philip Rivers to win the game 24 17 KC defense picked Rivers off 4 times in Mexico City via NFL ,112,431,3813,4244,video
CompanyJ_10862,Solid company ,14,1347,10055,11402,photo
CompanyJ_10863,PG IS BACK ,11,1940,14512,16452,video
CompanyJ_10864,Luka Doncic this season 29 5 PTS 10 7 RBS 9 3 AST Last four games 42 PTS 26 PTS 33 PTS 34 PTS ,94,3931,30481,34412,photo
CompanyJ_10865,We spent two weeks with LaMelo Ball in Australia to find out who he really is Teammate LaMelo thinks he s better than Lonzo Breaks down his relationship with LaVar His manager says LaMelo has been treated like he s a prostitute ,228,381,2530,2911,photo
CompanyJ_10866,This week marks one year since Alex Smith s gruesome leg injury His wife lizbsmith11 posted this video showing how much progress he s made Wow ,143,2681,19079,21760,video
CompanyJ_10867,The crossover move was too filthy via ticket52 IG ,50,8714,43381,52095,video
CompanyJ_10868,50 years ago today Pele scored his 1 000 goal One Thousand brfootball ,70,915,8463,9378,photo
CompanyJ_10869,Blazers announce Melo will wear No 00 with Portland ,52,9814,56545,66359,video
CompanyJ_10870,Little bro has no doubt ,24,925,7064,7989,photo
CompanyJ_10871,Melo explains why he chose 0 0 ,31,2503,13247,15750,photo
CompanyJ_10872,The NBA needs JCrossover ,25,5787,34073,39860,photo
CompanyJ_10873,Frank Gore putting in that work 36 year old has a motor like no other via uninterrupted ,88,1025,9946,10971,video
CompanyJ_10874,He called it exactly via LeightonTownFC ,40,289,3014,3303,video
CompanyJ_10875,Lamar s run vs Houston is even better in Spanish via Ravens ,60,1073,5711,6784,video
CompanyJ_10876,Breaking Tottenham has fired manager Mauricio Pochettino The club is currently 14th in the Premier League brfootball ,117,872,4655,5527,photo
CompanyJ_10877,Pochettino took Tottenham to their first Champions League final This is what it meant to him via brfootball ,108,288,2901,3189,video
CompanyJ_10878,This kid trucked his way right into a touchdown via trevor_hilton Instagram ,76,442,5818,6260,video
CompanyJ_10879,The Netherlands Gini Wijnaldum and Frenkie De Jong sent a message of equality and anti racism in their game vs Estonia today brfootball ,136,1078,7054,8132,photo
CompanyJ_10880, New GridironHeights Belichick Lamar and Sherman are contestants on the new game show Which Teams Are Good PlayStation ,119,499,2390,2889,video
CompanyJ_10881,LaMelo s playing with former NBA players in Australia and they say he s league ready IQ is amazing His ceiling is so high NBL ,126,2339,13009,15348,video
CompanyJ_10882,Carmelo Anthony is starting in his Trail Blazers debut vs the Pelicans per MarcJSpearsESPN ,91,2747,15839,18586,photo
CompanyJ_10883,Melo looks ready to go via NBATV ,33,5061,36380,41441,video
CompanyJ_10884,Melo wasn t about to come off the bench in his Blazers debut ,61,4267,24831,29098,video
CompanyJ_10885,Melo scores his first NBA bucket in 376 days ,45,5386,35207,40593,photo
CompanyJ_10886,Melo is officially back ,24,13815,68643,82458,video
CompanyJ_10887,BI s dunk got the Pels bench on their feet ,43,285,2284,2569,video
CompanyJ_10888,Tottenham and Jose Mourinho reach agreement for him to be club s new manager per FabrizioRomano ,96,371,2037,2408,photo
CompanyJ_10889,Vintage Melo ,13,1668,11792,13460,video
CompanyJ_10890,Melo tried to throw it down on Jaxson Hayes ,44,2765,27562,30327,video
CompanyJ_10891,Melo through the years Jumper is timeless ,42,4667,29215,33882,photo
CompanyJ_10892,CP3 got Caruso on this and AC s reaction was priceless ,55,893,12013,12906,video
CompanyJ_10893,RONDO BRON ,11,4416,26060,30476,video
CompanyJ_10894,Lakers gotta give this kid a 10 day via Lakers ,47,5710,45252,50962,video
CompanyJ_10895,Venus Gronk and James Corden put on a show with the Laker Girls via NBATV ,74,2662,21207,23869,video
CompanyJ_10896,First player ever to have a triple double against every team in the league KingJames ,85,26695,113506,140201,photo
CompanyJ_10897,KCP BANG ,9,967,8696,9663,video
CompanyJ_10898,Top of the NBA is back to the way it used to be ,48,10968,53550,64518,photo
CompanyJ_10899,Jose Mourinho is officially the new manager of Tottenham brfootball ,68,316,2521,2837,photo
CompanyJ_10900, I won more Premierships alone than the other 19 managers together Respect When Jose Mourinho was at Manchester United via brfootball ,134,297,2373,2670,video
CompanyJ_10901, Man I belong here Melo s happy to be back via NBATV ,53,2287,14710,16997,video
CompanyJ_10902, Get your little ass over there Jalen Ramsey mic d up is the best via RamsNFL ,78,1869,8711,10580,video
CompanyJ_10903,Not even Brady Wentz or AP is safe from DhaSickest Redskins RB Derrius Guice isn t afraid to roast anybody in the NFL except Dan Snyder New Ditch the Playbook with AdamLefkoe StateFarm ,185,265,1349,1614,video
CompanyJ_10904,Footwork is unreal via fcbarcelona ,35,1223,11574,12797,video
CompanyJ_10905,Jerry Jones says Bill Belichick found him at a ski resort in the 90s after he d been fired from the Browns Belichick told Jones I can coach don t forget about me Cowboys owner has thought about that many times since via 1053thefan brgridiron ,242,2803,22475,25278,photo
CompanyJ_10906, I know you can read and seeing I haven t been playing defense the last couple of years but it s a new year Bron arguing with the ref about a foul via briansher18 IG ,166,10434,64461,74895,video
CompanyJ_10907,At two years old his birth father died saving him from drowning At 11 his brother died after being struck by lightning PSU s Yetur Gross Matos says he wouldn t be where he is today a projected top 20 pick without his stepfather He s our superhero ,247,670,4198,4868,photo
CompanyJ_10908,Everyone s getting in on the basketball challenge ,50,1310,8838,10148,video
CompanyJ_10909,What if ,8,5105,38848,43953,photo
CompanyJ_10910,Cam Reddish s lane switched to bowling From B R x JCPenney ,59,72,680,752,video
CompanyJ_10911,Game s gotta mean this much via AJFeldmanTV ,44,787,5567,6354,video
CompanyJ_10912,Le Veon calls out the NFL and says he s not taking any more random blood tests brgridiron ,90,400,3291,3691,photo
CompanyJ_10913,Kawhi and PG will take the court for the first time together tonight per NotoriousOHM and wojespn ,98,2401,13162,15563,photo
CompanyJ_10914,Switched hands midair via jasonmalbrue IG ,42,3731,24732,28463,video
CompanyJ_10915,NCAA has suspended potential No 1 pick James Wiseman for 12 games will clear him on Jan 12 ,91,570,3482,4052,photo
CompanyJ_10916,You never expect it to happen and then it does brfootball ,58,414,5473,5887,photo
CompanyJ_10917,The West could ve looked real different ,40,915,8708,9623,photo
CompanyJ_10918,Ben Simmons officially hits the first 3 of his career ,54,20280,91774,112054,video
CompanyJ_10919,New NBA logo ,13,4201,30185,34386,photo
CompanyJ_10920,Morris threw down Embiid and he wasn t having it ,49,1426,11649,13075,video
CompanyJ_10921,Coming off a 40 point triple double Luka just dropped 22 PTS 5 6 3PT 5 REBS 5 ASTS in the first quarter ,104,4742,31239,35981,photo
CompanyJ_10922,At the half Luka has 33 points Warriors have 38 ,48,5397,45848,51245,photo
CompanyJ_10923,Kelly Oubre has officially retired the Supreme sleeve brkicks ,62,278,3417,3695,photo
CompanyJ_10924,Simmons to his 3PT doubters ,28,701,5139,5840,video
CompanyJ_10925,Luka making more history ,25,1494,8654,10148,photo
CompanyJ_10926,Kawhi to PG for 3 The first of many via NBA ,44,502,5497,5999,video
CompanyJ_10927,18 PTS for D Rose in his return to Chicago ,43,1129,9930,11059,video
CompanyJ_10928,Donovan dropped RoCo ,21,1648,11179,12827,video
CompanyJ_10929,You good Russ ,14,3744,33542,37286,video
CompanyJ_10930,Kyrie and KD leading the Nets bench celebrations now ,53,636,5710,6346,video
CompanyJ_10931,Luka couldn t contain himself after JJ Barea faked like he was checking in ,75,5903,45413,51316,video
CompanyJ_10932,KAWHI ENDED HIM via NBA ,24,11602,63018,74620,video
CompanyJ_10933,TATUM DROPPED PG via nba ,25,19486,86596,106082,video
CompanyJ_10934,Board Man poster ,17,2516,16952,19468,photo
CompanyJ_10935,Three years away from the start of the next World Cup brfootball ,65,398,3627,4025,photo
CompanyJ_10936,Bronny making his official debut for Sierra Canyon today brhoops ,65,4049,29673,33722,video
CompanyJ_10937, DwyaneWade is passing the torch to D Angelo Russell Dloading exclusively announces on brkicks that he s becoming the face of Li Ning s Way of Wade brand ,154,2229,11789,14018,video
CompanyJ_10938,Which city is the Mecca of basketball A thread Chicago ,55,825,3592,4417,video
CompanyJ_10939,This Kawhi poster better in person via leandrogeoffrey yojameson IG ,68,1302,11192,12494,video
CompanyJ_10940,Andy Ruiz was 6 2 and 268 pounds when he upset Anthony Joshua the first time For the rematch he wants to get down to 255 The chubby champ isn t concerned the weight loss will hurt him as a fighter but some experts are ,218,193,1707,1900,photo
CompanyJ_10941,Luke s father was deployed in Afghanistan for the last year He surprised his son last night at the Rangers game via NHLonNBCSports ,131,1252,11072,12324,video
CompanyJ_10942,Naz Carter NBA bound Jay Z s nephew is lighting it up in Washington playing alongside 5 star recruits ,102,702,5330,6032,video
CompanyJ_10943,People have their opinions of LaMelo already but MirinFader spent two weeks in Australia with him to find out what his life is really like,138,301,1879,2180,status
CompanyJ_10944,Masai Ujiri was ranked most influential Torontonian of 2019 Traded DeRozan for a season of Kawhi Replaced COY Dwane Casey with Nick Nurse Brought the city its first NBA championship More to come ,195,604,4655,5259,photo
CompanyJ_10945,Real life heroes All Star athletes Watch these stories come to life on the new season of B Real StateFarm Help push it forward by donating to great causes and you can win a Mercedes G 550 ,188,12,100,112,video
CompanyJ_10946,LA got loud when Tatum dropped PG via edforthewin_ IG ,54,2750,20134,22884,video
CompanyJ_10947,Only running backs to ever get a 9 9 in Madden Barry Sanders Marshall Faulk LaDainian Tomlinson Chris Johnson Adrian Peterson Christian McCaffrey joined the club today via Panthers ,181,13727,82750,96477,video
CompanyJ_10948,HOFer Mike Singletary surprises his former high school team with new gear for the season From Ford X B R PFHOF ,111,86,850,936,video
CompanyJ_10949,One of the best MVP races in years brgridiron ,46,569,5063,5632,photo
CompanyJ_10950,Texans are ready Mortal Kombat vibes for the linebackers ahead of TNF via nflnetwork ,85,3782,24931,28713,photo
CompanyJ_10951,Allen has his point guard s back ,33,651,6860,7511,photo
CompanyJ_10952,This week might be the long awaited OBJ breakout YahooFantasy ,62,35,378,413,video
CompanyJ_10953,Melo stayed ready and patient before the Blazers gave him the call via NBAonTNT ,80,614,4475,5089,video
CompanyJ_10954,Melo with no hesitation ,24,3601,28728,32329,video
CompanyJ_10955,Stay Mel0 0 ,12,8552,51175,59727,video
CompanyJ_10956,This one s going in the ridiculous touchdown Hall of Fame via Hudl LynnBowden_1 ,80,3685,17802,21487,video
CompanyJ_10957, NSFW rebound 3PT Classic Melo sequence ,40,4478,26050,30528,video
CompanyJ_10958,Hop always finds his mom and gives her the touchdown ball via NFLonFox ,71,1939,17383,19322,video
CompanyJ_10959,Will Fuller is back 51 yards from Watson like it s nothing via NFL ,67,288,3334,3622,video
CompanyJ_10960,N U K Second touchdown of the night for DeAndre Hopkins Via NFL ,64,702,5031,5733,video
CompanyJ_10961,Money Mayweather coming back ,29,4661,24795,29456,photo
CompanyJ_10962,BI has TAKEN OVER the 4Q ,25,3571,25383,28954,video
CompanyJ_10963,There is no Inside the NBA without TurnerSportsEJ Recently the Turner Sports family surprised EJ to celebrate his 30 years on the iconic show via NBAonTNT ,155,1530,7945,9475,video
CompanyJ_10964,Messi became La Liga s all time top scorer on this day in 2014 He s added 175 more in the last five years brfootball ,117,273,2718,2991,photo
CompanyJ_10965,Best jersey collection gotta belong to obj brgridiron ,54,9246,53544,62790,video
CompanyJ_10966, SergeIbaka says it hurt a little bit when Kawhi decided to leave for the Clippers but ultimately he respected the Klaw s decision to return home New How Hungry Are You with guest cthagod ,188,97,680,777,video
CompanyJ_10967,Nothing more genuine than KDTrey5 and his reactions watching the kids hoop at 2KEmpireClassic brhoops ,102,105,1359,1464,photo
CompanyJ_10968,Ja Morant leads all rookies in scoring and assists Is he also leading the race for Rookie of the Year ,102,999,7681,8680,video
CompanyJ_10969, Get back in the weight room Redskins RB DhaSickest went in on Carson Wentz StateFarm ,86,147,1164,1311,video
CompanyJ_10970, Drake s new art is a masterpiece ,34,12919,73112,86031,photo
CompanyJ_10971,Donovan Mitchell and Eric Paschall have a bond as inseparable as blood brothers ,80,912,8805,9717,video
CompanyJ_10972,Marcus Smart on comparison to Pat Bev I m on another level no offense to Pat but step up his game a little bit and we ll see via GwasburnGlobe ,143,3224,26143,29367,video
CompanyJ_10973,As a G Leaguer with the Warriors Kendrick Nunn started modeling his daily routine off KD s and Steph s Now he s the Heat s breakout star In this game rent is due every day ,172,871,7129,8000,photo
CompanyJ_10974,HOFer champbailey surprised and gifted Charlton County High School with brand new laptops From Ford X B R PFHOF ,112,72,415,487,video
CompanyJ_10975,Drake will be making sad rap love songs about the Raptors this year cuz that s how bad the Raptors are gonna be cthagod didn t have any hope for the Toronto Raptors this season ,177,74,603,677,video
CompanyJ_10976,The Kyrie 6 just dropped at Uncle Drew s Bodega It s been a long time in the making brkicks ,92,436,3025,3461,video
CompanyJ_10977,Seven years ago today the Butt Fumble happened via nflthrowback ,64,1372,8246,9618,video
CompanyJ_10978,CP3 made sure he got out of LeBron s way ,41,2207,18179,20386,video
CompanyJ_10979,O B J LBJ with the one handed snag and assist to KCP at the buzzer ,67,9293,53906,63199,video
CompanyJ_10980,AD AND BRON ACTIVATE SHOWTIME ,30,2874,19053,21927,video
CompanyJ_10981,Coach K makes history Mike Krzyzewski breaks John Wooden s record for most wins when coaching an AP No 1 team with 218 ,119,709,4710,5419,photo
CompanyJ_10982,Kemba Walker being stretchered off the court after colliding with teammate Semi Ojeleye ,88,3442,21792,25234,photo
CompanyJ_10983,Kemba Walker has been diagnosed with concussion like symptoms ,62,692,6235,6927,photo
CompanyJ_10984,Bron goes jalenramsey with the clutch INT to seal the win vs OKC ,65,1364,12727,14091,video
CompanyJ_10985,Spurs are in the upside down Eighth straight loss for San Antonio they are 5 11 ,80,554,5764,6318,photo
CompanyJ_10986,Peyton Manning told the Nuggets mascot to go deep brgridiron ,61,5419,54459,59878,video
CompanyJ_10987,Kawhi with the game on the line one of the best in the clutch ,62,2346,20222,22568,video
CompanyJ_10988,Lou Will caught fire in the second half ,40,669,7224,7893,photo
CompanyJ_10989,Pat Bev and Russ were still going at it after they both fouled out ,67,5174,36912,42086,video
CompanyJ_10990,Odell made The Catch five years ago today A legendary moment and he did it as a rookie porsche ,95,510,3311,3821,video
CompanyJ_10991,The many faces of a winning Mourinho brfootball ,48,417,6077,6494,photo
CompanyJ_10992,28 years ago today Jordan was getting in the rookie s head Free Throw Mutombo 1991 92 642 MJ Eyed Closed 1 000 Via NBAonTNT ,124,9014,52191,61205,video
CompanyJ_10993, What are you doing ,20,1539,16495,18034,video
CompanyJ_10994,Ja Morant is leading the Rookie of the Year race and HowardBeck doesn t think it s close ,89,1870,12663,14533,video
CompanyJ_10995,Vince Carter s dunk on Dikembe in 99 is still iconic He plays the Raptors for the first time this season tonight ,113,616,3070,3686,photo
CompanyJ_10996,Bama fans give Tua a warm welcome back via UA_Athletics ,56,241,2779,3020,video
CompanyJ_10997,NBA NBPA and broadcast partners are engaged in serious discussions on sweeping and dramatic changes to the league calendar that would include per wojespn and ZachLowe_NBA 30 team in season tournament Postseason play in games Reseeding four conference finalists ,261,830,5594,6424,photo
CompanyJ_10998,Just one week after suffering a season ending hip injury Tua returned to Bama to support his teammates Class act ,113,414,5540,5954,photo
CompanyJ_10999,Ohio State marching band cut up a Michigan logo at halftime Buckeyes and Wolverines play next week via TheWilderThings ,119,4976,26981,31957,video
CompanyJ_11000,Justin Fields with an absolute DIME Doesn t get much better than this via CFBONFOX ,83,513,3937,4450,video
CompanyJ_11001,ANOTHER PENN STATE FUMBLE RECOVERY via CFBONFOX ,48,178,1399,1577,video
CompanyJ_11002,Harvard Yale game delayed by student protest over climate injustice via lim_woojin ,83,2012,13215,15227,video
CompanyJ_11003,Chase Young can t be contained via CFBONFOX ,44,437,3690,4127,video
CompanyJ_11004,Tua s little brother Taulia threw his first TD pass today and their parents were in the stands to celebrate What a moment for the Tagovailoa family ,148,1444,16461,17905,video
CompanyJ_11005,Chase Young broke the Ohio State single season sack record in his return vs Penn State Ready to hunt down NFL QBs brgridiron ,125,4183,24578,28761,photo
CompanyJ_11006, KingJames wasn t happy about his pregame nap being interrupted by a concert ,77,5056,35129,40185,video
CompanyJ_11007,Jonathan Taylor 12 now has the most 200 yard rushing games in FBS history ,74,987,6579,7566,photo
CompanyJ_11008,Spurs are 5 11 but Pop doesn t believe it ,42,514,5998,6512,photo
CompanyJ_11009,Fultz put Aaron Holiday on skates ,34,3868,21875,25743,video
CompanyJ_11010,Trae Wild ,10,4315,31010,35325,video
CompanyJ_11011,MALIK MONK CLEARED FOR TAKEOFF ,31,4682,34028,38710,video
CompanyJ_11012,Too tough to stay in front of Ja ,33,1209,10612,11821,video
CompanyJ_11013,Zach LaVine stole the ball and the game from the Hornets LaVine had 49 to help Bulls come back from down 5 with 14 sec left ,124,18496,74764,93260,video
CompanyJ_11014,Spida with the hammer and stare down ,37,1653,10695,12348,video
CompanyJ_11015,Ja is putting on a show against the Lakers ,43,4589,31013,35602,video
CompanyJ_11016,AD and Bron came through in the clutch when the Lakers needed them most ,72,1882,14360,16242,video
CompanyJ_11017,DOWN GOES NO 6 OREGON ASU pulls through to win 31 28 stunning the Ducks in Tempe ,81,906,6536,7442,photo
CompanyJ_11018,Jayden Daniels launched it out to Brandon Aiyuk for the 81 yard TD to stun Oregon From B R x BassProShops ,106,268,2286,2554,video
CompanyJ_11019,The Hoosiers didn t stand a chance on Nico Collins breakaway TD exxonmobil ,75,1655,11725,13380,video
CompanyJ_11020,Good night Ortiz Deontay Wilder beats Luis Ortiz via KO to move to 41 0 1 ,74,4037,19760,23797,photo
CompanyJ_11021,Deontay Wilder looks forward to a unification bout with Tyson Fury in February via SkySportsBoxing ,99,1185,6475,7660,video
CompanyJ_11022, 42 0 41 KOs That s a bad man ,30,4792,28665,33457,photo
CompanyJ_11023,Ed Reed surprised military veteran and Ravens superfan Captain Dee Fense From Ford X B R PFHOF ,95,382,2031,2413,video
CompanyJ_11024,Cam Newton is serving Thanksgiving meals to 1 300 underprivileged kids tomorrow for the eight straight year Everyone gets free food and another meal to make at home brgridiron via jmarusak ,189,9191,49322,58513,photo
CompanyJ_11025, SLAY THIS GIANT Michael Irvin went off via NFLGameDay ,55,3275,11830,15105,video
CompanyJ_11026,Zach LaVine got benched by Bulls coach Jim Boylen for making egregious defensive errors on Friday LaVine felt disrespected His response on Saturday 49 PTS 17 28 FG 13 17 3PT Game winner ,186,5245,36399,41644,photo
CompanyJ_11027,Don t get caught sleeping before a pivotal week TheMattCamp is dropping knowledge on everything you need this week Watch Your FantasyFireDrill NOW ,147,9,62,71,link
CompanyJ_11028,Only OBJ via FOXSports ,23,2093,11847,13940,video
CompanyJ_11029, spidadmitchell is jumping out the gym and off your screen ,59,156,1746,1902,video
CompanyJ_11030,Browns fans are using a helmet to hit a Mason Rudolph piñata via clevelanddotcom ,81,7426,33458,40884,video
CompanyJ_11031,Don t know which is better the fake or the throw by Russell Wilson via NFL ,75,2613,20281,22894,video
CompanyJ_11032,Jameis threw a pick on his first possession He made this incredible throw on his next via Buccaneers ,101,429,3979,4408,video
CompanyJ_11033,OBJ scores his first TD since Week 2 Back to his old self via NFL ,66,1044,8360,9404,video
CompanyJ_11034,A fan snuck a whole pumpkin pie and whipped cream into the Bears game Perfect use of slow mo brgridiron via ErnestWilkins ,122,1358,11654,13012,video
CompanyJ_11035,Mike Evans doing what only the has done brgridiron ,51,2507,18604,21111,photo
CompanyJ_11036,Mike Evans and Chris Godwin are both over 1 000 receiving yards this season Special duo in Tampa Bay ,101,1053,9236,10289,photo
CompanyJ_11037,1 Emmitt 2 Payton 3 FRANK GORE Legendary career continues brgridiron ,69,1757,10100,11857,photo
CompanyJ_11038,Time to include Cantguardmike in the MVP convo 10 grabs for 101 and a score today ,82,1685,8115,9800,photo
CompanyJ_11039,Frank Gore thanked all his coaches lineman and anyone who s blocked for him after passing Barry on the all time rushing list via NFLonCBS ,138,4140,25208,29348,video
CompanyJ_11040,Tom Brady has now thrown a TD pass to 75 different players brgridiron Incredible ,81,1497,13729,15226,photo
CompanyJ_11041,DERRICK HENRY 74 YARD HOUSE CALL He does it again vs the Jags via NFL ,70,2292,17605,19897,video
CompanyJ_11042,Randall Cobb goes 59 yards then catches his own fumble via NFL ,63,284,3340,3624,video
CompanyJ_11043,Cowboys fans right now brgridiron ,34,1106,5099,6205,photo
CompanyJ_11044,Patriots were haunting Dak today ,33,593,3254,3847,video
CompanyJ_11045,Richard Jefferson said he knew it was time to retire when the Knicks offered him a contract ,92,6598,39677,46275,video
CompanyJ_11046,Luka on how the Mavs improved their defense this season Last year we had Dirk on defense so it was tough via espn_macmahon ,123,4871,42522,47393,video
CompanyJ_11047,49ers get a strip sack on Rodgers and score a TD right away What a start via NFL ,81,481,4161,4642,video
CompanyJ_11048,Pats keep making history brgridiron ,36,424,3196,3620,photo
CompanyJ_11049,A member of the Packers equipment staff s mom has cancer Za Darius Smith made sure he was gonna shout her out if he got a sack tonight Well done ,145,3941,34935,38876,photo
CompanyJ_11050,Lou Will doing his best Kawhi impersonation via LAClippers ,59,4647,35744,40391,video
CompanyJ_11051,DEEBO TOO QUICK via thecheckdown ,33,407,4017,4424,video
CompanyJ_11052,The game comes too easy for Nikola Jokic ,41,1420,13473,14893,video
CompanyJ_11053,Rodgers connects with Tae Adams for 6 Packers officially on the board via NFL ,78,77,1096,1173,video
CompanyJ_11054,Jimmy G George Kittle 61 yard TD via NFL ,41,770,6275,7045,video
CompanyJ_11055,Packers get smacked 37 8 in SF ,31,14909,62881,77790,video
CompanyJ_11056, You ll remember my name I got two sacks on your ass Shaq Lawson confronted Broncos OL Connor McGovern postgame he said McGovern told him earlier he d never heard of him via thadbrown7 ,185,7816,53460,61276,video
CompanyJ_11057,LaMelo Ball went for a 32 point triple double and came up clutch with the game tying three in an OT win He s 18 years old via NBL ,130,3707,16243,19950,video
CompanyJ_11058,Messi playing with his son Ciro is too sweet via antonelaroccuzzo IG ,69,1625,18256,19881,video
CompanyJ_11059,Stacked ,8,1474,7310,8784,photo
CompanyJ_11060,Mason Rudolph got benched yesterday but Browns tackle Sheldon Richardson wants to see him out there for the rematch Did you see him last game via RuiterWrongFAN ,161,368,3204,3572,video
CompanyJ_11061,32 PTS 11 REB 13 AST LaMelo brhoops ,36,2830,21757,24587,photo
CompanyJ_11062,National hero Cultural Icon Obsession Tottenham s Son Heung min is larger than life in South Korea Son is the meaning of life brfootball verizon ,145,294,1780,2074,video
CompanyJ_11063,This is Alex Caruso s world We re just living in it ,52,7569,49936,57505,video
CompanyJ_11064,The Newmans are viral hoops sensations but their father says don t compare them to the Balls Julian and Jaden got famous because of themselves ,143,56,842,898,photo
CompanyJ_11065, brgridiron ,12,890,10143,11033,photo
CompanyJ_11066,Curtis Martin gives back to where it all began for him his high school Getting to the Hall of Fame started right here From Ford X B R PFHOF ,140,59,448,507,video
CompanyJ_11067,This is incredible via vanja_rolandsgarden IG ,46,18893,119614,138507,video
CompanyJ_11068,When Ronaldo scored from DISTANCE against Arsenal in the Champions League semi finals Follow brfootball for the best of the UCL ,128,963,6091,7054,video
CompanyJ_11069,24 seconds of straight 3s from Luka via dallasmavs ,51,1286,13103,14389,video
CompanyJ_11070,Why d Jamal Adams do Derek Carr s brother like this Stop living through your brothas You need to focus on your lil high school job ,131,3042,20931,23973,photo
CompanyJ_11071,She was living in an abandoned house at 21 and didn t start boxing until she was 22 Now Team USA champ Naomi Graham has eyes on Olympic gold in Tokyo 2020 StateFarm New B Real ,176,255,1168,1423,video
CompanyJ_11072,Gilbert Arenas shot Swaggy P with a BB gun during an NBA gun awareness meeting via CertifiedBckts ,98,4128,16383,20511,video
CompanyJ_11073,Neymar is feeling the hate ever since he tried to leave for Barcelona New episode of TheChampions PlayStation ,110,1093,4271,5364,video
CompanyJ_11074,2009 2019 Decade full of stars brgridiron brfootball ,53,2009,13962,15971,photo
CompanyJ_11075,Lamar getting MVP chants in LA tonight brgridiron via Ravens ,61,1521,14914,16435,video
CompanyJ_11076,Kevin Porter Jr over TWO Nets ,30,1394,7741,9135,video
CompanyJ_11077,Trae had him lost ,18,813,5383,6196,video
CompanyJ_11078,Lamar goes to Hollywood Ravens strike first via Ravens ,55,581,4540,5121,video
CompanyJ_11079,Melo finding his groove He just dropped 12PTS on 5 8 shooting in the quarter ,77,5155,29978,35133,video
CompanyJ_11080,L A M V P A R Second TD pass to Hollywood in the first quarter via NFL ,71,1792,11458,13250,video
CompanyJ_11081,Still got the burst in year 17 ,31,3442,21650,25092,video
CompanyJ_11082,Lamar s checklist Pick up bobbled snap Avoid the sack Make the defense miss Set up the Ravens for their third TD of the half via NFL ,133,1043,7277,8320,video
CompanyJ_11083,Lamar is shining bright in LA 3 TDs 80 rushing yards Ravens up 28 6 at halftime Out gaining Rams 167 99 on his own MVP business brgridiron ,139,1130,7005,8135,photo
CompanyJ_11084,THROW IT DOWN MELO ,19,6013,33145,39158,video
CompanyJ_11085,Drake made sure to show love to Embiid who scored 0 points against the Raptors tonight via TSN_Sports ,102,4964,39473,44437,video
CompanyJ_11086,Melo finished with 25PTS and 8REBS tonight His son Kiyan got to celebrate with him over Facetime via trailblazers ,114,12142,74199,86341,video
CompanyJ_11087,How many touchdowns does Lamar Jackson have tonight brgridiron ,63,1806,7837,9643,photo
CompanyJ_11088,Giannis statline was insane tonight 50 PTS 14 REBS 6 ASTS 2 STLS ,65,2237,13281,15518,video
CompanyJ_11089,The Ravens are a vibe ,22,6956,40615,47571,video
CompanyJ_11090,Rams 221 yards weren t enough to keep up with Lamar brgridiron ,63,1287,8198,9485,photo
CompanyJ_11091,Jalen Ramsey had to be held back from Ravens players on the way to the locker room after tonight s game via KHOLMESlive ,120,1849,14517,16366,video
CompanyJ_11092,Dybala loved Ronaldo getting nutmegged Ronaldo did not via brfootball ,70,555,7596,8151,video
CompanyJ_11093,Lamar s evolution as a passer has been unreal No 1 passing TD tied No 1 TD No 3 QB rating Only QB with 5 TDs twice Unstoppable ,127,3543,22913,26456,photo
CompanyJ_11094,Jose Mourinho is back in the Champions League via brfootball ,61,205,2129,2334,video
CompanyJ_11095,Gifted this kid the shoes right off his feet KingJames via abovecms tiktok ,75,11437,92407,103844,video
CompanyJ_11096,Giannis MVP season 27 7 PTS 5 9 AST 12 5 REB Giannis through 17 games this season 31 1 PTS 6 4 AST 13 9 REB ,108,1157,9144,10301,photo
CompanyJ_11097,Big games high stakes in the Champions League today Follow brfootball for the best of the UCL ,94,84,932,1016,photo
CompanyJ_11098,Cam giving back On Monday the former MVP served meals to underprivileged kids for the eighth year in a row Over 1 300 got a Thanksgiving dinner and another meal to take home via CLTure ,185,4893,31936,36829,video
CompanyJ_11099,Mbappe will play his 100th game for PSG today and he s not even 21 yet brfootball ,82,943,11602,12545,photo
CompanyJ_11100,Anthony Gordon was a zero star recruit without a significant snap in four years Now the fifth year QB at Washington State leads the nation by 906 passing yards and four TDs and is drawing comparisons to Patrick Mahomes ,219,451,2825,3276,photo
CompanyJ_11101,KAT and Wiggins are the NBA s breakout duo this season ,55,927,6969,7896,video
CompanyJ_11102,Ravens LB Matthew Judon took a swig in the blowout brgridiron via samsteffanina IG ,83,3649,32203,35852,video
CompanyJ_11103,WHAT via SchwaigerJ zoehipel IG ,32,585,5073,5658,video
CompanyJ_11104,Real Madrid are into the knockout stages of the Champions League for the 23rd consecutive year Twenty three years straight brfootball ,134,158,1042,1200,photo
CompanyJ_11105,Headbands really making a comeback this year ,45,154,2065,2219,video
CompanyJ_11106,Eden Hazard beat two players and then nutmegged the ref via brfootball ,71,241,1696,1937,video
CompanyJ_11107,Lakers hit up a Mexican restaurant after beating the Spurs You know what these fans got Bron to yell via Ooh_Rhiann ,116,26158,138391,164549,video
CompanyJ_11108,OH MY DYBALA brfootball ,24,1830,8919,10749,video
CompanyJ_11109,On Thanksgiving 21 years ago today Randy Moss put up one of the most iconic stat lines of all time brgridiron ,110,7517,41051,48568,photo
CompanyJ_11110,Rihanna out watching Juventus in the Champions League ,54,862,7197,8059,video
CompanyJ_11111, New two minute GridironHeights special The great MVP race gets the go kart treatment PlayStation ,98,684,3065,3749,video
CompanyJ_11112,Real Madrid really blew a 2 0 lead in 3 minutes to draw 2 2 with PSG brfootball ,80,484,3946,4430,video
CompanyJ_11113,Ballboy s quick play helped Tottenham score so Mourinho gave him props for the assist via brfootball ,101,3308,16338,19646,video
CompanyJ_11114,His energy is unmatched via tboogss IG ,39,1113,5869,6982,video
CompanyJ_11115,EMONI BATES DESTROYED HIM brhoops ,34,927,5651,6578,video
CompanyJ_11116,KP really got a shirt with Boban s face via dallasmavs ,55,614,9330,9944,video
CompanyJ_11117,PAUL GEORGE 17 PTS in the first quarter for PG13 ,49,1502,13360,14862,video
CompanyJ_11118,Luka did not like this call ,28,298,4613,4911,video
CompanyJ_11119,Describe the Mavs uniforms in one word ,39,1242,18529,19771,photo
CompanyJ_11120,Bradley Beal is back in Denver so he had to make the famous face via WashWizards ,81,3807,32169,35976,video
CompanyJ_11121,Cassius Stanley can get UP via FOXSportsSouth ,46,342,2943,3285,video
CompanyJ_11122,Stephen F Austin takes down Duke at Cameron Indoor Stadium Duke loses at home to a non conference opponent for the first time since 2000 previously winning the last 150 games in Durham ,185,2939,16283,19222,photo
CompanyJ_11123,Layup that ended a 19 year streak Stephen F Austin STUNNED Duke in the last second via FOXSportsSouth ,102,6369,35364,41733,video
CompanyJ_11124,How Stephen F Austin arrived to Duke before upsetting them ,59,789,5200,5989,photo
CompanyJ_11125,Lamar makes Madden history brgridiron ,38,3715,29824,33539,photo
CompanyJ_11126,12 years ago today we lost a legend before his prime The great Sean Taylor died from a gunshot wound protecting his family from armed robbers He was only 24 ,157,26891,104678,131569,photo
CompanyJ_11127,Joao Felix wins the 2019 Golden Boy award for best young player in Europe via LaLigaEN ,87,114,1015,1129,video
CompanyJ_11128,What happened here via u loveshack007 ,38,692,6019,6711,video
CompanyJ_11129,Two Wolverine legends Ty Law and Tom Mack surprised kids at the Children s Hospital with gifts after being honored as Ford Hometown HOFers From Ford X B R PFHOF ,161,21,175,196,video
CompanyJ_11130,The Clippers aren t playing nice ,33,253,3048,3301,photo
CompanyJ_11131,Dybala s touch ,15,180,2037,2217,video
CompanyJ_11132,Santana Moss says Dan Snyder wanted him to play through injury vs the Cowboys he ended up drinking half a Gatorade bottle of Henny and took Toradol and Vicodin New Untold Stories with MasterTes ,194,1001,3191,4192,video
CompanyJ_11133,Brow returns to NOLA as a Laker tonight How we got here in 60 seconds ,70,770,5367,6137,video
CompanyJ_11134,Hines Ward was one of the game s complete receivers Does the former Super Bowl MVP belong in the ProFootballHOF Vote now From B R X FordTrucks PFHOF20 ,151,33,335,368,video
CompanyJ_11135,Maurizio Sarri on Dybala s goal The first thing a coach thinks is What the f k are you doing shooting from there ,113,214,2040,2254,video
CompanyJ_11136, I went through the stands and threw up a deuce one Because that s how I got to pay tribute every week Showin him that we out here doin it still for him Santana Moss remembering his late friend Sean Taylor ,206,410,1906,2316,video
CompanyJ_11137,Brandon Ingram opens up on his struggles with the Lakers and questioning whether he d make a full recovery after blood clot ,124,1956,14317,16273,status
CompanyJ_11138,Family flies together Jumpman23 ,32,195,1192,1387,video
CompanyJ_11139,Hold the tributes Melo s not done ,34,1652,10750,12402,photo
CompanyJ_11140,Kawhi had Sam Cassell ROLLING on the bench ,43,2407,26714,29121,video
CompanyJ_11141,What Spicy P is doing shouldn t be possible says HowardBeck MIP MVP ,68,359,2542,2901,video
CompanyJ_11142, Go ahead goal First Champions League goal for Chelsea cpulisic_10 ,67,164,1575,1739,photo
CompanyJ_11143,Christian Pulisic comes up big for Chelsea brfootball ,54,112,1325,1437,video
CompanyJ_11144,Messi makes his 700th appearance for Barcelona today He made his first in 2004 brfootball ,90,510,3787,4297,photo
CompanyJ_11145,W O W ,6,1440,7775,9215,video
CompanyJ_11146,Sergino Dest no look pass to set up Ajax s goal ,48,157,1918,2075,video
CompanyJ_11147,Suarez gt Messi Too easy brfootball ,36,541,4115,4656,video
CompanyJ_11148,Dame really designed a shoe after a heckler he humbled in Orlando brkicks ,74,2363,16641,19004,video
CompanyJ_11149,Messi goal two assists Suarez goal assist Griezmann goal Barcelona s front three brfootball ,92,275,2047,2322,video
CompanyJ_11150,Only right that Zeke eats on Thanksgiving YahooFantasy ,55,35,396,431,video
CompanyJ_11151,Salzburg s Erling Haaland has 27 goals in 19 appearances in all competitions this season He s 19 ,97,334,2867,3201,photo
CompanyJ_11152,Messi after 700 games for Barcelona 613 goals 250 assists Unreal numbers ,73,3090,21530,24620,photo
CompanyJ_11153,Celtics fans at TD Garden started a Kyrie sucks chant via NBCSCeltics ,70,909,5281,6190,video
CompanyJ_11154,Dame Jr looks ready to suit up via trailblazers ,48,2052,22985,25037,video
CompanyJ_11155,That was tough kevinporterjr ,29,1372,8922,10294,video
CompanyJ_11156,Giannis just bullied Vince ,27,4777,37206,41983,video
CompanyJ_11157,How many steps did RJ take ,27,4208,35014,39222,video
CompanyJ_11158,Kendrick Nunn with the chasedown block on Russ ,47,1501,10220,11721,video
CompanyJ_11159,Trae beat the buzzer ,21,467,5202,5669,video
CompanyJ_11160,On Friday Kemba sustained a neck strain after a scary collision with a teammate and had to be carted off on a stretcher Tonight he dropped a season high 39 PTS in a win over the Nets ,183,1340,9064,10404,video
CompanyJ_11161,Brow getting all the boos in NOLA via NBATV ,44,571,5585,6156,video
CompanyJ_11162, J A ,5,1147,9234,10381,video
CompanyJ_11163,DBook destroyed him ,20,939,6252,7191,video
CompanyJ_11164,Let this man commentate every NBA game via jdougie08 Instagram ,63,3263,25318,28581,video
CompanyJ_11165, I got it Hassan get outta here Melo wanted that rebound ,57,2194,16121,18315,video
CompanyJ_11166, Great vibes surfer Klay The Warriors are having Klay do play by play tonight and had him rank all his bobbleheads ,115,509,3888,4397,video
CompanyJ_11167,LaVine s dunks are too mean ,28,1628,11156,12784,video
CompanyJ_11168,33k club The King s in good company ,36,8876,47638,56514,photo
CompanyJ_11169,Melo gets a standing ovation as he exits the game with 19 PTS on 9 11 shooting via NBCSNorthwest ,97,4084,26766,30850,video
CompanyJ_11170,AD s return to NOLA was one for the books 41 PTS 9 REBS Lakers get the W over the Pels ,87,3244,16401,19645,video
CompanyJ_11171,Bron Brow duo is scary LeBron tonight 29 PTS 5 REBS 11 ASTS AD tonight 41 PTS 9 REBS 2 STLS 9 wins in a row for the Lakers ,123,2888,17273,20161,photo
CompanyJ_11172,AD felt right at home against his former team tonight ,54,643,5777,6420,photo
CompanyJ_11173, ,1,1788,14903,16691,photo
CompanyJ_11174,18 years old via NBL ,21,6215,34156,40371,video
CompanyJ_11175,Madden raised Lamar s speed rating to 96 the highest ever for a QB LJ says it s still too low via Ravens ,105,1753,16603,18356,video
CompanyJ_11176,Melo s last two games 25 PTS 10 20 FG 19 PTS 9 11 FG ,53,2629,17416,20045,photo
CompanyJ_11177,Start David Montgomery vs the Lions Can you trust Amari Is Latavius Murray a sleeper TheMattCamp has answers for all your fantasy questions today before you settle in for Thanksgiving FantasyFireDrill ,201,7,77,84,video
CompanyJ_11178,We need sideline reporter Klay every game until he gets back via NBCSAuthentic ,79,1830,14603,16433,video
CompanyJ_11179,All day Thanksgiving football brgridiron ,41,324,2837,3161,photo
CompanyJ_11180,DAVID BLOUGH IS NOT HERE TO MESS AROUND First completion is a 75 yard TD to Kenny Golladay via Lions ,101,854,7501,8355,video
CompanyJ_11181,Bron tried to give this young fan a sleeve and wristband but they got intercepted by adults King did him one better with game worn sneakers Little man broke down in tears via billoram hmfaigen ,193,4015,39553,43568,video
CompanyJ_11182,Marvin Jones had to carve the turkey after his Thanksgiving TD via NFLonFOX ,76,349,3781,4130,video
CompanyJ_11183,Bobby Wagner was buying Thanksgiving meals for people in lower income Seattle areas on Tuesday when he decided to quietly pick up the tab for everyone in the store The star LB left before any cameras showed up ,210,16056,108769,124825,photo
CompanyJ_11184,Trubisky DIMED this one for six via NFL ,40,222,2572,2794,video
CompanyJ_11185,Lamar makes it look this easy via realDockery ,46,4531,23532,28063,video
CompanyJ_11186,Conor McGregor vs Donald Cowboy Cerrone set for UFC 246 on Jan 18 per danawhite bokamotoESPN The fight will be at welterweight 170 LBS ,135,4935,18431,23366,photo
CompanyJ_11187,Cowboys fans at the table during Thanksgiving brgridiron ,57,3311,18973,22284,photo
CompanyJ_11188,Bills made sure the Cowboys didn t have a happy Thanksgiving brgridiron ,72,1528,9896,11424,photo
CompanyJ_11189,Taysom Hill dominating on all cylinders Blocked punt 2 receptions Touchdown via thecheckdown ,93,1172,12330,13502,video
CompanyJ_11190, If we don t got y all respect now we got this s t They gon respect Bills Mafia We built different NSFW Shaq Lawson s message to the NFL via thadbrown7 ,152,2989,23754,26743,video
CompanyJ_11191,ANOTHER Taysom Hill TD Much more than just a QB via NFL ,56,590,5782,6372,video
CompanyJ_11192,MATT RYAN GOT STIFF ARMED INTO OBLIVION via NFL ,48,9088,54287,63375,video
CompanyJ_11193,Falcons recover back to back onside kicks via NFL ,50,865,8475,9340,video
CompanyJ_11194,Taysom Hill was feasting on Thanksgiving brgridiron ,52,937,8917,9854,photo
CompanyJ_11195,Breaking Arsenal fires manager Unai Emery after their longest run without a win since 1992 brfootball ,102,1205,5921,7126,photo
CompanyJ_11196,Landon Collins goes back to Bama to tailgate with the Ultimate CFB Fanbase From B R x RightGuardUS ,99,35,371,406,video
CompanyJ_11197,Part II RjHampton14 vs MELOD1P These top five prospects are showtime already ,77,300,2617,2917,video
CompanyJ_11198,The No 1 PG in Class of 2022 making his debut tonight 3Diorjohnson s time is now brhoops ,89,346,2306,2652,video
CompanyJ_11199,Auburn alum Daren Bates playing radio call of 2013 s Kick Six while Alabama alum Derrick Henry is being interviewed Rivalry Week doesn t sleep in the Titans locker room via jwyattsports ,186,2042,14735,16777,video
CompanyJ_11200,Isaac Bruce will be remembered as one of the Rams all time greats Will he also be in the ProFootballHOF Vote now From B R X FordTrucks PFHOF20 ,143,43,249,292,video
CompanyJ_11201,Heisman contender Chuba Hubbard s family experienced poverty while he was growing up in Canada He wants to make it in the NFL so he has a platform to build his nonprofit and help kids like him ,193,485,2396,2881,photo
CompanyJ_11202,Brooklyn claps back at Celtics fans during Kemba s free throws Kyrie s better ,78,1356,13083,14439,video
CompanyJ_11203,Why he jab stepping in his free throw routine via daniii_s4 ,60,5578,43343,48921,video
CompanyJ_11204,Kyrie showed love to the Celtics players after the game ,56,3337,28330,31667,video
CompanyJ_11205, 1 Ohio State and 13 Michigan look to add another chapter tomorrow in The Game Harbaugh is 0 4 against the Buckeyes does that change Wendys ,140,62,668,730,video
CompanyJ_11206,Juwan Howard celebrating with his team after winning the Battle 4 Atlantis Michigan has started this season 7 0 via umhoops ,124,4526,27144,31670,video
CompanyJ_11207,On a mission to make the Celtics miss some free throws via ankit hete IG ,73,245,3117,3362,video
CompanyJ_11208,Giannis throws it down on Kevin Love ,37,888,8040,8928,video
CompanyJ_11209,GIANNIS PUTBACK ON TRISTAN ,27,700,6325,7025,video
CompanyJ_11210,Jazz Grizzlies uniform matchup is straight out of the 90 s ,59,6907,47773,54680,photo
CompanyJ_11211,Pacers fans give Vince Carter a standing O during his final game in Indiana ,76,570,6944,7514,video
CompanyJ_11212,Brandon Ingram is a man on a mission this year Spin to the rim for the ,71,2410,18659,21069,video
CompanyJ_11213,Trae had Brogdon going the wrong way then pulled up from deep Unlimited range ,78,1772,16571,18343,video
CompanyJ_11214,Trae Young tied his career high with 49 points in the Hawks 105 104 OT loss to the Pacers The rest of the Hawks starting lineup had 19 points combined ,151,1153,10786,11939,photo
CompanyJ_11215,Bron enters the everlasting debate ,35,4981,29954,34935,video
CompanyJ_11216,Rondo oops it to LeBron for the poster ,39,3628,26137,29765,video
CompanyJ_11217,Khabib Nurmagomedov vs Tony Ferguson for the UFC lightweight title is set for April 18th 2020 in Brooklyn per bokamotoESPN ,123,1659,7038,8697,photo
CompanyJ_11218,Luka bounced back tonight 42 PTS 9 REB 11 AST 12 24 FG 15 18 FT ,64,1968,18878,20846,photo
CompanyJ_11219,Rui Hachimura and Shohei Ohtani got together before the Lakers Wizards game in LA ,82,433,4893,5326,photo
CompanyJ_11220,Melo with the touch pass and the Blazers bench loves it Having fun out there ,77,2201,19908,22109,video
CompanyJ_11221,Lakers were up by 35 so LeBron started shooting with his left hand ,67,13014,96357,109371,video
CompanyJ_11222,BACK TO BACK TRIPLE DOUBLES MELOD1P with 25 PTS 12 REB 10 AST for NBL s first consecutive triple doubles since 2005 ,116,1425,6839,8264,video
CompanyJ_11223,This weekend means a little more Who claims bragging rights ,60,618,4900,5518,photo
CompanyJ_11224,This goal from Kevin De Bruyne is unreal via NBCSportsSoccer ,61,963,5388,6351,video
CompanyJ_11225,Luka Doncic in November 32 4 PTS 10 3 REB 10 4 AST The third player in NBA history to average a 30 point triple double in a single month ,137,3609,23614,27223,photo
CompanyJ_11226,Melo s last three games 23 PTS 11 REB W 19 PTS 4 REB W 25 PTS 8 REB W ,70,6601,37412,44013,photo
CompanyJ_11227,Virgil Van Dijk scored two goals in six minutes for Liverpool He s a defender ,78,196,2145,2341,photo
CompanyJ_11228,Lakers have won 10 straight and are 17 2 their joint best start in franchise history KingJames Easy money via lojomedia ,120,2896,23917,26813,video
CompanyJ_11229,Mourinho and the ballboy brfootball ,36,299,3754,4053,photo
CompanyJ_11230,This kid in the Dominican Republic is hitting bottle tops off a slingshot via coco_jose_12 IG ,94,21191,97014,118205,video
CompanyJ_11231,Kevin Greene said it was an honor to give back to his high school s football program From Ford X B R PFHOF ,107,54,408,462,video
CompanyJ_11232,Michigan players really took off JK Dobbins shoe This rivalry is something else via CFBONFOX ,93,1315,10904,12219,video
CompanyJ_11233,Justin Fields came out of the medical tent in a brace and immediately threw a TD Incredible via CFBONFOX ,105,3060,18032,21092,video
CompanyJ_11234,J K Dobbins TOOK FLIGHT That s now a career high 211 rushing yards and 4 TDs on the day via CFBONFOX ,101,469,3068,3537,video
CompanyJ_11235, J K ALL DAY Dobbins had a field day against Michigan in The Game rushing for a career high 211 yards and 4 TDs ,112,683,4107,4790,photo
CompanyJ_11236,8 straight wins for the Buckeyes in The Game Ohio State has now won the last 15 of 16 meetings with Michigan ,109,1264,7284,8548,photo
CompanyJ_11237,NA EE HARRIS HURDLE via CBSSports ,34,367,2389,2756,video
CompanyJ_11238,Breaking Terrelle Pryor has been arrested on a charge of simple assault after being stabbed earlier this morning per KDKA ,122,1104,4876,5980,photo
CompanyJ_11239,They really won FIFTY to one brfootball ,40,177,1685,1862,photo
CompanyJ_11240,New jerseys and a visit from a Hall of Famer Nothing like it From Ford X B R PFHOF ,83,101,471,572,video
CompanyJ_11241,A U B U R N P I C K S I X via CBSSports ,40,2119,13634,15753,video
CompanyJ_11242,,0,554,6046,6600,photo
CompanyJ_11243,WADDLE AGAIN 4th TD of the game via CBSSports ,46,849,4817,5666,video
CompanyJ_11244,AUBURN WILL NOT BE DENIED Tigers now up 48 45 after 2 point conversion via CBSSports ,85,597,3447,4044,video
CompanyJ_11245,One more time for Broadway Joe in Baton Rouge Chills via LSUFootball ,69,6916,49734,56650,video
CompanyJ_11246, No 15 Auburn STUNS No 5 Alabama 48 45 in a WILD Iron Bowl ,59,3803,22016,25819,photo
CompanyJ_11247,Fan got stuck in a bush trying to rush the field after Auburn s Iron Bowl win over Bama ,88,1260,10105,11365,photo
CompanyJ_11248,THE KICK IS NO GOOD No 15 Auburn escaped No 5 Alabama in a down to the wire Iron Bowl finish 48 45 From B R x BassProShops ,123,801,5421,6222,video
CompanyJ_11249,Bama fans knowing they re going to miss the CFP ,48,2930,13533,16463,video
CompanyJ_11250,Auburn fans celebrating like there s no tomorrow on the field via BarrettSallee ,80,399,3031,3430,video
CompanyJ_11251,Oklahoma runs the Sooner Special to get Jalen Hurts a TD reception via CFBONFOX ,80,813,7627,8440,video
CompanyJ_11252,Ben Simmons comes up clutch with back to back steals to win the game ,69,930,6744,7674,video
CompanyJ_11253,James Harden has a 50 piece It s still the 3rd qtr ,51,1131,8218,9349,photo
CompanyJ_11254,James Harden through 3 quarters 60 PTS 8 AST 3 STL 16 24 FG 20 23 FT Rockets up 54 ,83,5823,32463,38286,photo
CompanyJ_11255,Harden realizing he got benched two points away from his career high ,69,5243,35479,40722,video
CompanyJ_11256,Giannis gifted this fan his game worn shoes after the game brkicks All love via Bucks ,86,1639,16890,18529,video
CompanyJ_11257,Will history repeat itself this year brgridiron ,48,1467,8858,10325,photo
CompanyJ_11258,Michigan State corner Josh Butler s parents both died while he was in college During his final home game he came onto the field accompanied by his two dogs for Senior Day DavidHarns ,182,17510,114945,132455,video
CompanyJ_11259,Destructive Niners defense Record setting Ravens offense Today s gonna be fun ,78,2713,19488,22201,photo
CompanyJ_11260,Beard chasing Mamba Harden in three quarters last night 60 PTS 16 24 FG 29 in the 3rd Kobe s first three quarters when he dropped 81 53 PTS 21 33 FG 27 in the 3rd ,163,888,7203,8091,photo
CompanyJ_11261,The Patriots flew two planes to Houston one for sick players and another to keep the healthy ones away from them Nine are questionable because of an illness via FieldYates ,172,1360,12208,13568,photo
CompanyJ_11262,Hall of Famer Derrick Brooks surprised Big Nasty a Bucs fan who s making a real difference in Tampa From Ford X B R PFHOF ,122,143,880,1023,video
CompanyJ_11263,It s the most critical week of the fantasy regular season Don t be unprepared TheMattCamp has everything you need ahead of a pivotal Week 13 Watch Your FantasyFireDrill NOW ,173,9,68,77,link
CompanyJ_11264,Cameron Sutton s pregame attire for the Steelers Browns rematch It s on via diannaESPN ,87,799,5212,6011,photo
CompanyJ_11265,Memphis does the KD pregame dance as part of their handshake via _UnoTres ,74,5405,34457,39862,video
CompanyJ_11266,Mark Ingram s energy is unmatched Every team needs a guy like him via NFLonFOX ,79,3035,17461,20496,video
CompanyJ_11267,Deebo scores and breaks out the dance Baltimore kept doing on Monday Night Football via NFL ,92,739,5676,6415,video
CompanyJ_11268,Mark Andrews catches the TD from Lamar and does Nick Bosa s flag wave as his celebration via Ravens ,100,1437,11345,12782,video
CompanyJ_11269,LAMAR TAKING THE DEFENDER S ANKLES via Ravens ,46,5614,28146,33760,video
CompanyJ_11270,Can t let it be this easy for Lamar via Ravens ,47,740,6357,7097,video
CompanyJ_11271,Dolphins with the fake of the century via MiamiDolphins ,56,6027,35734,41761,photo
CompanyJ_11272,Lamar and the Ravens were too much for the 49ers Baltimore wins 20 17 in the heavyweight fight brgridiron ,106,2209,14821,17030,photo
CompanyJ_11273,Bron on both ends ,18,1207,7978,9185,video
CompanyJ_11274,Did Lamar end the MVP race Eight game winning streak Leading NFL in touchdowns Wins over TB Watson Russ Beat vaunted Niners defense On pace to break Vick s rushing record ,171,2973,18569,21542,photo
CompanyJ_11275,AD pocket pass Caruso jam Dwight reaction Everyone having fun on the Lakers ,76,1227,8531,9758,video
CompanyJ_11276,Dirk is at the Lakers Mavs game in LA today and the Lakers gave him a tribute Respect ,86,3402,19790,23192,video
CompanyJ_11277,ANTHONY DAVIS ,14,1663,13621,15284,video
CompanyJ_11278,Luka from deep Filthy ,22,822,6875,7697,video
CompanyJ_11279,Lamar on the Ravens mentality this season Nobody cares about what you doin you gotta work harder If you wanna be the best you gotta work harder via Ravens ,155,2836,14518,17354,video
CompanyJ_11280,Luka with the step back over LeBron ,36,4914,35639,40553,video
CompanyJ_11281,Wednesday Goal and two assists in the Champions League Sunday 86th minute game winner vs Atletico Messi ,104,283,2142,2425,photo
CompanyJ_11282,Texans LBs coming in as a SWAT team brgridiron via NFLUK ,57,3389,28330,31719,video
CompanyJ_11283,Luka helped raise over 2 2M for 22 month old Kris from Slovenia who has a rare muscle condition Today before the game he got to meet him via townbrad ,150,2955,27080,30035,video
CompanyJ_11284,Russ Deshaun PJ H town representing at SNF via HoustonTexans ,61,1420,12136,13556,video
CompanyJ_11285,45 straight 3 s for Devin Booker Ridiculous via Suns ,53,9856,56552,66408,video
CompanyJ_11286,Deshaun gets his 2nd TD Texans rolling early 14 3 via NFL ,58,324,3457,3781,video
CompanyJ_11287,Watson s last TD pass was overturned He found the end zone again on his next throw via NFL ,91,1238,10539,11777,video
CompanyJ_11288,DESHAUN TAKES IT HIMSELF via NFL ,33,998,6777,7775,video
CompanyJ_11289,Deshaun s 4 TDs lead the Texans to a 28 22 win over New England brgridiron ,75,1513,9601,11114,photo
CompanyJ_11290,Deshaun Watson and Lamar Jackson are the only QBs to beat the Patriots this season brgridiron ,94,9269,55059,64328,photo
CompanyJ_11291,With the Pats losing Lamar and the Ravens stand atop the AFC standings at 10 2 brgridiron ,90,1732,13816,15548,photo
CompanyJ_11292,Watson just wanted to beat the brgridiron ,42,498,6932,7430,photo
CompanyJ_11293,Lamar Jackson 22 TD leader could break Vick s rushing record Luka Doncic 20 32 10 10 AST in Nov Trae Young 21 28 4 PTS 4 2 REB 8 4 AST this season Kylian Mbappe 20 Averaging a goal or assist every game Erling Haaland 19 27 goals in 20 games all comps ,251,3662,22071,25733,photo
CompanyJ_11294,Member of the 40 INT 20 sack club and 215 straight starts Does Ronde Barber belong in the ProFootballHOF Vote now From B R X FordTrucks PFHOF20 ,144,67,673,740,video
CompanyJ_11295,Ballon d Or nominee Virgil van Dijk said in June that Messi deserves the award over him I think he deserves it as long as he plays via brfootball ,146,677,6113,6790,video
CompanyJ_11296, National championship Super Bowl Hall of Fame Now not many of em have that The legendary Ed Reed via TaylorRooks ,114,3238,24496,27734,photo
CompanyJ_11297,The defending champs aren t slowing down 2nd in the East 7 game W streak Siakam 25 6 PTS 8 4 REB 4 AST ,103,1221,11707,12928,photo
CompanyJ_11298,They experienced racism on the field and poverty off it But this soccer team of immigrants shocked all of Texas by winning a state championship StateFarm This is their story ,174,370,2007,2377,status
CompanyJ_11299,Andrew Wiggins is on pace for career highs in Scoring Field Goal Percentage Rebounds Assists The new look Wolves star opens up about silencing his doubters this year ,166,356,3499,3855,photo
CompanyJ_11300,Wiggins has tuned out the hate,30,707,6568,7275,status
CompanyJ_11301,Christian Wilkins was laughing right in the Eagles faces after the Dolphins pulled off their epic trick play via ClayWPLG FischerNBC6 ,134,423,3357,3780,video
CompanyJ_11302,Carmelo Anthony is the Western Conference Player of the Week Last time he got a Player of the Week award was 2014 H T TimBontemps ,130,8457,40893,49350,photo
CompanyJ_11303,Official USWNT star Megan Rapinoe wins her first Ballon d Or brfootball ,72,1048,10078,11126,photo
CompanyJ_11304,Lionel Messi officially wins his SIXTH Ballon d Or He s now won more than any other player in history brfootball ,113,4877,22592,27469,photo
CompanyJ_11305,Messi s son was too hype via francefootball ,44,1431,10875,12306,video
CompanyJ_11306,2009 vs 2019 ,13,957,6096,7053,photo
CompanyJ_11307,2009 2010 2011 2012 2015 2019 A record brfootball ,50,1577,10535,12112,photo
CompanyJ_11308,In 2009 Didier Drogba refused a photo with then 10 year old Kylian Mbappe after Chelsea lost the UCL semifinal to Barcelona Tonight he made up for it ,150,305,3273,3578,photo
CompanyJ_11309,This ain t a damn farewell tour Western Conference Player of the Week Carmelo Anthony ,86,1134,6518,7652,video
CompanyJ_11310,KELLY OUBRE ,12,2148,16259,18407,video
CompanyJ_11311,Giannis just bullied Randle ,28,4921,29580,34501,video
CompanyJ_11312,Russell Wilson s throw is deflected Russell Wilson tips it to Anthony Harris for a pick six Wild via Vikings ,109,650,5206,5856,video
CompanyJ_11313,Simulate the rest of the game ,30,1130,10549,11679,photo
CompanyJ_11314,Seahawks receivers at it again with the celebrations New Edition after the TD via thecheckdown ,95,14278,80327,94605,video
CompanyJ_11315, DangeRussWilson leads the Seahawks past the Vikings to the top of the NFC West at 10 2 Seattle takes care of business winning 37 30 on MNF brgridiron ,151,890,6586,7476,photo
CompanyJ_11316,51 year old Gary Sheffield casually hitting bombs while smoking a cigar via garysheffield ,90,3069,22281,25350,video
CompanyJ_11317,Real love in the Seattle backfield Starter Chris Carson subbed himself out near the goal line last night so backup Rashaad Penny could score That just shows you who he is Any other running back would stay in via Joe_Fann ,221,921,10064,10985,photo
CompanyJ_11318,Waking up with Ballon d Or No 6 brfootball ,43,579,6088,6667,photo
CompanyJ_11319, 7x Pro Bowl 5x First Team All Pro 2x tackles leader Is Zach Thomas built for the ProFootballHOF Vote now From B R X FordTrucks PFHOF20 ,136,122,672,794,video
CompanyJ_11320,The Bucks are back on top of the East Best record in the league 18 3 Tied for franchise s best start 12 game W streak Giannis 30 8 PTS 13 4 REB 5 8 AST ,152,716,6185,6901,photo
CompanyJ_11321,Kelly Oubre Jr s handshake game is next level ,46,3017,23398,26415,video
CompanyJ_11322, lilyachty x brkicks x chinatownmarket Yachty linked with B R Kicks for an exclusive collab with Chinatown Market ahead of this year s Drop Up Cop now ,151,117,688,805,video
CompanyJ_11323,Scrawny redhead Nico Mannion was cut from the USA Basketball U16 team and has been doubted by many for the way he looks But the viral dunker is on his way to being a top 10 draft pick ,184,550,4046,4596,photo
CompanyJ_11324,Blue Devils have been stacked through the years but wendellcarter34 got his starting five set He picks his all time Duke squad with 15 dollars ,143,72,476,548,video
CompanyJ_11325,Steelers weren t impressed brgridiron ,38,589,5110,5699,photo
CompanyJ_11326,This outside the boot assist from Lukaku via brfootball ,56,476,4123,4599,video
CompanyJ_11327, Zeroes on the clock Pack down 23 21 61 yards to go Four years ago today Aaron Rodgers walked off in Detroit via nflthrowback ,126,1224,8260,9484,video
CompanyJ_11328,Panthers have fired head coach Ron Rivera ,42,2740,15626,18366,photo
CompanyJ_11329,Cam Reddish and De Andre Hunter had the entire store to themselves for two minutes to try and look the part From B R x jcpenney ,128,99,893,992,video
CompanyJ_11330, New GridironHeights x The Mandalorian Kliff Kingsbury and Baby Kyler lead the way for the Cardinals PlayStation ,113,370,1956,2326,video
CompanyJ_11331,Drummond leads the league in total rebounds and is outpacing Rodman s HOF career board numbers But is it enough to secure him the bag this offseason ,149,318,3138,3456,video
CompanyJ_11332,BOOM SHAKA LAKA Giannis Embiid AD Steph The Beard Luka Fun Guy Tatum Zion The NBA Jam limited edition pack from BR x homage is out Get yours NOW ,145,125,755,880,photo
CompanyJ_11333,New CFP rankings Did they get it right ,39,277,2466,2743,photo
CompanyJ_11334,IT played defense without his shoe and then drilled a 3 ,56,2876,30444,33320,video
CompanyJ_11335,Luka put on the moves ,22,983,8572,9555,video
CompanyJ_11336,New career high for Markelle tonight 20 PTS 6 ASTS Fultz is flourishing in Orlando ,83,2516,19520,22036,video
CompanyJ_11337,A Spurs fan told Harden no one wants to see a free throw shooting contest Beard Nobody wants to see fouls either goddammit ,123,11490,62841,74331,video
CompanyJ_11338,CARUSO OUTTA NOWHERE ,21,5122,26321,31443,video
CompanyJ_11339,Luka did it all tonight He grabbed a career high 18 REBS to go along with 33 PTS and 5 ASTS ,92,1045,8966,10011,video
CompanyJ_11340,Jimmy just dropped 8 straight points to start OT ,49,1651,10078,11729,video
CompanyJ_11341,The refs really didn t count this Harden dunk ,46,4989,32830,37819,video
CompanyJ_11342,That move was FILTHY brhoops ,29,2090,16217,18307,video
CompanyJ_11343,Tre Jones broke his ankles then landed on him ,46,3433,22510,25943,video
CompanyJ_11344,Bazemore denied The Klaw marriottbonvoy ,40,457,4828,5285,video
CompanyJ_11345,Shaq tried the TikTok challenge and Charles smoked him in the head with an egg via NBAonTNT ,92,20626,95775,116401,video
CompanyJ_11346,Anthony Davis vs Denver 37 min 9 18 FG 25 PTS LeBron James vs Denver 37 min 9 18 FG 25 PTS ,91,1985,18190,20175,photo
CompanyJ_11347,After his first fumble of the year Lamar started apologizing to everybody on the Ravens sideline We riding with you regardless ,127,5299,32788,38087,video
CompanyJ_11348,Zlatan has been linked to a return to AC Milan Ibra_official today I ll see you in Italy soon brfootball ,105,245,2167,2412,photo
CompanyJ_11349,Pep Guardiola accidentally said his old team s name instead of his current team via brfootball ,95,198,2295,2493,video
CompanyJ_11350, tkelce had his brother shook after he pulled a hidden camera prank on him before a charity event StateFarm New Ditch the Playbook with AdamLefkoe ,147,370,2577,2947,video
CompanyJ_11351,Torry Holt going from the Greatest Show on Turf to the ProFootballHOF 2x yardage leader 7x Pro Bowl Vote now From B R X FordTrucks PFHOF20 ,139,70,425,495,video
CompanyJ_11352,DeAndre Hopkins and Stephon Gilmore are still going at it after Texans beat the Pats brgridiron ,96,1380,12156,13536,photo
CompanyJ_11353,7 foot high schooler Chet Holmgren went viral for shaking Steph Curry with Steph s own move The class of 2021 s No 4 prospect could be basketball s next star unicorn ,166,122,1400,1522,photo
CompanyJ_11354,Draymond Green got emotional at his Michigan State jersey retirement I lived that dream via BigTenNetwork ,106,1364,11764,13128,video
CompanyJ_11355,Crossing up Steph Curry changed 7 footer Chet Holmgren s life An inside look at the top recruit s transformation ,113,544,3626,4170,video
CompanyJ_11356,The touch and finish from Dele Alli via NBCSportsSoccer ,56,826,5130,5956,video
CompanyJ_11357,Luka or Harden The debate over who s better goes deeper than the stepback ,74,566,5847,6413,video
CompanyJ_11358,Mbappe with the slick backheel goal via beINSPORTSUSA ,54,1043,6047,7090,photo
CompanyJ_11359,Khabib hooping via TeamKhabib ,30,1378,14412,15790,video
CompanyJ_11360,49ers have suspended radio color analyst Tim Ryan over controversial comments made about Lamar Jackson on Monday Ryan said Jackson was successful at faking handoffs because of his dark skin with a dark football per sfchronicle ,227,4903,19175,24078,photo
CompanyJ_11361,Langston had to be rescued out the seats after making a fan spill his beer and he kept drinking it ,99,224,2681,2905,video
CompanyJ_11362,Blake stepped over Giannis and the Bucks weren t having it ,59,1740,16822,18562,video
CompanyJ_11363,Career high TEN threes for Devonte Graham tonight 33 PTS 10 16 3s 7 REBS 9 ASTS ,80,1330,9350,10680,video
CompanyJ_11364,Bron went for a walk ,21,6391,34438,40829,video
CompanyJ_11365,Melo is relentless ,19,5537,37378,42915,video
CompanyJ_11366,AD INCOMING ,12,1632,10899,12531,video
CompanyJ_11367,Dwight s reaction ,18,1716,14130,15846,video
CompanyJ_11368,DWIGHT OUT HERE HITTING 3s ,27,4234,30850,35084,video
CompanyJ_11369, Look at LeBron he s on the court With no shoes that s some disrespect right there Jazz announcers weren t having it ,117,7616,52857,60473,video
CompanyJ_11370,Melo knew Dame s 3 was cash before it went in ,46,2161,23506,25667,video
CompanyJ_11371,Bron was walking all over the galaxy ,37,8725,45564,54289,video
CompanyJ_11372,11 dribbles 60 points On this day in 2016 Klay put on a CLINIC ,63,5922,33043,38965,video
CompanyJ_11373, There you go Serge got it TeamVic amp karrueche were impressed with sergeibaka s salsa dancing on How Hungry Are You ,118,67,425,492,status
CompanyJ_11374,The kid who made the impossible look normal in every sport went on to revolutionize the NFL B R brings you inside the legend of young Pat Mahomes ,146,323,2388,2711,status
CompanyJ_11375,Bron responds to the Jazz announcers criticism from last night s game ,70,3133,19303,22436,photo
CompanyJ_11376,Steve Belichick is the safeties coach under his dad in New England Can you tell they re related via NESN ,105,2366,16921,19287,video
CompanyJ_11377, He s a really big part of what happened tonight and he s gonna continue to watch over me over my career Jalen Brunson dedicated his 14 point 4th quarter to his high school friend Nathan who passed away last week ,213,581,7565,8146,video
CompanyJ_11378,VanVleet doesn t understand how anyone could knock James Harden I haven t met a basketball player that doesn t appreciate it It s the casual people that watch the game or are tied into some fantasy of what they think the game is about via JLew1050 ,248,1942,9972,11914,photo
CompanyJ_11379,Watch her face when Giannis gifts his sneakers brkicks via Bucks ,65,3433,31228,34661,video
CompanyJ_11380, In the end you re gonna find out more about yourself than you ever thought you were in search of Peyton Manning KAT Abby Wambach and more open up about what the Gatorade AOY program means to them From B R x Gatorade ,217,24,154,178,video
CompanyJ_11381,Race for the NFC East brgridiron ,33,4631,23198,27829,video
CompanyJ_11382,Patrick Mahomes dangerous since high school brgridiron ,55,1289,13098,14387,video
CompanyJ_11383,Carmelo Anthony s contract with the Blazers will become fully guaranteed for the remainder of the season wojespn ,113,8454,53109,61563,photo
CompanyJ_11384,Morris and Jokic had to get separated after a quick shoving match ,66,311,3979,4290,video
CompanyJ_11385,OUBRE ON INGRAM ,16,2209,12769,14978,video
CompanyJ_11386,You good Lowry ,15,604,5629,6233,video
CompanyJ_11387,JAXSON HAYES GOODNESS ,22,2225,12043,14268,video
CompanyJ_11388,Poster boy ,11,461,4687,5148,photo
CompanyJ_11389,MITCH TRUBISKY W H E E L S via NFL ,35,1053,8055,9108,video
CompanyJ_11390,Cowboys fans after the team s second 3 game losing streak brgridiron ,69,2669,15942,18611,photo
CompanyJ_11391,9 years ago today ,18,13363,59450,72813,photo
CompanyJ_11392,Giannis turns 25 today 3x All Star NBA Most Improved Player 2017 All NBA First Team 2019 NBA All Defensive First Team 2019 2019 MVP 5th player born outside the U S to win MVP Greek Freak is just getting started ,211,3596,22774,26370,photo
CompanyJ_11393,Melo vs Bron has been a battle since 2003 It continues tonight ,63,19052,70547,89599,video
CompanyJ_11394,Music video director _ColeBennett_ collabed with brkicks and ChinatownMarket to make an exclusive basketball and limited merch ,127,70,494,564,video
CompanyJ_11395,Eagles center Jason Kelce was still going to sign this Chiefs jersey after it was destroyed StateFarm ,102,54,723,777,video
CompanyJ_11396, Guys drowned out his voice Amid 5 15 start Cavs players are upset at head coach John Beilein for treating the season and team like they are still in college per ShamsCharania and joevardon ,190,358,3292,3650,photo
CompanyJ_11397,Kemba and the Celtics have been killing it without Kyrie ,57,645,3978,4623,video
CompanyJ_11398,Bosh just wanted to be part of the iconic moment via chrisbosh ,63,828,9377,10205,video
CompanyJ_11399,Knicks have fired David Fizdale per wojespn ,44,1607,9896,11503,photo
CompanyJ_11400,A Browns fan turned their windshield wiper into a Steelers helmet hitting Mason Rudolph via Bill O Brien FB ,108,6673,37524,44197,video
CompanyJ_11401,Fizdale leaving NYC knowing he s getting paid to not coach the Knicks ,70,1437,11426,12863,video
CompanyJ_11402,Warming up with the Greek Freak comes at a price via jovanbuha ,63,459,7041,7500,video
CompanyJ_11403,Cavs are ready to listen to offers on K Love per wojespn ,57,1654,14971,16625,photo
CompanyJ_11404,SLIPPERY ,9,401,3169,3570,video
CompanyJ_11405,DeAndre picks up a dime when he gets an assist via BrooklynNets ,64,1512,12327,13839,video
CompanyJ_11406,Spurs assistant coach Becky Hammon would have interest in coaching Knicks if she could land a long term deal per JabariJYoung ,126,1058,8261,9319,photo
CompanyJ_11407,Zach LaVine just scored 21 points in 7 minutes ,47,1688,11560,13248,video
CompanyJ_11408,Coby White That was tough ,26,3803,27541,31344,video
CompanyJ_11409,Jaylen Brown jeez via celtics ,30,978,8340,9318,video
CompanyJ_11410,OH MY GIANNIS Might not be another player that can make this a poster ,70,2000,13029,15029,video
CompanyJ_11411,SCHRODER OT WOW ,16,931,5769,6700,video
CompanyJ_11412,Brotherhood via NBA ,20,13343,84222,97565,video
CompanyJ_11413, His jersey s untucked CP3 Jordan Bell was called for a delay of game for checking in with an untucked jersey Wolves ended up losing the game in OT ,148,3638,22896,26534,video
CompanyJ_11414,Year 1 Year 17 Legendary ,25,8143,40777,48920,photo
CompanyJ_11415,The Kings had four attempts at a game winner and they lost ,59,684,6094,6778,video
CompanyJ_11416,Breaking Rodney Hood suffered a torn left Achilles vs Lakers Prayers up ,72,2574,20219,22793,photo
CompanyJ_11417,Tatum lit the Nuggets up MountainDew MtnDew3pt ,47,493,3659,4152,video
CompanyJ_11418,Bron s made the courtside vendor s night via NBA ,49,5956,49490,55446,video
CompanyJ_11419,20 3 record for the Lakers Bron and AD combined for 70 points ,62,4573,24055,28628,video
CompanyJ_11420,Top Heisman contenders take center stage on Championship Saturday who gets your vote wendys ,92,56,670,726,video
CompanyJ_11421,Welcome to Conference Championship weekend ,43,354,2589,2943,video
CompanyJ_11422,15 years ago today 17 year old Leo Messi made his Champions League debut brfootball ,84,186,1532,1718,video
CompanyJ_11423,Happy 63rd birthday to Larry Legend 3x NBA champ 3x NBA MVP 12x All Star 3x 3 Point Shootout champ Only person to win MVP Coach of the Year and Executive of the Year ,166,2288,12844,15132,photo
CompanyJ_11424,Harry Kane from DISTANCE via NBCSportsSoccer ,45,140,1159,1299,video
CompanyJ_11425,Six months ago 11 1 underdog Andy Ruiz upset then undefeated Anthony Joshua Today the rematch via DAZN_USA ,107,4574,23809,28383,video
CompanyJ_11426,Son s solo run from his own penalty box to the goal INCREDIBLE via NBCSportsSoccer ,83,1583,7291,8874,video
CompanyJ_11427,Steve Kerr on David Fizdale s firing If I had gone to New York that would have been me like three years ago I think I made the right choice via anthonyVslater ,159,729,6519,7248,video
CompanyJ_11428,Ran 80 yards in 12 seconds to score Heung min Son brfootball ,61,224,2515,2739,photo
CompanyJ_11429,Jimmy Butler to the Heat bench after draining a three I m a bad motherf ker I m sorry ,86,9078,61106,70184,video
CompanyJ_11430,Oklahoma brought the Sooner Schooner back for the Big 12 Championship game via CalebMac21 WillCoPro ,100,111,1358,1469,video
CompanyJ_11431,Manchester United cut City wide open on Martial s goal via NBCSportsSoccer ,75,206,1329,1535,video
CompanyJ_11432,Soon ,5,1628,12270,13898,photo
CompanyJ_11433,Manchester City lose 2 1 at home to rival Manchester United brfootball ,71,213,1511,1724,photo
CompanyJ_11434,No 6 Oklahoma wins the Big 12 championship in OT with a 30 23 win over No 7 Baylor CeeDee Lamb 8 catches for 173 yards ,119,1523,9611,11134,photo
CompanyJ_11435,CeeDee Lamb had another MONSTER game and helped lead the Sooners to their 5th straight Big 12 championship He finished with 8 catches for 173 yards ,148,993,7639,8632,video
CompanyJ_11436,Burrow completing passes to himself via CBSSports ,50,1016,7033,8049,video
CompanyJ_11437,Joe Burrow with all the time in the world Not fair via CBSSports ,65,1609,13438,15047,video
CompanyJ_11438,Messi scores his 35th La Liga hat trick A league record brfootball ,67,465,3790,4255,photo
CompanyJ_11439,Anthony Joshua beats Andy Ruiz by unanimous decision in their rematch Joshua takes back the WBO IBF IBO and WBA heavyweight titles ,131,4451,18042,22493,photo
CompanyJ_11440,Breaking Lane Kiffin named head coach at Ole Miss ,50,1299,8956,10255,photo
CompanyJ_11441,Broadway Joe is unbelievable via CBSSports ,43,3276,19255,22531,video
CompanyJ_11442,They already started carting out Georgia s SEC Championship gear at the start of the 4Q via ScottCarpTV ,104,1170,8569,9739,video
CompanyJ_11443,LSU wins its first SEC Championship since 2011 Joe Burrow joins other legendary Tigers on top of the conference via LSUfootball ,128,1659,13525,15184,video
CompanyJ_11444,Broadway Joe Bengals brgridiron Looked like the No 1 pick in the SEC Championship ,82,561,3834,4395,photo
CompanyJ_11445,Coach O and Burrow Tough to name a better duo in college football via CBSSports ,80,187,2165,2352,video
CompanyJ_11446,Joe Burreaux shined on the biggest stage and led LSU to an SEC Championship 28 38 for 349 yards 4 TDs 0 INTs ,109,533,4575,5108,video
CompanyJ_11447,BEN SIMMONS WITH ANOTHER 3 ,27,4219,25508,29727,video
CompanyJ_11448,Ohio State takes home the Big Ten Championship after coming back to beat Wisconsin 34 21 JK Dobbins 33 carries 172 yards 1 touchdown ,133,619,4323,4942,photo
CompanyJ_11449,Buckeyes started the Ohio State comeback with this incredible TD catch From B R X BassProShops ,95,542,4492,5034,video
CompanyJ_11450,Odell has been playing through a serious and often painful sports hernia injury per RapSheet The star WR will require surgery in the offseason ,143,488,4561,5049,photo
CompanyJ_11451,Alistair Overeem got knocked out in the final seconds of his fight and got something to show for it ,100,7460,30000,37460,photo
CompanyJ_11452,Time to start talking about Josh Allen as one of the most dangerous QBs in the game brgridiron ,95,169,1539,1708,video
CompanyJ_11453,Texans linebackers dress up together on gameday Week 14 Average Joe s Gym Via HoustonTexans ,92,5148,37098,42246,video
CompanyJ_11454,The Bosa boys take competition to the next level in their family From B R x JCPenney ,85,308,2233,2541,video
CompanyJ_11455,PLAYOFFS ARE HERE TheMattCamp has everything you need to make sure you don t go one and done in the playoffs Watch Your FantasyFireDrill NOW ,141,15,83,98,link
CompanyJ_11456,R I P ,6,2801,23513,26314,photo
CompanyJ_11457,2020 College Football Playoff field is set LSU Ohio State Clemson Oklahoma ,75,2466,10009,12475,photo
CompanyJ_11458,OBJ wants out of Cleveland Odell Beckham Jr has reportedly told opposing players and coaches before and during games this year Come get me via JayGlazer ,153,2969,18019,20988,photo
CompanyJ_11459,Behind the Design DangeRussWilson and local Seattle artist Jeff Weirdo Jacobson give an exclusive look at his new cleat design for My Cause My Cleats brkicks ,158,88,792,880,video
CompanyJ_11460,Lamar shook him out of his shoes He hits 1 000 rushing yards on the season via thecheckdown ,92,12624,63656,76280,video
CompanyJ_11461,Niners scoring TDs off of trick plays Game is wild so far via 49ers ,68,702,5179,5881,video
CompanyJ_11462,Niners Saints has been electric At half Brees 4 TDs Mostert 2 TDs Jimmy G 11 12 2 TDs Sanders 132 yards pass TD Jared Cook 2 TDs Niners up 28 27 ,145,620,4295,4915,photo
CompanyJ_11463,8 years ago today the Lakers trade for CP3 was vetoed One of the craziest things in sports to happen this decade ,113,6472,31211,37683,photo
CompanyJ_11464,Ravens play sheet blew onto the field so Bills corner Tre White picked it up and tried to read it Ref had to take it away Via NFLonCBS ,135,10238,61554,71792,video
CompanyJ_11465,Deshaun with a miraculous touchdown run via HoustonTexans ,58,577,4355,4932,video
CompanyJ_11466,Brees Smith SAINTS TAKE THE LEAD via NFL ,41,422,2726,3148,video
CompanyJ_11467,Jimmy G throws four touchdowns and leads the game winning drive to beat the Saints in an unreal 48 46 shootout brgridiron ,122,907,4354,5261,video
CompanyJ_11468,4th and 2 from the wrong side of midfield with the game on the line and 39 seconds left George Kittle did this via NFL ,119,1998,11409,13407,video
CompanyJ_11469,OKAY VC Vince Carter was drafted on June 24 1998 PJ Washington was born on August 23 1998 ,90,6819,41479,48298,video
CompanyJ_11470,Tyler Herro feelin it That step back was tough ,47,1296,10028,11324,video
CompanyJ_11471,BRADY RUNS IT 17 YARDS ON 4TH DOWN via NFL ,43,636,4518,5154,video
CompanyJ_11472,Pats struggling vs the new generation brgridiron ,49,2593,16697,19290,photo
CompanyJ_11473,Mahomes leads the Chiefs over the Patriots in Foxboro StateFarm ,64,397,2679,3076,video
CompanyJ_11474,Mbappe gets his first Nike collection at 20 years old His first custom boot is the Mercurial Superfly 7 brkicks ,112,532,5019,5551,photo
CompanyJ_11475,Luka continues to make history ,31,1757,11953,13710,photo
CompanyJ_11476,Tyler Herro caught fire from deep CLUTCH MtnDew3pt MountainDew ,63,558,3910,4468,video
CompanyJ_11477,CP3 amp Melo 15 years later ,28,1119,11672,12791,video
CompanyJ_11478,Bron to AD from across the court ,33,668,5962,6630,video
CompanyJ_11479,LEBRON PLAYING BULLY BALL ,26,9948,54209,64157,video
CompanyJ_11480,LaMelo Ball is expected to miss four weeks after suffering a foot injury per DraftExpress ,90,265,2700,2965,photo
CompanyJ_11481,Gurley stiff arms his way for the TD Rams in full control via NFL ,66,330,2649,2979,video
CompanyJ_11482,CP3 caused Melo to get a tech ,30,886,8079,8965,video
CompanyJ_11483,Niners retake control of the NFC West from the Seahawks brgridiron ,67,2462,15343,17805,video
CompanyJ_11484,AD s got 50 PTS on 20 29 shooting ,34,2905,19955,22860,photo
CompanyJ_11485,Anthony Davis had another vintage performance tonight 50 PTS 7 REB 6 AST 4 STL 20 29 FG W ,90,2255,15857,18112,video
CompanyJ_11486,LeBron and AD became the first Lakers teammates to combine for 70 points in consecutive games since Kobe and Shaq in 2003 ,122,4568,27066,31634,photo
CompanyJ_11487,Tracy McGrady 13 points in 33 seconds Still unbelievable 15 years later via nbahistory ,87,6924,32124,39048,video
CompanyJ_11488,Will Shields surprised a teacher who s spent three decades rooting for the Chiefs Over 30 years of season tickets is dedication From Ford X B R PFHOF ,150,83,892,975,video
CompanyJ_11489,Kawhi hooped against Bobby Wagner in high school Small world brgridiron ,72,1780,16225,18005,photo
CompanyJ_11490, We re gonna run the West ,26,5712,42881,48593,photo
CompanyJ_11491,Luka wants to talk ball not numbers Too much stats You can t compare nobody to Michael Jordan via espn_macmahon ,112,2159,17058,19217,video
CompanyJ_11492, Watch your mouth This fan was NOT happy with LeBron cursing ,61,1878,18838,20716,video
CompanyJ_11493, People see just like a religion first because obviously we re wearing the scarves WNBA legend S10Bird surprised the Salam Stars girls basketball team in Milwaukee that s turning heads StateFarm ,195,382,1549,1931,video
CompanyJ_11494,Devin Booker has the personal accolades but no winning to show for it Now he says his only focus is putting the Suns into contention In the past I ve put the numbers up and it doesn t matter Right now I think everything comes with winning ,239,474,3562,4036,photo
CompanyJ_11495,Odell reportedly told opposing players to come get me during at least one game in October Cleveland s schedule that month 49ers Seahawks Patriots via CharlesRobinson ,166,1611,11153,12764,photo
CompanyJ_11496,Keeper s reaction to making the save in the national championship was elite via ncaasoccer ,91,1324,12855,14179,video
CompanyJ_11497,Pete Frates the former college baseball player with Lou Gehrig s disease who helped make the ALS ice bucket challenge go viral has died at 34 R I P ,148,3994,30015,34009,photo
CompanyJ_11498,The NFL is investigating whether a Patriots employee was videotaping Bengals play calls on Sunday per diannaESPN ,113,3301,14826,18127,photo
CompanyJ_11499,Patrick Mahomes girlfriend Brittany Matthews says security moved her and Pat s brother to a safe place at Gillette Stadium because New England fans were harassing them That s how you know it was bad brgridiron ,210,1966,18191,20157,photo
CompanyJ_11500,The goalkeepers need to stop a meteor from destroying the planet New episode of TheChampions PlayStation ,105,187,985,1172,video
CompanyJ_11501,Gordon Hayward is officially available for the Celtics tonight ,63,818,9864,10682,photo
CompanyJ_11502,2019 Heisman Finalists Jalen Hurts Justin Fields Joe Burrow Chase Young ,72,1356,9953,11309,photo
CompanyJ_11503,The NBA Jam limited edition pack from BR x homage Last chance to order for an X Mas delivery is Thursday Cop NOW ,113,45,259,304,video
CompanyJ_11504,Pacers fans are booing PG so he hit them with the after the bucket ,67,886,8927,9813,video
CompanyJ_11505,B I over Drummond ,18,1436,10541,11977,video
CompanyJ_11506,Beard Cheat code ,17,3361,22887,26248,video
CompanyJ_11507,PG got em with the cross He s got 34 PTS and 7 threes at the end of the 3rd quarter against his former team ,108,765,6518,7283,video
CompanyJ_11508,Giannis feelin it via Bucks ,28,1289,12487,13776,video
CompanyJ_11509,BIG SHOT BJELICA FTW ,21,3781,22113,25894,video
CompanyJ_11510,17 points in the 4th and the game winner D Rose went off ,57,8262,41721,49983,video
CompanyJ_11511,CP3 did Gobert dirty ,21,4369,27018,31387,video
CompanyJ_11512,Tough night for Giants fans brgridiron ,39,331,3906,4237,photo
CompanyJ_11513,KAT was fed up ,15,1800,17578,19378,video
CompanyJ_11514,WWWWWWWWWWWWWWW 15 straight ,28,624,10174,10798,photo
CompanyJ_11515,No turning off the Champions League brfootball ,47,236,2277,2513,photo
CompanyJ_11516,Clutch is in D Rose s DNA ,26,1219,9872,11091,photo
CompanyJ_11517,Philip Rivers talking trash will never get old via Jaguars ,59,3466,23500,26966,video
CompanyJ_11518,Jaylen Brown says the Celtics were calling Grant Williams Ben Simmons before he made his first NBA three via NBCSCeltics ,121,463,4365,4828,video
CompanyJ_11519,Ten teams Six spots Stakes are high today Watch Chelsea Lille FREE on brlive ,77,43,324,367,link
CompanyJ_11520,Rasual Butler s tragic and puzzling death in 2018 didn t match the person that friends family and teammates knew he was Ever since his loved ones have been left with more questions than answers ,194,158,988,1146,photo
CompanyJ_11521,Khalil Mack paid off every holiday layaway account at his hometown Walmart 80K to clear 300 accounts Respect brgridiron via jeremymikula ,137,9932,73663,83595,photo
CompanyJ_11522,Kevin Love would prefer to get traded to the Blazers per KevinOConnorNBA ,73,3425,25807,29232,photo
CompanyJ_11523,Jameis this year Two TD passes 26 behind Lamar for the league lead Seven yards behind Dak for the top passing spot Leads the NFL in picks 23 by a huge margin Could finish No 1 in all three brgridiron ,200,3195,25775,28970,photo
CompanyJ_11524,Mo Salah from an impossible angle brfootball ,45,1525,10907,12432,video
CompanyJ_11525,Reigning champions Liverpool top their group and are through to the Round of 16 brfootball ,91,125,974,1099,photo
CompanyJ_11526,The build up The backheel Chelsea s opening goal brfootball ,60,229,2604,2833,video
CompanyJ_11527,The MVP race is all but over br_betting ,40,697,6098,6795,photo
CompanyJ_11528,Jets Quincy Enunwa was visiting a school in Jersey City when there was a shooting nearby The wide receiver and students are safe and on lockdown at the school via TinaCervasio ,176,369,3607,3976,photo
CompanyJ_11529,Ansu Fati is now the youngest goalscorer in Champions League history brfootball ,80,815,4677,5492,photo
CompanyJ_11530,New GridironHeights Gronk is having trouble getting everybody in position for playoff picture day PlayStation ,110,451,2237,2688,video
CompanyJ_11531, Barca s youngest ever La Liga goalscorer Youngest to score assist in a single La Liga match Now also youngest UCL goalscorer 17 year old Ansu Fati keeps making history brfootball ,180,567,3772,4339,video
CompanyJ_11532,Knicks have a promising future despite their struggles this season HowardBeck wants them to start the youth now and cash in on their vets ,138,314,2114,2428,video
CompanyJ_11533,When Frenkie De Jong found out Ajax his former team got knocked out of the Champions League via brfootball ,107,1033,11523,12556,video
CompanyJ_11534, DwyaneWade dropped a limited edition run of his World Tour merch just in time for the holidays Get yours now ,110,100,857,957,photo
CompanyJ_11535, Raptors dropped a tribute to Kawhi before his return to The 6ix tomorrow ,74,1566,9446,11012,video
CompanyJ_11536,That dunk was tough MatisseThybulle ,36,1297,8855,10152,video
CompanyJ_11537,How did Gary Harris finish this ,32,3684,33168,36852,video
CompanyJ_11538,Miles Bridges with the dagger MtnDew3pt MountainDew ,52,135,1402,1537,video
CompanyJ_11539,Embiid had to break out the shimmy after this crazy bucket ,59,390,3913,4303,video
CompanyJ_11540,Jimmy G Buckets sends it to OT ,31,1133,8717,9850,video
CompanyJ_11541,Duncan Robinson went off TEN THREES 34 PTS 10 14 from three 4 ASTS ,67,2408,13701,16109,video
CompanyJ_11542,Trae Young yelled It s over to the Heat crowd after the Hawks went up 6 with 1 minute left The Heat ended up winning by 14 ,123,7037,49357,56394,video
CompanyJ_11543,Breaking Gerrit Cole is heading to the Yankees 9 years 36M per year 324M total per JonHeyman ,93,14063,41252,55315,photo
CompanyJ_11544,Record breaking money for Cole Most money ever for a pitcher Most money per year for any player ever ,101,787,5077,5864,photo
CompanyJ_11545,Alex Antetokounmpo throwing down with Giannis in the crowd brhoops ,67,5317,52626,57943,video
CompanyJ_11546,The world champion USWNT is TIME s 2019 Athlete of the Year ,60,1074,6220,7294,photo
CompanyJ_11547,Khris Middleton got a new winter coat for every single student at an elementary school in Milwaukee 315 in total via AdrianaMendez ,131,1983,19417,21400,photo
CompanyJ_11548,It only took one year for the Fun Guy to become King in the North Kawhi returns to Toronto tonight ,99,903,7564,8467,video
CompanyJ_11549,He really wanted the bottle just to throw it brfootball ,56,199,2055,2254,video
CompanyJ_11550,Former Cardinals DL ddockett was out living his best life two days before the 2008 NFC Championship game when he got caught in an ATV chase with the cops New Untold Stories with MasterTes ,188,132,656,788,video
CompanyJ_11551,Five years ago today Kobe called the Lakers soft like Charmin after practice via ArashMarkazi ,94,7240,35984,43224,video
CompanyJ_11552,Deion Sanders breaking down the Prime Time pregame routine Legendary brgridiron ,80,7074,34541,41615,photo
CompanyJ_11553,Penny Hardaway s Super Seven is Memphis version of the Fab Five Once James Wiseman returns they could be unstoppable ,117,386,2124,2510,status
CompanyJ_11554,Melo wants to be in the Garden rafters ,39,1244,12913,14157,photo
CompanyJ_11555,Patriots have signed trick shot kicker Josh Gable to their practice squad per FieldYates Trick shot specialist Never played CFB Played pro soccer in Europe Kicked pro for Nebraska Danger and Tucson Sugar Skulls IFL ,215,1393,12093,13486,video
CompanyJ_11556,AD doing the Bron three via HoopJab ,36,2543,21534,24077,video
CompanyJ_11557,JuJu says he made 100K streaming Thursday Night Football and playing Call of Duty with TimTheTatman BRGaming brgridiron ,120,907,11988,12895,photo
CompanyJ_11558,Mbappe s drag back assist for Neymar s goal ,44,728,5902,6630,video
CompanyJ_11559,Mbappe Smooth brfootball ,25,1069,11186,12255,video
CompanyJ_11560,The Champions League Round of 16 is set brfootball ,51,469,2107,2576,video
CompanyJ_11561, KingJames rocking KMbappe s new Nike collection via Lakers ,60,548,5875,6423,photo
CompanyJ_11562,Kawhi comes back to Toronto to face off against Siakam s Raptors squad From B R x AmericanExpress ,98,149,1433,1582,video
CompanyJ_11563,J J Culver became just the second player in NAIA history to score 100 points in a game 100 points 34 62 FG 12 33 3 PT 20 27 FT Incredible via WBUBasketball ,156,724,6298,7022,video
CompanyJ_11564,Neymar gave the penalty to Cavani instead of taking it himself True teammate brfootball ,88,745,9974,10719,video
CompanyJ_11565,Ronaldo was pissed at this pitch invader ,41,532,6204,6736,video
CompanyJ_11566,Harden s elite ability to draw fouls is because of his beard ,61,290,1894,2184,video
CompanyJ_11567, fatjoe wanted more money to build his all time Knicks squad The family ties run deep for the NY native ,104,49,320,369,video
CompanyJ_11568,Drake court side celebrating Kawhi s return ,44,1818,21499,23317,photo
CompanyJ_11569,It s all love for Kawhi in Toronto as he gets his championship ring via FoxSportsWest ,86,4409,28601,33010,video
CompanyJ_11570, back in the 6 Run was unforgettable ,37,1061,11853,12914,photo
CompanyJ_11571,Nasty no look dime from Kemba ,30,5927,37339,43266,video
CompanyJ_11572,Lakers and Magic exchanging words Dudley wanted all the smoke ,62,2832,19732,22564,video
CompanyJ_11573,Bron got rejected by Mo Bamba ,30,3078,27676,30754,video
CompanyJ_11574,Drake was trying to trash talk Pat Bev ,39,430,5404,5834,video
CompanyJ_11575,Devonte Graham is putting the league on notice 40 PTS career high 5 REBS 5 ASTS ,80,7014,42243,49257,video
CompanyJ_11576,55 points and 10 threes for The Beard tonight ,46,586,6734,7320,photo
CompanyJ_11577,Anthony Rendon agrees to a 7 year 245 million deal with the Los Angeles Angels per JonHeyman ,93,1257,6623,7880,photo
CompanyJ_11578, Gerrit Cole 324 million to Yankees Stephen Strasburg 245 million to Nationals Anthony Rendon 245 million to Angels Scott Boras negotiated 814M from just 3 players ,164,1349,7431,8780,photo
CompanyJ_11579,JA MORANT ENDED ARON BAYNES ,28,17100,75042,92142,video
CompanyJ_11580,,0,852,7753,8605,photo
CompanyJ_11581,A work of art ,14,2929,19602,22531,photo
CompanyJ_11582,Bogdan Triple Cold From B R x coorslight ,41,138,1294,1432,video
CompanyJ_11583, I have like an F you symbol Kawhi says he has the middle finger symbol on his Raptors championship ring via TSN_Sports ,120,732,6764,7496,video
CompanyJ_11584,D LO SENDS IT TO OT ,20,1902,16022,17924,video
CompanyJ_11585,Perfect 10 from 47 year old Kelly Slater Whoa via wsl ,54,1961,16377,18338,video
CompanyJ_11586,This courtside angle of Ja s dunk via teamdelle ,48,1801,15409,17210,video
CompanyJ_11587,Kylian Mbappe has reached 100 career club goals All before his 21st birthday brfootball ,88,404,4102,4506,photo
CompanyJ_11588,Imagine this duo brgridiron ,28,1625,13027,14652,photo
CompanyJ_11589, nate_robinson bet custom Jordans with a Knicks superfan If they lose the sneakers get shredded Caesars Sportsbook ,115,49,429,478,video
CompanyJ_11590,MLB MLBPA jointly approve significant changes to the Drug of Abuse program including testing for cocaine and opioids They also won t test minor league players for marijuana ,173,436,3561,3997,photo
CompanyJ_11591,Joe Burrow is the AP Player of the Year first LSU player to win the award He received 50 first place votes Chase Young received the other three ,144,3083,23767,26850,photo
CompanyJ_11592,5 star recruit Bijan Robinson could have gone to Bama LSU or Ohio State but he wants to revive the Longhorns Getting Texas back to where it needs to be is what my focus is ,172,1104,6690,7794,status
CompanyJ_11593,Antoine Griezmann tries to beat SteveNash in HORSE Verizon ,59,190,1420,1610,video
CompanyJ_11594,Poor defender via driftyjayy ,29,2672,15582,18254,video
CompanyJ_11595,The Kings and Bucks will become the first NBA teams to participate in basketball games at correctional facilities They want to break down stigmas of individuals impacted by the criminal justice system via MarcJSpearsESPN ,221,3005,14980,17985,photo
CompanyJ_11596,Action Jackson in primetime is must watch tonight Threw five TDs on MNF 23 yards from Vick s rushing record Looking to end MVP race Could clinch AFC North with a W ,164,1080,8238,9318,photo
CompanyJ_11597,Welcome to the Lamar Jackson Experience LJ has passed Vick for the single season QB rushing record brgridiron ,110,15559,64907,80466,video
CompanyJ_11598,Kemba dropped 44 last night Looks like he s still feelin it ,60,819,8280,9099,video
CompanyJ_11599,History Most rushing yards in one season from a QB via NFL ,59,635,3698,4333,video
CompanyJ_11600, michaelvick s reaction to Lamar breaking his record ,53,5670,32492,38162,video
CompanyJ_11601,The torch has been passed brgridiron ,37,312,3175,3487,photo
CompanyJ_11602,Nasty pass from Luka ,21,932,7827,8759,video
CompanyJ_11603,Luka and Blake both welcomed Mexico City to their game tonight in Spanish Luka s went better than Blake s ,106,11632,65828,77460,video
CompanyJ_11604,Dion Waiters has been suspended 6 games for failure to adhere to team policies violation of team rules and continued insubordination Dion hasn t played yet this season ,168,363,2957,3320,photo
CompanyJ_11605,Former NBA commissioner David Stern suffered a brain hemorrhage earlier today and underwent emergency surgery Prayers up ,121,1723,13022,14745,photo
CompanyJ_11606,OBJ is reportedly not afraid returning to New York Giants or Jets if he s traded per RVacchianoSNY ,99,1002,6921,7923,photo
CompanyJ_11607,Lamar Jackson is putting on a SHOW The NFL s touchdown leader has added four more ,82,686,5453,6139,photo
CompanyJ_11608,New mixed reality from the Ravens This is wild ,47,11561,59536,71097,video
CompanyJ_11609,KP with the poster and stare down on Drummond ,46,1826,11650,13476,video
CompanyJ_11610,Action Jackson did it again 5 TD 296 total yards 10th straight win Clinched AFC North Broke Vick s rushing record ,114,4662,25779,30441,photo
CompanyJ_11611,Luka getting MVP chants in Mexico 41 PTS 12 REBS 11 ASTS Another triple double for Luka ,88,2838,19984,22822,video
CompanyJ_11612,This Lamar Ingram postgame interview was an instant classic via NFLonFOX ,73,22905,89165,112070,video
CompanyJ_11613,Lamar getting that D Wade treatment Everybody wants a jersey via NFL ,69,3706,31328,35034,video
CompanyJ_11614,Another record for Luka ,24,1144,8820,9964,photo
CompanyJ_11615,CP3 and his son out in Denver to watch Melo ,44,864,13106,13970,video
CompanyJ_11616,Elite 5 star Josh Christopher grew up in gyms watching James Harden and DeMar DeRozan Ranked No 11 overall the kid known as Jaygup is ready to show his true personality ,169,205,1230,1435,status
CompanyJ_11617,Embiid sealed the game with a vicious block XboxGamePass ,57,381,4887,5268,video
CompanyJ_11618,It s been a year since SSJreef had heart surgery and started his journey back to basketball Shareef is currently playing as a redshirt freshman at UCLA brhoops ,160,3879,37210,41089,video
CompanyJ_11619,Twelve days Twelve dunks from stars playing on Christmas Day The BRNBAXmas countdown starts now ,96,172,1305,1477,video
CompanyJ_11620,Luka recreates the iconic Heat moment with KP ,46,9453,66842,76295,photo
CompanyJ_11621,Former NFL players CRO31 and jcharles25 both accidentally took edibles during their careers and it went as you d expect I m about to die man ,141,393,1589,1982,video
CompanyJ_11622,Kevin Love is on the trade block Which team needs him the most HowardBeck says the Celtics ,91,300,3347,3647,video
CompanyJ_11623,LeBron s best regular season start could turn into a historic Lakers run with AD ,81,1414,10796,12210,video
CompanyJ_11624,Last time Bron played at Miami he dropped 51 points He ll be back in South Beach tonight ,89,3111,24744,27855,video
CompanyJ_11625,Hornets breakout star Devonte4Graham is playing his way onto All Star ballots ,78,859,5790,6649,video
CompanyJ_11626,Nuggets Melo is a forever legend ,33,1921,17084,19005,photo
CompanyJ_11627,Jimmy always had high hopes for the Heat this year ,51,583,6921,7504,photo
CompanyJ_11628,Lots of games won here with Bron and CB via Lakers ,51,7091,63777,70868,video
CompanyJ_11629,Kendrick Nunn over JaVale via NBATV ,36,1116,7802,8918,video
CompanyJ_11630,B R D I E ,10,6537,40156,46693,video
CompanyJ_11631,James Harden on Wednesday 55 PTS James Harden tonight 54 PTS Video game mode ,77,3649,24075,27724,photo
CompanyJ_11632,AD amp LeBron were clutch in the 4th quarter to give the Heat their first home loss of the year ,96,4409,28871,33280,video
CompanyJ_11633,Kyle Anderson put Giannis on a poster and Ja was lovin it ,58,1188,10498,11686,video
CompanyJ_11634,HE ELEVATED FOR THE PUTBACK via EWUMBB ,39,1355,7798,9153,video
CompanyJ_11635,Kevin Knox scored on his own team ,34,2325,20399,22724,video
CompanyJ_11636, PUIG GOING AGAINST SUMO WRESTLERS via YasielPuig ,50,333,3503,3836,video
CompanyJ_11637,88 combined points for Kawhi amp PG Two bucket getters ,55,1217,10691,11908,photo
CompanyJ_11638,Five years ago Kobe Bryant passed Michael Jordan for third all time leading scorer The game was stopped on the road for Kobe to have his moment ,144,6708,40766,47474,video
CompanyJ_11639,Nutmeg off the back heel for the goal MoSalah is next level Via NBCSportsSoccer ,80,1712,11426,13138,video
CompanyJ_11640,8 years ago today After his trade to the Lakers was vetoed Chris Paul was traded to the Clippers Birth of the Lob City era in LA ,129,1122,12292,13414,photo
CompanyJ_11641,15 years old and she hit 100 on the radar via baseballfor_all ,62,2648,27669,30317,video
CompanyJ_11642,16 years ago today Joe Horn brought out the cell phone after scoring a TD brgridiron Cantguardmike paid homage by doing the same last year ,139,1646,12952,14598,photo
CompanyJ_11643,Shaq caught slipping by SSJreef and the dog ,44,1089,10508,11597,video
CompanyJ_11644,Trae s timing on the Splash was too smooth Via HawksOnFSSE ,59,13491,70798,84289,video
CompanyJ_11645,No hands needed to draw Ronaldo using a soccer ball via bouboudesign7 ,70,627,3782,4409,video
CompanyJ_11646, TeamJuJu making the holidays special by giving back ,53,550,4821,5371,video
CompanyJ_11647,Texas high school football is different via MaxPreps ,53,6627,40172,46799,video
CompanyJ_11648,On the seven year anniversary of the Sandy Hook tragedy Newtown high school won the state championship on a last second touchdown via McFarland_Shawn ,150,4840,31108,35948,video
CompanyJ_11649,Giannis hit the Cobra on Robin Lopez for the second straight night via Bucks ,77,640,4938,5578,video
CompanyJ_11650,Luka left the game after suffering an ankle injury Hope he s alright ,69,4099,31717,35816,video
CompanyJ_11651,From Ohio State benchwarmer to the toast of college football LSU s Joe Burrow wins the Heisman trophy ,102,2984,19062,22046,video
CompanyJ_11652,Joe Burrow and Ed Orgeron were both emotional during his Heisman speech ,72,860,9369,10229,photo
CompanyJ_11653, Led CFB with 48 TDs 4 715 passing yards No 1 Seed LSU s 2nd Heisman winner 3rd straight transfer QB to win award Joe Burrow had a sensational season at LSU ,157,1002,7585,8587,video
CompanyJ_11654,Ja is RUTHLESS at the rim ,26,4431,31163,35594,video
CompanyJ_11655,Zach LaVine takes down the Clippers ,36,2077,15161,17238,video
CompanyJ_11656,Bronny scored 15 points and was named MVP of the game after beating St Vincent St Mary 59 56 He and LeBron were all smiles postgame via Tarek_Fattal ,149,1752,16318,18070,video
CompanyJ_11657,Jamal Murray faked the defense and threw it off the glass Mamba Mentality ,74,13836,81948,95784,video
CompanyJ_11658,LeBron s reaction to Bronny s clutch bucket is everything brhoops via WhosNextHS ,81,1235,11550,12785,video
CompanyJ_11659,Tiger was hyped after winning his match at the Presidents Cup via PGATOUR ,74,1589,16445,18034,photo
CompanyJ_11660,Amanda Nunes beats Germaine De Randamie via Unanimous decision to retain women s Bantamweight title UFC245 ,107,339,2308,2647,photo
CompanyJ_11661,Bronny showed up to Ohio against his Dad s alma mater and won MVP of the game right in front of him brhoops He s got next ,122,3030,22492,25522,photo
CompanyJ_11662,AND NEW Alexander Volkanovski defeats Max Holloway by unanimous decision to win Featherweight Championship UFC245 ,114,712,3649,4361,photo
CompanyJ_11663,Fight living up to all the hype via ufc ,40,570,3717,4287,video
CompanyJ_11664,Kamaru Usman beats Colby Covington to retain the Welterweight Championship What a fight via ufc ,96,3861,18164,22025,video
CompanyJ_11665,One of the biggest Broncos fans is also a major contributor to the Colorado community Champ Bailey surprises this heroic fan in Denver From Ford X B R PFHOF ,157,84,798,882,video
CompanyJ_11666,A sports family s dream brgridiron ,35,3345,22833,26178,photo
CompanyJ_11667,26 years ago today FIFA launched its first game BRGaming ,57,470,3181,3651,photo
CompanyJ_11668,Shoots scores celebrates via thatgirlondeck ,44,2505,15828,18333,video
CompanyJ_11669,Five goals in his last four games Cristiano Ronaldo brfootball ,63,766,6399,7165,photo
CompanyJ_11670,Usman was fighting for something bigger ,40,6354,25294,31648,photo
CompanyJ_11671, PLAYOFFS TheMattCamp is dropping sleepers giving injury updates and getting you ready for your fantasy playoff matchup Watch Your FantasyFireDrill NOW ,152,11,79,90,link
CompanyJ_11672,Kevin De Bruyne less than two minutes in via NBCSportsSoccer ,61,155,1270,1425,video
CompanyJ_11673,Ankle breakers posters clutch shots Ten of the best Christmas Day plays we ve ever seen for Day 10 of BRNBAXMas ,112,267,1604,1871,video
CompanyJ_11674,LBJ and Savannah courtside for Bronny ,38,7364,57178,64542,photo
CompanyJ_11675,Football weather means pre game snowball fight via Chiefs ,58,1584,14269,15853,video
CompanyJ_11676,Cleveland has agreed to trade former Cy Young pitcher Corey Kluber to Rangers per JonHeyman ,92,420,2401,2821,photo
CompanyJ_11677,Here it is JayGlazer and FOXSports released footage of what the Patriots were filming on the Bengals sideline plus conversations between security and the videographer We were trying to get some field perspective My bad That s not the field ,240,1202,4295,5497,video
CompanyJ_11678,For every Jameis interception there s an equal TD waiting to happen brgridiron ,79,904,8805,9709,photo
CompanyJ_11679,Saquon made three separate Dolphins fall on this play First juke via Giants ,76,1100,7681,8781,video
CompanyJ_11680,Keeper deserved the straight red for this via FOXSoccer ,56,506,3038,3544,video
CompanyJ_11681,Mascot went full Beast Mode on these kids at Patriots Bengals via ZackCoxNESN ,78,2638,14876,17514,video
CompanyJ_11682,Impossible throw from Carson Wentz via thecheckdown ,52,6302,45692,51994,video
CompanyJ_11683,A L L D A Y Adrian Peterson has tied Walter Payton for the fourth most rushing touchdowns in NFL history 1 1 0 trips to the end zone via NFL ,141,730,5207,5937,video
CompanyJ_11684,Last game in Oakland before the Raiders move to Vegas League won t be the same brgridiron ,90,624,2768,3392,video
CompanyJ_11685,Trying not to cry while Giants fans give Eli his well deserved ovation in what could be his last home start via Giants ,119,4279,29614,33893,video
CompanyJ_11686,THE BEARS WERE SO CLOSE TO PULLING IT OFF via thecheckdown ,59,601,6986,7587,video
CompanyJ_11687,Markelle made Jrue pay for going for the steal So smooth ,57,5609,39107,44716,video
CompanyJ_11688,Madison Bumgarner and Diamondbacks are nearing 5 year deal per JeffPassan ,74,432,2541,2973,photo
CompanyJ_11689,Confusion between Dak and the ref results in the Cowboys having to kick to begin both halves Wow via NFLonFOX ,110,829,7662,8491,video
CompanyJ_11690,There s run blocking and then there s what George Kittle just did via 49ers ,76,812,6353,7165,video
CompanyJ_11691, Giants gave Eli the game ball in what might ve been his final start in New York ,81,1252,11501,12753,video
CompanyJ_11692,Nick Young s son is a LEGEND via NickSwagyPYoung ,49,2916,27371,30287,video
CompanyJ_11693,Rondo faked the oop so Bron faked the block ,44,21668,115307,136975,video
CompanyJ_11694,Anndddd Raiders leave Oakland with one last L ,46,725,5663,6388,photo
CompanyJ_11695,Bron went no look and between the legs on the dime to Dwight ,61,14190,76687,90877,video
CompanyJ_11696,FALCONS WITH THE LAST SECOND TD TO STUN THE NINERS via AtlantaFalcons ,70,2390,13584,15974,video
CompanyJ_11697,Cowboys still the favorites for the NFC East too brgridiron ,60,702,3937,4639,video
CompanyJ_11698,KD shoved Kyrie in excitement of Jarrett Allen s dunk ,54,3227,30863,34090,video
CompanyJ_11699,Raiders fans started throwing trash on the field after losing their final home game in Oakland via torreyhart ,110,1679,11094,12773,video
CompanyJ_11700, You can thank Chris Paul The ref told Elfrid Payton to thank CP3 for getting a delay of game for having an untucked jersey ,124,1792,15385,17177,video
CompanyJ_11701,Dray tried to go off the glass to Glenn Robinson III ,53,410,4662,5072,video
CompanyJ_11702,Bron showed VC respect after their final game against each other ,65,3713,38111,41824,video
CompanyJ_11703,Duck Hodges all night ,22,933,7526,8459,photo
CompanyJ_11704,The Champions League Round of 16 UCLdraw Dortmund vs PSG Real Madrid vs Man City Atalanta vs Valencia Atletico vs Liverpool Chelsea vs Bayern Lyon vs Juventus Tottenham vs RB Leipzig Napoli vs Barcelona ,203,466,2063,2529,photo
CompanyJ_11705,Bills fans met the team at the airport at 2am in 25 degree weather after they made the playoffs brgridiron via BuffaloBills ,124,2946,38172,41118,video
CompanyJ_11706,No load management for KingJames ,33,5389,40182,45571,photo
CompanyJ_11707,Is Super Bowl champ Reggie Wayne heading to the ProFootballHOF Retired with 7th most catches ever 6x Pro Bowl Vote now From B R X FordTrucks PFHOF20 ,149,143,990,1133,video
CompanyJ_11708,In 2018 Kostas Manolas knocked Barcelona out of the UCL in Roma s epic second leg comeback In February Barcelona will face him on Napoli brfootball ,148,81,941,1022,video
CompanyJ_11709,Throwing Gilly s way is just a bad idea brgridiron ,51,382,3812,4194,photo
CompanyJ_11710,Drew Brees putting in mental reps by himself after practice Nobody else in the gym ReggieBush This is what it takes This is what greatness looks like ,150,5869,37449,43318,video
CompanyJ_11711,Houston Rockets star PJ Tucker surprised Kent State basketball player Kalin Bennett who became the first D I player with autism to score in a game earlier this year Bennett was able to choose and sign Tucker s sneakers for his game statefarm ,242,1606,8582,10188,video
CompanyJ_11712,Zach Ertz signing a Julie Ertz jersey at the Eagles game via Eagles ,68,473,7946,8419,video
CompanyJ_11713,6 1 270 lbs and a running back recruit Antwain Baby Bus Littleton didn t come this far to be a lineman ,103,147,766,913,status
CompanyJ_11714,At least 20 teams are seriously interested in signing Antonio Brown Patriots are the only postseason contender who would not sign him per B R s mikefreemanNFL ,159,2189,13909,16098,photo
CompanyJ_11715,Neymar has assisted all of Mbappe s last four goals Mbappe has assisted one of Neymar s last two Dynamic duo brfootball ,120,462,7440,7902,photo
CompanyJ_11716,This angle of the Wentz throw Ridiculous via metro_boonin ,58,1666,13377,15043,video
CompanyJ_11717,Multiple Browns players including Jarvis Landry yelled Come get me to the Cardinals sideline on Sunday per MikeSilver That s the same phrase JayGlazer reported OBJ has told opponents ,183,2942,18045,20987,photo
CompanyJ_11718,Pogba feeling it brfootball via paulpogba ,42,482,3689,4171,video
CompanyJ_11719,Josh Gordon has been suspended indefinitely for violating the NFL s PED and substance abuse policies ,101,2437,15441,17878,photo
CompanyJ_11720,It s chaos in the Champions house after a meteor wrecks Earth Season 3 finale of TheChampions PlayStation ,106,191,801,992,video
CompanyJ_11721,Joe Burrow s Heisman acceptance speech inspired more than 150K in donations to a Athens County Food Pantry in his hometown in Ohio ,131,786,8306,9092,photo
CompanyJ_11722,You can say China loves them some T Mac via tmac213 IG ,55,2521,24172,26693,video
CompanyJ_11723,Dejounte Murray and Harden going at it ,39,6172,39411,45583,video
CompanyJ_11724,Michael Thomas is unstoppable via NFL ,38,851,5782,6633,video
CompanyJ_11725,Drew Brees ties Peyton Manning with his 539th touchdown pass via NFL ,69,1003,6613,7616,video
CompanyJ_11726,Drew Brees becomes the all time TD pass leader brgridiron ,58,7169,39562,46731,photo
CompanyJ_11727,Drew Brees gets the 5 4 0 record via NFL ,41,1258,6069,7327,video
CompanyJ_11728,KP from wayyyyy downtown Mavs could end the Bucks 18 game win streak ,69,1053,8352,9405,video
CompanyJ_11729,Brees sends love to his family after breaking the NFL record for touchdown passes via thecheckdown ,99,2343,26946,29289,video
CompanyJ_11730,Mavs have ended the Bucks 18 game win streak without Luka KP 26 PTS 4 threes 12 REBS 4 ASTS ,92,2673,23275,25948,photo
CompanyJ_11731, I absolutely s t my pants Steven Adams kept it a little too real in his postgame interview ,92,1025,9603,10628,video
CompanyJ_11732,Drew Brees vs the Colts on MNF brgridiron Four touchdowns One incompletion ,75,601,6425,7026,photo
CompanyJ_11733,DAME TIME ,10,828,8539,9367,video
CompanyJ_11734,Melo balled out tonight 23 PTS 4 6 from three 8 REBS 2 STLS 3 BLKS ,67,6914,42377,49291,video
CompanyJ_11735,Brees is the new all time passing TD king and his peers had to show love brgridiron ,84,915,8354,9269,video
CompanyJ_11736, This guy is not normal Ronaldo tried to convince teammates to go to training right after a game brfootball ,108,816,7197,8013,photo
CompanyJ_11737, And Drew Brees is the GOAT Teddy Bridgewater via NFL ,54,254,2789,3043,video
CompanyJ_11738,From the 2015 playoffs to the tunnel game Rockets Clippers is one of the NBA s hottest current rivalries They face off again on TNT this Thursday ,146,1116,8984,10100,video
CompanyJ_11739,Drew Brees right after his record breaking TD pass What a moment brgridiron ,76,1987,25234,27221,photo
CompanyJ_11740,Is John Lynch heading to the ProFootballHOF Super Bowl XXXVII champion 9x Pro Bowl Vote now From B R X FordTrucks PFHOF20 ,122,42,406,448,video
CompanyJ_11741,Russ and Trey Lyles accidentally spilling fans drinks ,54,890,8392,9282,video
CompanyJ_11742,Former NBA Commissioner David Stern remains in serious condition after emergency surgery on Thursday to treat a brain hemorrhage ,129,367,4194,4561,photo
CompanyJ_11743,Generational brkicks ,21,1945,16342,18287,photo
CompanyJ_11744,Richard Sherman opens up to B R more than ever about why He welcomed a torn Achilles He s the best CB in the game He continues to give back ,140,292,2553,2845,status
CompanyJ_11745,Eight players we d love to see go head to head next year Day 8 of BRNBAXMas ,76,119,1151,1270,video
CompanyJ_11746, NickSwagyPYoung s kid went viral off one highlight and now he s pulling up to school like he s in the NBA ,107,1714,15120,16834,video
CompanyJ_11747,This stadium in Italy has a moat surrounding the field so someone has to fish out all the balls via sonyakarate ,112,142,2002,2144,video
CompanyJ_11748,UNC s Cole Anthony is expected to miss the next 4 6 weeks after surgery on a partially torn meniscus ,101,431,3588,4019,photo
CompanyJ_11749,That turn before the goal Filthy via FOXSoccer ,47,214,1523,1737,video
CompanyJ_11750,Kobe vs MJ 33 PTS vs 36 PTS 22 years ago today ,47,3069,19760,22829,photo
CompanyJ_11751,New GridironHeights The NFC East is up for grabs and it doesn t look like the Eagles or the Cowboys want it playstation ,120,611,2706,3317,video
CompanyJ_11752,Hope this works but if it doesn t _ ツ _ ,40,4083,35263,39346,photo
CompanyJ_11753,Pure Electricity Fallon Sherrock is the first woman ever to win a win a OfficialPDC World Championships darts match ,116,3426,24095,27521,video
CompanyJ_11754,Make A Wish Foundation s Gianna Henrickson attended her first Rangers game and met her favorite player Henrik Lundqvist during an unforgettable night via NYRangers ,164,347,2355,2702,video
CompanyJ_11755,Eli not going out quiet brgridiron ,35,682,7198,7880,photo
CompanyJ_11756,Bron too smooth with the dish ,30,5606,41990,47596,video
CompanyJ_11757,Vinsanity is another class of greatness Last game at MSG Advice for the NYK rook Standing ovation when checking in First bucket is cash ,136,779,7171,7950,video
CompanyJ_11758,Ravens are sending 12 players to the Pro Bowl Tied for the most ever Big Truss ,79,5819,42614,48433,photo
CompanyJ_11759,DSJ block RJ stepback Mitchell steal and finish This Knicks sequence ,69,600,4661,5261,video
CompanyJ_11760, Almost sat on him ,19,234,2441,2675,video
CompanyJ_11761,Malcolm Brogdon clutch buckets ,31,264,2304,2568,video
CompanyJ_11762,Rondo flopped on the ref ,25,853,8388,9241,video
CompanyJ_11763,Jrue dancing on them ,21,122,1681,1803,video
CompanyJ_11764, It s that wheel route You been watching film huh That s cool Watch this Two years ago today Cam called his shot on Clay Matthews Then delivered via thecheckdown ,162,11609,66707,78316,video
CompanyJ_11765,Brandon Ingram s ice cold getting to the rim ,45,584,5573,6157,video
CompanyJ_11766,Who is screaming that loud in the crowd ,40,1335,11302,12637,video
CompanyJ_11767,Oubre bodied PG ,16,12138,58679,70817,video
CompanyJ_11768,Donovan Mitchell too patient with it ,37,140,2086,2226,video
CompanyJ_11769,Filthy hangtime spidadmitchell ,31,1861,14828,16689,video
CompanyJ_11770,Paul George vs Kelly Oubre Jr has been a show in the first half ,64,3648,21295,24943,video
CompanyJ_11771,Jalen Suggs had himself a 40 piece Future stud in the league brhoops ,69,114,1620,1734,video
CompanyJ_11772,Kawhi unbothered ,17,336,4332,4668,video
CompanyJ_11773,This play sequence is satisfying to watch ,42,515,6111,6626,video
CompanyJ_11774, Barcelona vs Real Madrid El Clasico is today brfootball ,57,573,3433,4006,photo
CompanyJ_11775, ,1,749,9342,10091,photo
CompanyJ_11776,LeBron is having the best Year 17 we ve ever seen says HowardBeck Lakers vs Bucks is Thursday night on TNT ,107,1144,7205,8349,video
CompanyJ_11777,Ricky Williams had one of the wildest rookie years ever Weighed in at 242 8 pounds at the combine Ate three desserts in front of Saints brass Discusses his infamous wedding dress photoshoot New Untold Stories with MasterTes ,224,231,1192,1423,video
CompanyJ_11778,Is Edgerrin James heading to the ProFootballHOF NFL All Decade Team 2000s 4x Pro Bowl Vote now From B R X FordTrucks PFHOF20 ,125,52,321,373,video
CompanyJ_11779,Gerrit Cole brought back the sign he made as a kid for the 2001 World Series via YESNetwork ,92,2048,13744,15792,video
CompanyJ_11780,KG didn t hold back ,20,1047,9515,10562,photo
CompanyJ_11781,Karl Anthony Towns this season Leads all centers in scoring Also leads in 3 PT shooting 41 8 Nearly doubled his 3 PT attempts I just feel like Picasso up there ,160,394,3377,3771,status
CompanyJ_11782,8 amp 2 4 Two years ago today the Lakers retired both of Kobe s jerseys ,72,2479,10317,12796,video
CompanyJ_11783,Luka s hyped for El Clasico ,28,264,2879,3143,photo
CompanyJ_11784,Seven games of NBA 2K taking an unexpected twist brgaming Day 7 of BRNBAXMas ,77,289,1845,2134,video
CompanyJ_11785,Ronaldo got UP brfootball ,26,989,7677,8666,photo
CompanyJ_11786,Hang this KELLYOUBREJR ,23,2236,16514,18750,photo
CompanyJ_11787,El Clasico ends 0 0 for the first time in 17 years brfootball ,62,456,3922,4378,photo
CompanyJ_11788,Herman Boone the iconic coach portrayed in Remember the Titans dies at 84 ,74,12468,51714,64182,photo
CompanyJ_11789,Sat courtside and got to give Bron the assist via chettbutterworth IG ,70,4769,53284,58053,video
CompanyJ_11790, steveaustinBSR celebrating his birthday the only way he knows how BRWrestling ,79,2110,7135,9245,video
CompanyJ_11791,BI went off for 18 PTS season high for a quarter in the 1Q against the Timberwolves ,84,410,3316,3726,video
CompanyJ_11792,D Rose getting shifty ,22,10454,54923,65377,video
CompanyJ_11793,Ja went flying ,15,2703,22684,25387,video
CompanyJ_11794,Brad Beal CLUTCH ,17,1897,13732,15629,video
CompanyJ_11795,Melo alley oop ,15,1236,10114,11350,video
CompanyJ_11796,Serena Williams training with Mike Tyson Legends via MikeTyson ,63,5305,32280,37585,video
CompanyJ_11797,Kelenna Azubuike says Melo paid him 3K to wear his No 7 jersey on the Knicks He regrets not asking for more ,108,1584,13826,15410,video
CompanyJ_11798,There can only be one Bucks amp Lakers battle tonight on TNT ,61,4401,24592,28993,video
CompanyJ_11799,Ronaldo jumped over 27 inches on his gravity defying header Sheesh brfootball ,78,589,6544,7133,photo
CompanyJ_11800,The battle of NBA s best records will feature the reunion of the Antetokounmpo brothers ,88,679,6090,6769,video
CompanyJ_11801,You always hear about LeBron s humble beginnings Now he s helping to reshape this narrative for future generations Nike ,120,886,3849,4735,video
CompanyJ_11802,Is DT Richard Seymour heading to the ProFootballHOF Three Super Bowls in NE 2000 s All Decade Team Vote now From B R X FordTrucks PFHOF20 ,138,29,281,310,video
CompanyJ_11803,Taking passing tips out of K Love s book via ibethedream IG ,60,257,3740,3997,video
CompanyJ_11804,Greek Freak could be seeing the King in June Bucks amp Lakers clash tonight on TNT ,83,868,4883,5751,video
CompanyJ_11805,Russell Wilson has never gotten an MVP vote or made an All Pro team But he wins games at a historic pace That s what he cares about I want to be known as the greatest winner in this game ,187,760,5443,6203,status
CompanyJ_11806,Chad ochocinco nailed a 60 yard FG to win this fan his bet New br_betting Gameday Gameshow CaesarsPalace ,105,174,1549,1723,video
CompanyJ_11807, BRING BACK CHRISTMAS JERSEYS ,30,2273,20086,22359,photo
CompanyJ_11808,Breaking Potential No 1 pick James Wiseman has left University of Memphis Wiseman will sign with an agent and start prepping for the 2020 NBA draft per ShamsCharania ,166,2808,18364,21172,photo
CompanyJ_11809,Naismith Memorial Basketball HOF candidates for 2020 Kobe Bryant Kevin Garnett Tim Duncan Chris Bosh Tamika Catchings Full list ,128,1874,9464,11338,photo
CompanyJ_11810, I think I d be in the Hall of Fame right now if I ended up in Cleveland Ricky Williams says his career would ve been different had he ended up being drafted by the Browns New Untold Stories with MasterTes ,206,385,1719,2104,video
CompanyJ_11811,Young SoCal legends face off on the big stage tonight brhoops NBAonTNT at 10 30 ET ,83,1284,7859,9143,photo
CompanyJ_11812,Chuck is wrong for this via NBAonTNT ,37,446,3597,4043,video
CompanyJ_11813,Greek Freak vs Bron Who had the better first signature shoe brkicks ,68,219,3043,3262,photo
CompanyJ_11814,Giannis pulled up on AD ,24,1101,10441,11542,video
CompanyJ_11815,Giannis is going right at AD early ,35,468,3714,4182,video
CompanyJ_11816,Adam Sandler the floor general via SenseiSigh ,46,11573,78292,89865,video
CompanyJ_11817,Giannis really expanding his range ,35,1245,9792,11037,video
CompanyJ_11818,ANOTHER GIANNIS 3 ,18,1105,8941,10046,video
CompanyJ_11819,Bron passes Gary Payton on the all time assists list ,53,1143,8755,9898,photo
CompanyJ_11820,Giannis continues to expand his game That s now a career high 5 3PTs and counting ,82,1156,9806,10962,video
CompanyJ_11821,OH MY AD ,9,3254,25169,28423,video
CompanyJ_11822,The Greek Freak strikes down the King and the Lakers ,53,3973,21682,25655,video
CompanyJ_11823,Giannis drilled a career high 5 3PTs in a statement win over the Lakers ,72,915,6545,7460,video
CompanyJ_11824,Antetokounmpo family reunion via NBAonTNT ,42,12251,80759,93010,video
CompanyJ_11825,Pat Bev giving Harden zero breathing room ,42,1313,10329,11642,video
CompanyJ_11826,Russ really made them bring a ladder out to confirm the hoop was 10 feet ,73,828,6455,7283,video
CompanyJ_11827,Harden hit PG with a nasty combo adidasHoops ,45,1998,12713,14711,video
CompanyJ_11828,Lou Will couldn t believe the foul call on Russ He got ejected real quick ,74,1219,11153,12372,video
CompanyJ_11829,PG CLUTCH ,10,366,3406,3772,video
CompanyJ_11830, BRODIE 40 BALL ,16,1083,7278,8361,video
CompanyJ_11831,Russ waves off Pat Bev after his ejection Harden immediately tried to calm down Russ ,85,2540,18795,21335,video
CompanyJ_11832,Harden drilled the biggest shot of the game to help lift the Rockets over the Clippers MarriottBonvoy ,102,947,5964,6911,video
CompanyJ_11833,Reporter asks Russ if he regrets getting a technical for waving off Pat Bev after his ejection Westbrook had a perfect response via BenGolliver ,144,3520,23136,26656,video
CompanyJ_11834,Shaq in classic Adam Sandler movies is priceless via NBAonTNT ,62,20550,74729,95279,video
CompanyJ_11835,Career high five triples vs the King Greek Freak wants that crown MountainDew MtnDew3pt ,88,192,1848,2040,video
CompanyJ_11836,Second time this week a trio of brothers has gotten to swap jerseys Sports are incredible ,90,7315,40562,47877,photo
CompanyJ_11837,Lamar s humble in real life but cocky on Madden BRGaming brgridiron via jdormannn IG ,85,4165,36051,40216,video
CompanyJ_11838,The reigning MVP s squad has the best record in the NBA He s keeping himself humble ,84,2480,22386,24866,photo
CompanyJ_11839,Devonte Graham last season 4 7 PPG 2 6 AST Devonte Graham this season 19 1 PPG 7 5 AST The Hornets star s journey to runaway MIP ,129,1360,9188,10548,status
CompanyJ_11840,Mike Conley before and after he started working with an NBA stylist From B R x tissot ,86,141,1338,1479,video
CompanyJ_11841,Next level prep from Buffalo brgridiron ,40,388,5444,5832,photo
CompanyJ_11842,Kylian Mbappe turns 21 today 1 World Cup 3x Ligue 1 2017 Golden Boy 2018 Kopa Trophy Youngest player to 10 UCL goals Just the beginning brfootball ,147,1256,10320,11576,photo
CompanyJ_11843,Cavs came back Then KD came to GSW Three years ago Christmas gave us one of the most anticipated matchups in recent NBA history ,128,6112,24480,30592,video
CompanyJ_11844,Check the Brodie s resume ,26,1987,14304,16291,photo
CompanyJ_11845,Joe Mixon tweeted Tom Brady that he was too nervous to ask for his jersey TB came through brgridiron ,101,2155,24529,26684,photo
CompanyJ_11846,Does Darren Woodson belong in the ProFootballHOF 3x champ 3x All Pro Cowboys all time tackles leader Vote now From B R X FordTrucks PFHOF20 ,140,46,295,341,video
CompanyJ_11847,On this day in 2005 Kobe outscored the Mavs by himself through three quarters 62 points 18 31 FG 4 10 3PT 22 25 FT Lakers were up 34 Mamba declined playing the fourth to get 70 I ll do it when we really need it He dropped 81 a month later ,239,8027,35759,43786,photo
CompanyJ_11848,He put him on a poster then stared him down via brhoops ,56,4205,25986,30191,video
CompanyJ_11849,NBA sends proposal for 2021 22 season changes 78 game regular season In season tourneys with 1M per player 1 5M coaches for champ Play in tourneys to determine Nos 7 8 playoff seeds Final four reseeded in playoffs based on season standings via ShamsCharania ,258,2200,12303,14503,photo
CompanyJ_11850,Ja was WILD for trying this over Kevin Love ,44,21671,101976,123647,video
CompanyJ_11851, kevinlove had to give the rook his credit ,43,1431,11989,13420,photo
CompanyJ_11852,Brad Stevens wanted to see how loud Boston would get before he subbed Tacko in the game via Marc_DAmico ,104,9641,60997,70638,video
CompanyJ_11853,OKAY MARKELLE ,14,7364,55953,63317,video
CompanyJ_11854,Dame drops 36 CJ puts in another 31 Blazers win their third straight behind their dangerous duo ,96,532,6114,6646,video
CompanyJ_11855,Four days til these four MVPs take the court on Christmas BRNBAXMas ,68,478,4237,4715,photo
CompanyJ_11856,LeBron s daughter acting like every kid when they see the camera open on the phone via KingJames ,97,3593,40124,43717,video
CompanyJ_11857, I got ice in my veins After taking a pic with Luka this Sixers fan drained the jumper in front of him via fanaticsview ,120,16744,102372,119116,video
CompanyJ_11858,Fifty Goals In A Year For most that s impossible For Messi it s the ninth time brfootball ,90,1292,7552,8844,photo
CompanyJ_11859,Eagles legend Brian Westbrook and Cowboys superfan ZackTTG battle for bragging rights between the two rivals through a skills competition HarrahsPHL ,149,105,1087,1192,video
CompanyJ_11860,Five years ago today Marshawn Lynch rumbled for a 79 yard touchdown and jumped into the end zone like only he could Classic Beast Mode via nflthrowback ,152,5741,33861,39602,video
CompanyJ_11861,Jamie Vardy Wow Via nbcsportssoccer ,36,188,1693,1881,video
CompanyJ_11862,Jameis has now thrown a pick on the opening drive five times this year Five via ScottSBucs ,91,938,9271,10209,photo
CompanyJ_11863,Darren Sproles is retiring after his 15th NFL season One of the most electrifying players of all time via Eagles ,113,4938,29520,34458,photo
CompanyJ_11864,Airness still making history brkicks ,37,924,8370,9294,photo
CompanyJ_11865,Special teams coach is a legend for this one via FOXSportsSW ,61,3507,20161,23668,video
CompanyJ_11866,Luka Doncic is nearing a lucrative multi year deal with Jordan Brand per ShamsCharania and tim_cato ,100,2490,18744,21234,photo
CompanyJ_11867,Luka two weeks ago You can t compare nobody to Michael Jordan Luka today About to sign with Michael Jordan brkicks ,115,3012,22899,25911,video
CompanyJ_11868,Harden s got respect from the greats ,37,2523,16050,18573,photo
CompanyJ_11869, 20 gift for whoever could steal the ball from Santa spiceadams ,64,686,3338,4024,video
CompanyJ_11870,Mbappe s last 7 games 9 goals 3 assists Neymar s last 5 games 5 goals 6 assists Ending 2019 strong ,99,306,2929,3235,photo
CompanyJ_11871,Jumpman is in good hands brkicks ,33,1371,15171,16542,photo
CompanyJ_11872,BRADY TOOK HIM OUT via NFL ,27,3548,22589,26137,video
CompanyJ_11873,BIG MAN TD Josh Allen hits 320 pound tackle Dion Dawkins to tie it up vs New England via NFL ,93,1019,10193,11212,video
CompanyJ_11874,Patriots have won the division for 11 straight years Unreal brgridiron ,71,585,3263,3848,video
CompanyJ_11875,LHP Dallas Keuchel and White Sox have reached an agreement on a deal per JeffPassan ,84,511,2381,2892,photo
CompanyJ_11876, Yeah they might be open but they can just get your rebound if you miss ,72,30942,162917,193859,video
CompanyJ_11877,Kobe and VC Two legends via NBA ,32,2904,25741,28645,video
CompanyJ_11878,KAWHI ,6,311,3095,3406,video
CompanyJ_11879,IT let a fan know what was on his mind and got ejected ,55,845,8520,9365,video
CompanyJ_11880,THANASIS ANTETOKOUNMPO Bucks bench couldn t believe it ,55,7394,57628,65022,video
CompanyJ_11881,JIMMY G LAUNCHED IT via 49ers ,30,1563,10687,12250,video
CompanyJ_11882,Beard amp Russ combined for 77 points tonight Harden 47 PTS 6 REB 7 AST Westbrook 30 PTS 4 REB 10 AST The duo is starting to find their groove as teammates ,156,4130,28210,32340,photo
CompanyJ_11883,Rams fans watching their squad go from the Super Bowl to missing the playoffs brgridiron ,89,3282,22369,25651,video
CompanyJ_11884,17 year old Sebastiano Esposito had his mom in the front row to celebrate his first Serie A goal brfootball What a moment ,122,294,3983,4277,photo
CompanyJ_11885,A Raiders superfan who served in the military and now serves for the Oakland Fire Department gets the surprise of a lifetime by Raiders legend Ray Guy Ford X B R PFHOF ,168,70,703,773,video
CompanyJ_11886,49ers QB C J Beathard s brother was fatally stabbed in a bar fight this weekend Coach Kyle Shanahan delivered a heartfelt speech to the team and dedicated their win to C J and his family via 49ers ,197,5122,33156,38278,video
CompanyJ_11887,Lamar has made it a goal to learn the first name of everyone at the Ravens facility Not just players and coaches One of the many stories about LJ s leadership this year via KimJonesSports ,188,2247,21161,23408,photo
CompanyJ_11888, 50 goals in 9 10 years 91 goals in 2012 Messi s decade brfootball ,67,378,2791,3169,photo
CompanyJ_11889,Robert Williams got REAL dark when they asked the Celtics about their favorite holiday movie ,93,267,2755,3022,video
CompanyJ_11890,James Harden now has the 4th most 40 point games ever after dropping 47 last night ,83,839,5797,6636,photo
CompanyJ_11891,Sixteen years ago today Brett Favre played on Monday Night Football one day after his father died He honored his dad with one of the best games of his life 22 30 att 399 yards 4 TDs 41 7 W He was there that night ,213,1111,9818,10929,photo
CompanyJ_11892,Manchester United loses to the last place team in the Premier League Watford only had one league win before this brfootball ,124,198,1141,1339,photo
CompanyJ_11893, Don t do that man IT confronts the fan who allegedly shouted f k you b h after he made a free throw via victoriafinn10 ,120,9076,64345,73421,video
CompanyJ_11894,That s a ROCKET via NBCSportsSoccer ,36,247,1723,1970,video
CompanyJ_11895,Philly fans get a Frosty if an opponent misses two free throws in the second half ,82,1151,9798,10949,photo
CompanyJ_11896,Real Betis fans throw toys onto the field so they can be donated to children in need over the holidays ,103,896,5992,6888,photo
CompanyJ_11897,Son gets a red card for violent conduct via NBCSportsSoccer ,60,70,744,814,video
CompanyJ_11898,Christmas clutch from 3 Day 3 of BRNBAXmas ,43,910,5223,6133,video
CompanyJ_11899,The two 76ers fans who yelled obscenities at Isaiah Thomas last night have been banned from Wells Fargo Center for 12 months ,125,977,9233,10210,photo
CompanyJ_11900,Nothing the defense could do on this 67 yard Saquon TD run Made the defender look silly in the open field via Giants ,117,801,6218,7019,video
CompanyJ_11901,Steelers benched Duck Hodges for Mason Rudolph This fan was READY via steelersfan8479 ,86,4513,28640,33153,video
CompanyJ_11902,Lamar Jackson threw for 138 yards and two touchdowns in the last two minutes of the first half Surgical ,104,3745,28603,32348,photo
CompanyJ_11903,Ronaldo couldn t take off the silver medal fast enough via btsportfootball ,75,1998,17016,19014,video
CompanyJ_11904,Fastest to 12 000 receiving yards Hall of Fame career for Julio and he s not done yet brgridiron ,97,5124,35472,40596,photo
CompanyJ_11905,Odell and Freddie Kitchens ,27,831,10082,10913,photo
CompanyJ_11906,144 times that proved you can t guard Mike Cantguardmike with the most receptions in a single season brgridiron ,112,3742,15889,19631,video
CompanyJ_11907,Browns haven t made the playoffs in 17 years brgridiron ,56,2336,15919,18255,video
CompanyJ_11908,Saquads today 2 TDs 189 rushing yards 90 receiving yards 279 scrimmage yards 43 9 PPR fantasy points Giants scrimmage yards record brgridiron ,142,1008,10334,11342,photo
CompanyJ_11909, We re gonna beat the Clippers since they treated you really really bad NickSwagyPYoung s son ,94,459,5328,5787,video
CompanyJ_11910,Raptors complete 30 point comeback largest in franchise history Lowry had 20 in the fourth ,91,1216,10770,11986,photo
CompanyJ_11911, This one referee started shaving last week The announcers did not like this foul call ,87,1196,12735,13931,video
CompanyJ_11912,NBA suspends Isaiah Thomas two games for entering the crowd during verbal confrontation with fans ,98,530,4983,5513,photo
CompanyJ_11913,Eagles fans going to bed knowing the Cowboys couldn t clinch vs Philly brgridiron ,82,1855,7029,8884,video
CompanyJ_11914,OKC gave Paul George a loud ovation in his first return as a Clipper via AndrewGreif ,85,397,4306,4703,video
CompanyJ_11915,Tacko got MVP chants in Boston ,31,1396,13387,14783,video
CompanyJ_11916,Mahomes with the sidearm throw Too easy via thecheckdown ,57,978,12736,13714,video
CompanyJ_11917,Pat Mahomes counted to 10 to let the Bears know where he landed in the draft via Chiefs ,88,5584,44177,49761,video
CompanyJ_11918,Giannis gave this fan his game shoes and her reaction is everything via Bucks ,78,4033,36097,40130,video
CompanyJ_11919,Hyun Jin Ryu s signing brings Scott Boras offseason total to over 1 billion for his clients Other notable signings Strasburg 7 year 245M Rendon 7 year 245M Cole 9 year 324M ,173,446,3450,3896,photo
CompanyJ_11920,Imagine getting a penalty like this scored on you in FIFA via u iZieMY ,71,410,4695,5105,video
CompanyJ_11921, Can we get some professionalism here please Larry Fitzgerald s dad is a reporter and Fitz trolled him when his phone went off via ChierstinSusel 12News ,153,3729,36709,40438,video
CompanyJ_11922,Even Harbaugh is saying it now brgridiron ,42,1410,14644,16054,photo
CompanyJ_11923,BEAST MODE BACK Marshawn Lynch and the Seahawks are open to a reunion and he s traveling to Seattle today to discuss per RapSheet MikeGarafolo and TomPelissero ,160,3384,21050,24434,photo
CompanyJ_11924, Who s your favorite point guard K Low or Freddy pskills43 had to answer or drink sergeibaka s cricket tea in a new How Hungry Are You ,135,152,971,1123,video
CompanyJ_11925, Cantguardmike is having one of the greatest receiving seasons of all time No 1 in rec yards No 1 in 1st downs No 1 in targets No 1 in catch among WR No 2 in rec TDs Nine games with 10 catches Broke Marvin Harrison s single season catch record ,244,6118,34511,40629,photo
CompanyJ_11926,Kawhi will never let on but some around the league really think he went to L A to compete against LeBron East GM I would say there s mutual respect but that there s an appropriate level of fear as well I don t see them going out to dinner ,239,179,1099,1278,status
CompanyJ_11927,King not expected to miss Christmas Source close to LeBron says he should be ready to play against the Clippers per mcten ,122,1144,12237,13381,photo
CompanyJ_11928, If you need me to sing any of those for you I got you Kevin Garnett and Adam Sandler play Start Bench Cut ,107,184,1405,1589,video
CompanyJ_11929, Twas two nights before the two LA teams face off on Christmas Day BRNBAXMas ,77,1713,6239,7952,video
CompanyJ_11930,Lamar Jackson will sit Sunday with the No 1 seed in the AFC locked up His 2019 regular season is over 13 2 record 36 passing TD 6 interceptions 3 127 passing yards 66 1 completion 1 206 rushing yards 7 rushing TD One for the ages ,230,16779,82753,99532,photo
CompanyJ_11931,Zlatan s statue in Malmo has now been vandalized twice brfootball ,66,477,5746,6223,photo
CompanyJ_11932,Kawhi s uncle Dennis Robertson reportedly asked the Raptors Lakers and Clippers for part ownership of the team a private plane house and guaranteed amount of endorsement money per sam_amick The NBA investigated and found no evidence the Clippers granted those requests ,269,1727,9383,11110,photo
CompanyJ_11933,AD is already cementing himself as one of LeBron s best ever teammates ,71,1016,10042,11058,video
CompanyJ_11934,Cavs are trading Jordan Clarkson to the Jazz for Dante Exum per wojespn ,72,2543,19238,21781,photo
CompanyJ_11935,That was tough BenSimmons25 ,28,675,6890,7565,video
CompanyJ_11936,Nailed the half court shot and won free Chick fil A for a year The basketball gods were on his side ,100,6994,64946,71940,video
CompanyJ_11937,DERRICK JONES JR ON THE REIGNING DPOY ,38,7063,38676,45739,video
CompanyJ_11938,Just a littttllleeee strong on the pass ,40,447,5088,5535,video
CompanyJ_11939,Diggs one on one Six for Minnesota via Vikings ,47,254,2493,2747,video
CompanyJ_11940,The Seahawks and Marshawn Lynch are expected to get a deal done at some point per AdamSchefter ,95,1811,13948,15759,photo
CompanyJ_11941,Tacko Fall conducted an entire orchestra through Sleigh Ride tonight Legend via nicolecyang ,92,1083,8622,9705,video
CompanyJ_11942,Melo at the buzzer ,19,4480,29413,33893,video
CompanyJ_11943,Marshawn Lynch and the Seahawks have an agreement on a deal per AdamSchefter Beastmode is back ,95,10042,50552,60594,photo
CompanyJ_11944,Last week Marshawn was handing out tequila shots at a Raiders tailgate Today Signed with the Seahawks Nobody like Beastmode brgridiron via jake_muller ,151,2598,19146,21744,photo
CompanyJ_11945,Lonzo put his own teammate on a poster ,39,3512,29714,33226,video
CompanyJ_11946,Jerami Grant SHUT IT DOWN NHTSAgov ,35,351,3447,3798,video
CompanyJ_11947,Clarkson is headed to Salt Lake City From B R x americanexpress ,64,982,9883,10865,video
CompanyJ_11948,The wait is almost over One day full of hoops for basketball fans everywhere tomorrow BRNBAXmas ,96,171,1266,1437,video
CompanyJ_11949,Santa Mbappe got that holiday spirit brfootball ,48,133,2088,2221,photo
CompanyJ_11950, New GridironHeights Mahomes and Co are in the holiday spirit singing their favorite tunes PlayStation ,103,496,2405,2901,video
CompanyJ_11951,Will another chapter be added to the book of NBA Christmas legends tomorrow ,76,187,1238,1425,video
CompanyJ_11952,Bron and AD are both expected to play against the Clippers on Christmas per wojespn ,84,4626,38996,43622,photo
CompanyJ_11953,Michael Thomas creating unforgettable moments for a special fan at the hospital brgridiron via Nader723 ,104,3324,23753,27077,video
CompanyJ_11954,How d the ball end up back on the tee via a_sweeney12 IG ,57,124,2467,2591,video
CompanyJ_11955,This kid got LeBron to nod at him and he couldn t believe it via hasanjhaveri IG ,81,5670,54261,59931,video
CompanyJ_11956, De11eDonne visited a support home for disabled adults amp kids and gave everyone a pair of her FlyEase shoes The sneakers are inspired by her sister Lizzie who was born deaf and blind with cerebral palsy and autism brkicks ,224,301,1913,2214,video
CompanyJ_11957,Kawhi on what Christmas Eve looks like in the Leonard household Private I don t discuss that with you guys via TomerAzarly ,123,6175,54404,60579,video
CompanyJ_11958,Never change Marshawn via Seahawks ,35,12506,60486,72992,video
CompanyJ_11959,This bettor turned 5 into 100k during this past week s NFL slate br_betting via WilliamHillUS ,94,1081,10190,11271,photo
CompanyJ_11960,Warriors vs Cavaliers on Christmas Day 2016 was a classic ,58,5479,28741,34220,video
CompanyJ_11961,Safe to say DarrenSproles proved them all wrong via brgridiron ,63,947,10482,11429,photo
CompanyJ_11962,Several younger Seahawks players were starstruck when they saw Marshawn Lynch in the locker room for the first time per Joe_Fann Many of them tried to play it cool but failed ,175,2237,31170,33407,photo
CompanyJ_11963, ,1,363,4772,5135,link
CompanyJ_11964,Today s the day ,16,4338,22470,26808,video
CompanyJ_11965,A full day of hoops Merry Christmas to all ,43,3253,20349,23602,photo
CompanyJ_11966,The NBA s biggest stars will take center stage on Christmas Day MountainDew ,76,399,2790,3189,video
CompanyJ_11967,In 1914 English and German soldiers played a game of in No Man s Land on Christmas during World War I The beautiful game brfootball ,132,999,7016,8015,photo
CompanyJ_11968,Bron is ready to protect home court on Christmas dakidgowie officialminks via HoHighlights ,91,2485,8044,10529,video
CompanyJ_11969, IT S A CHRISTMAS MIRACLE Ser King James invites everybody over to his Brentwood castle before the season starts in a special episode of GameOfZones statefarm ,159,1607,5393,7000,video
CompanyJ_11970,The best Christmas themed shoes brkicks ,40,942,7910,8852,photo
CompanyJ_11971,On Christmas Day 2015 LeBron caught a fan taunting him ,55,6185,55521,61706,video
CompanyJ_11972, NBAXMAS IS HERE LET S GO ,26,388,2733,3121,photo
CompanyJ_11973,Enes Kanter has not played a game outside the US in over a year out of fear for his safety since criticizing the Turkish government Today he finally gets to ,157,2481,22985,25466,photo
CompanyJ_11974,Jaylen Brown did Rondae Hollis Jefferson DIRTY RockstarGames ,61,292,2213,2505,video
CompanyJ_11975,Instead of their usual WWE routine pregame the Bucks gave each other gifts for Christmas via Bucks ,99,1464,15347,16811,video
CompanyJ_11976,These boys recently lost their father so Matthew Stafford showed up at their house to bring them Christmas presents via Heather Krause Jenny Myers FB ,150,10891,88377,99268,video
CompanyJ_11977, GIANNIS via NBA ,17,1963,16240,18203,video
CompanyJ_11978,Pick My Kicks is back for NBAXMAS Vote now on brkicks IG to help PJ Tucker choose what he ll wear against the Warriors ,119,116,1439,1555,photo
CompanyJ_11979,Joel Embiid is putting on a show on NBAXmas He had 23 PTS 8 11 FG and hit three 3PTs in the first half via NBA ,111,391,3039,3430,video
CompanyJ_11980,Embiid told Giannis to sit down via NBA ,40,1371,10895,12266,video
CompanyJ_11981,Joel Embiid 31 PTS 11 REB and the 76ers hand the league leading Bucks their biggest loss of the season on NBAXMAS 121 109 ,122,510,3558,4068,video
CompanyJ_11982,Embiid has his eyes set on DPOY ,32,367,5295,5662,photo
CompanyJ_11983,The Lakers went in on Kuz s fit via QCook323 ,45,7045,44326,51371,video
CompanyJ_11984,Beard was handing out the work in the first half He s 5 7 from 3PT for 19 PTS so far via HoustonRockets ,104,271,3085,3356,video
CompanyJ_11985,Warriors beating the Rockets NBAXmas ,37,1117,11062,12179,photo
CompanyJ_11986,Dray out here hitting threes The warriors are feelin it ,56,512,4636,5148,video
CompanyJ_11987,The Rockets just gave the Warriors their first win over a team with a 500 record ,81,3342,35427,38769,photo
CompanyJ_11988,Draymond was feeling it from 3PT and nailed the dagger against the Rockets MtnDew3pt MountainDew ,97,234,1947,2181,video
CompanyJ_11989,Bron AD Kawhi PG Battle of LA begins now ,41,2180,16958,19138,photo
CompanyJ_11990,Kawhi feelin it early 14 first quarter points via NBA ,54,501,5846,6347,video
CompanyJ_11991,15 points off the bench in 5 minutes ,37,1211,13300,14511,link
CompanyJ_11992,Kyle Kuzma Man on fire via NBA ,31,1067,7722,8789,video
CompanyJ_11993,KCP with a nasty rejection via NBATV ,37,1312,10525,11837,video
CompanyJ_11994,4th quarter Bron has been activated via NBA ,44,615,6090,6705,video
CompanyJ_11995,Kawhi and the Clippers steal an NBAXMas win ,44,6147,25499,31646,video
CompanyJ_11996,Wonder if KevinHart4real is okay after being crushed by AD ,59,669,5554,6223,video
CompanyJ_11997,Pat Bev with the clutch block on Bron to seal the game RockstarGames ,69,518,3716,4234,video
CompanyJ_11998,Pat Bev responds to a fan telling him don t make me call James Harden I ll lock his ass up too via HayleyByrnes ,112,6098,42393,48491,video
CompanyJ_11999,Embiid ruined the Greek Freak s Christmas statefarm ,52,335,2711,3046,video
CompanyJ_12000,Can t teach that ,17,960,9287,10247,photo
CompanyJ_12001,That was smooth BeMore27 via nuggets ,37,706,6460,7166,video
CompanyJ_12002,Monster game from Brandon Ingram tonight 31 PTS 7 Threes career high 7 REBS ,76,2423,18065,20488,video
CompanyJ_12003,Everyone who got Madden for Christmas has to try this BRGaming brgridiron via nickmanfre IG ,92,3942,38506,42448,video
CompanyJ_12004,June could determine who really runs Los Angeles ,49,817,8379,9196,photo
CompanyJ_12005,Zlatan Ibrahimovic has agreed a deal to return to AC Milan per DiMarzio brfootball ,83,1177,7194,8371,photo
CompanyJ_12006,Never bet against the Spurs until now says HowardBeck ,54,390,4025,4415,video
CompanyJ_12007,It s all about giving back ,27,1360,7728,9088,photo
CompanyJ_12008,Six months ago Corey Groves was diagnosed with stage four sarcoma cancer and given under a year to live One of the 17 year old s wishes was to meet KingJames Raptors superfan Nav Bhatia helped make it happen Corey got his wish on Christmas via CTVNews ,252,3208,30239,33447,photo
CompanyJ_12009,A fan bet that Chad ochocinco couldn t name some of the quarterbacks he had played with in his career and he was right New br_betting Gameday Gameshow w cabbie amp kellyinvegas CaesarsPalace ,191,126,870,996,video
CompanyJ_12010,The Steelers lost AB Le Veon and Big Ben Their best players have gotten hurt A beloved coach died How is this team still alive for a playoff spot ,146,743,3897,4640,status
CompanyJ_12011,Travis Kelce hosted his first ever robotics tournament and put these kids knowledge to the test statefarm ,106,92,717,809,video
CompanyJ_12012,Luka Doncic ankle is expected to make his return tonight against the Spurs per espn_macmahon ,93,491,6125,6616,photo
CompanyJ_12013,Her reaction to getting Bucks tickets for Christmas via cindyw968 IG ,69,873,10230,11103,video
CompanyJ_12014,WHAT A HIT via NBCSportsSoccer ,31,403,2803,3206,video
CompanyJ_12015,Brian Schottenheimer told Drew Brees following his third NFL season the Chargers were probably going to take a QB in the 2004 draft Brees responded That would be the worst f king mistake this organization could ever make brgridiron via AlbertBreer ,248,6825,45646,52471,photo
CompanyJ_12016,Zion says his rehab has involved more than recovering from surgery ,67,490,6295,6785,photo
CompanyJ_12017,Respect kevinlove ,18,1757,25017,26774,photo
CompanyJ_12018,Basketball s better with the Splash Bros ,41,3238,22997,26235,photo
CompanyJ_12019,Roberto Firmino s last 3 games Winner in Club World Cup semifinal Winner in Club World Cup final Two goals vs Leicester On fire brfootball ,139,189,1477,1666,photo
CompanyJ_12020,4 0 win vs 2nd place Leicester 13 points clear in 1st Liverpool get what they want for Christmas brfootball ,108,485,3993,4478,photo
CompanyJ_12021,Rudy Gay looking back at Pop and Tim Duncan s fashion with an NBA stylist From B R x tissot ,92,70,526,596,video
CompanyJ_12022,The newest members of Team Jordan brkicks ,42,1040,12578,13618,photo
CompanyJ_12023,Trent Alexander Arnold did the Mbappe after his 1 goal 2 assist performance ,76,226,3046,3272,photo
CompanyJ_12024,Pat Bev mocking LeBron s shot after he blocked him ,51,657,7224,7881,video
CompanyJ_12025,Chuck really trying to teach Zion how to walk and run via NBAonTNT ,67,5070,33897,38967,video
CompanyJ_12026,THIS SETH CURRY DIME ,21,6709,50297,57006,video
CompanyJ_12027,Vintage Melo ,13,2409,23280,25689,video
CompanyJ_12028,Bronny and Zaire making it look too easy with KingJames in attendance brhoops via WhosNextHS ,93,2873,25130,28003,video
CompanyJ_12029,Bicycle kick to win the game in the 92nd minute UNREAL via FOXSoccer ,69,2089,10705,12794,video
CompanyJ_12030,Melo had a chance to tie it ,28,1185,15380,16565,video
CompanyJ_12031,Antonio Brown is working out for the Saints per AdamSchefter ,61,6751,38539,45290,photo
CompanyJ_12032,Zach Randolph says he s ending his comeback plans and will retire from the NBA after 17 seasons Salute Z Bo via TMZ_Sports ,123,7687,56447,64134,photo
CompanyJ_12033,Hawks are last in the East but Ice Trae is putting up ridiculous numbers 29 PPG 8 5 APG All Star ,97,838,8738,9576,video
CompanyJ_12034, brfootball ,12,402,3268,3670,photo
CompanyJ_12035,Brodie wasn t about it ,23,5777,36725,42502,photo
CompanyJ_12036,Drake says Rich Paul was the one who convinced him to release Best I Ever Had as his first single Drake wanted to use Uptown Everything changed after that via RapRadar ,168,2423,19618,22041,photo
CompanyJ_12037,Wilder Fury Rematch Feb 22 LET S GO ,36,11470,48463,59933,photo
CompanyJ_12038,Zlatan Ibrahimovic officially returns to AC Milan brfootball ,61,687,4183,4870,video
CompanyJ_12039,AP Athletes of the Year Male Kawhi Leonard Female Simone Biles ,63,4627,38090,42717,photo
CompanyJ_12040,Cold blooded brgridiron ,24,1025,10817,11842,photo
CompanyJ_12041,Some NFL scouts say Clemson RB Travis Etienne is the best back in the draft Others say he s only a role player ,111,111,846,957,status
CompanyJ_12042,Powerful answer from Tom Brady on the sacrifices older players make Kids family life things Things that you can t get back via Patriots brgridiron ,147,1410,11421,12831,video
CompanyJ_12043,Z Bo was known as an enforcer in his 17 year career but he d give the shirt off his back for fans Gotta respect that via NBA ,125,2536,22821,25357,video
CompanyJ_12044,One of the greatest coaches ever sees one of the greatest players ever in luka7doncic s game ,93,925,9349,10274,photo
CompanyJ_12045,Things are in South Beach ,26,957,8436,9393,video
CompanyJ_12046,It had been three years since Heat rookie Chris Silva had last seen his mother That changed today via NBA ,106,22261,129849,152110,video
CompanyJ_12047,DEVONTE GRAHAM CLUTCH ,22,1332,11243,12575,video
CompanyJ_12048,Terry Rozier got a technical for his celebration after CP3 missed at the end of regulation ,91,423,7018,7441,video
CompanyJ_12049,Devonte Graham with an absolutely ridiculous shot ,50,7072,51841,58913,video
CompanyJ_12050,Shai with one of the filthiest eurosteps you ll see all year ,61,4831,36826,41657,video
CompanyJ_12051, Grizzlies Nuggets Pacers Pelicans Raps Celtics Hawks Bulls Cavs T Wolves Nets Rockets 76ers Heat Knicks Wizards Magic Bucks Pistons Spurs Mavs Dubs Suns Kings Lakers Blazers Jazz Clips CFP semifinals Saturday gonna be a wild ride ,231,1756,12425,14181,photo
CompanyJ_12052,D Lo extends the Warriors lead and Steph becomes the ultimate hype man at Chase Center ,87,1068,11527,12595,video
CompanyJ_12053,Seahawks playing Rock Paper Scissors via Seahawks ,50,1156,9541,10697,video
CompanyJ_12054,Boban playing keepaway with Luka via coulter_bostick IG ,56,2726,28647,31373,video
CompanyJ_12055,He did the defender DIRTY via borussia_fr ,42,4306,25646,29952,photo
CompanyJ_12056,Z Bo officially says goodbye ,29,2822,22247,25069,photo
CompanyJ_12057,Wolves Adama Traore is built like a tank brfootball ,52,702,8514,9216,photo
CompanyJ_12058, spidadmitchell gave the kid the headphones right off his head via thesofasurfer IG ,84,5161,53716,58877,video
CompanyJ_12059,Usain Bolt racing his godson is too sweet via UsainBolt ,56,705,10660,11365,video
CompanyJ_12060, brfootball ,12,408,3643,4051,photo
CompanyJ_12061,,0,6549,46025,52574,photo
CompanyJ_12062,Broadway Joe is putting on a show Make that 3 TDs and counting for Justin Jefferson via SECNetwork ,99,560,4601,5161,video
CompanyJ_12063,Not 1 not 2 but 4 TDs for Justin Jefferson That s a new single game CFP record via SECNetwork ,94,4111,25115,29226,video
CompanyJ_12064,Joe Burrow has 7 TDs and LSU is up 49 14 before half CFBPlayoff ,64,4113,18582,22695,photo
CompanyJ_12065,Joe Burrow broke the CFBPlayoff and LSU single game bowl record with 7 TDs in the first half against No 4 Oklahoma 21 27 for 403 yards 7 TDs 0 INTs ,148,5171,27550,32721,photo
CompanyJ_12066,Jamal Murray GOT UP NHTSAgov ,29,318,2392,2710,video
CompanyJ_12067,This lucky fan swapped kicks with Zionwilliamson brkicks via PelicansNBA ,73,586,8070,8656,video
CompanyJ_12068,All LSU from beginning to end Joe Burrow and Justin Jefferson lead the Tigers to the CFBPlayoff final with a 63 28 win over No 4 Oklahoma Burrow 29 39 for 493 yards 7 TDs 1 rushing TD Jefferson 14 catches for 227 yards 4 TDs ,225,1357,7483,8840,photo
CompanyJ_12069,Justin Jefferson lit up the Peach Bowl with NFL eyes on him brgridiron ,71,615,4215,4830,photo
CompanyJ_12070,History was made tonight in New Orleans The three Holiday brothers Jrue Justin and Aaron became the first trio of brothers to all play in the same NBA game together ,165,2360,16524,18884,photo
CompanyJ_12071,Ridiculous ,11,5444,37611,43055,photo
CompanyJ_12072,Porzingis and Draymond started going at it and Klay tried to get involved from the bench ,89,4281,36418,40699,video
CompanyJ_12073,D Angelo Russell was on the floor for several minutes after colliding with Luka Doncic He was able to walk on his own power after a stretcher was brought to the court ,167,443,4467,4910,photo
CompanyJ_12074,Josh Richardson purposely missed the free throw and Ben Simmons tipped it in to tie the game Refs originally ruled it off then counted the bucket after the review Wild ,168,600,6548,7148,video
CompanyJ_12075,Tyler Herro came up CLUTCH against Philly RockStarGames ,56,817,5866,6683,video
CompanyJ_12076,Trevor Lawrence and Clemson advance to the CFBPlayoffs title game with a 29 23 win over No 2 Ohio State The Tigers have now won 29 straight ,140,2090,11397,13487,photo
CompanyJ_12077,The Buckeyes blew a 16 0 lead ,30,2150,16460,18610,photo
CompanyJ_12078,Burrow Lawrence LSU Clemson The stage is set CFBPlayoffs ,57,3271,23475,26746,photo
CompanyJ_12079,Spida hit Kawhi with the fake and then took flight adidasHoops ,63,3802,30118,33920,video
CompanyJ_12080,Steph and Riley Curry have a whole handshake via nba ,53,8533,66702,75235,video
CompanyJ_12081,With Lamar sitting today RG3 will get his first start since 2016 He s got something to prove brgridiron ,104,723,8273,8996,photo
CompanyJ_12082,19 year old Erling Haaland has officially joined Borussia Dortmund brfootball ,78,495,4043,4538,photo
CompanyJ_12083,Holidays Antetokounmpos Edmunds Trios of brothers are making history this year ,79,3435,20010,23445,photo
CompanyJ_12084,A decade of greatness ,22,1017,5656,6673,photo
CompanyJ_12085,TAMMY ABRAHAM CHELSEA COMEBACK COMPLETE via NBCSportsSoccer ,60,333,2134,2467,video
CompanyJ_12086,Tonight Beast Mode BACK ,24,1779,14529,16308,photo
CompanyJ_12087,Saints reportedly want to sign AB brgridiron ,45,2638,17472,20110,photo
CompanyJ_12088,Liverpool s goal VAR ruled a goal Wolves goal VAR ruled offside Liverpool ,74,417,3148,3565,photo
CompanyJ_12089,Liverpool haven t lost at home in FIFTY games brfootball ,57,291,1881,2172,photo
CompanyJ_12090, ,1,6094,26676,32770,photo
CompanyJ_12091,First ever pick six for Tom Brady against the Dolphins Only took over 1 000 attempts for it to happen via NFL ,110,1003,8126,9129,video
CompanyJ_12092,Jalen Hurts had an unbelievable college career 2019 Heisman runner up National champion Threw for 80 TDs 9 477 YDS Won SEC Offensive POY as a freshman Came off the bench in the 4th to lead Bama to 2018 SEC title Broke Bama amp Oklahoma single season QB rushing YDS records ,273,5008,27260,32268,photo
CompanyJ_12093,J A M E I S via NFL ,20,1175,10607,11782,video
CompanyJ_12094,Teddy Bridgewater is one TD away from a 250K bonus Saints are up 35 3 at half Teddy time brgridiron ,100,1364,15300,16664,photo
CompanyJ_12095,Klay s been dressing in full uniform and a headband before Warriors games while going through his workout Seems like he can t wait to be back via Ali_Thanawalla h t loganmmurdock ,179,3653,32452,36105,video
CompanyJ_12096,Tom Brady just passed Peyton Manning for second all time in touchdown passes Two of the greatest ever learned a lot from each other via nflnetwork ,147,440,2866,3306,video
CompanyJ_12097,CMC with one of the greatest RB seasons ever brgridiron ,56,1472,9121,10593,photo
CompanyJ_12098,OBJ ending the year with a beauty WOW via Browns ,49,5034,31655,36689,video
CompanyJ_12099,Dolphins stunned the Patriots Chiefs beat the Chargers That means KC gets a bye ,80,1609,12158,13767,photo
CompanyJ_12100,Jameis ends the 2019 season with a pick six He s the first player ever with 30 touchdowns and 30 interceptions Incredible brgridiron ,133,5643,32178,37821,photo
CompanyJ_12101,30 interceptions but 33 touchdowns brgridiron ,46,1008,9515,10523,photo
CompanyJ_12102,Kevin Harlan was calling Chiefs Chargers and Patriots Dolphins at the same time Masterclass in play by play via thecheckdown ,125,4179,27216,31395,video
CompanyJ_12103,The 2019 Ravens are the greatest running team in NFL history Baltimore passes the 1978 Patriots for most rushing yards in one season ,133,2374,10437,12811,photo
CompanyJ_12104, I ain t quitting I couldn t have tried any harder Philip Rivers showing his heart via Chargers ,96,964,8537,9501,video
CompanyJ_12105,Gelo Ball has joined the OKC Blue as a practice player per joe_mussatto ,72,1383,9654,11037,photo
CompanyJ_12106,Earlier this week Eli Manning and Daniel Jones are seen playing flip cup Today Giants scored a TD and started playing flip cup as their celebration via Giants ,159,951,9403,10354,video
CompanyJ_12107,SAQUON TOOK OFF via NFL ,24,1421,10014,11435,video
CompanyJ_12108,Dak hit em with the nasty stiff arm via NFL ,44,447,2865,3312,video
CompanyJ_12109,Joe Mixon went to celebrate the Bengals second win all year but the ref got in the way via ChaseLaub1 ,102,8814,53334,62148,video
CompanyJ_12110,On this play Derrick Henry went for 53 yards a TD the 2019 rushing title via NFL ,81,1237,8866,10103,video
CompanyJ_12111,Mason Crosby was focused on one thing today From B R x CoorsLight ,66,64,562,626,video
CompanyJ_12112,Eagles closed the door on the Cowboys playoff hopes brgridiron ,63,7734,27897,35631,video
CompanyJ_12113,Browns have fired head coach Freddie Kitchens per AdamSchefter mortreport ,74,2655,13279,15934,photo
CompanyJ_12114,They ve all punched their ticket to the postseason brgridiron ,62,1425,8828,10253,photo
CompanyJ_12115,It s time Seahawks vs 49ers ,28,360,2644,3004,photo
CompanyJ_12116,CHRIS BOUCHER WOW ,18,413,2896,3309,video
CompanyJ_12117,Beast Mode s first carry Still got it via NFL ,46,886,9429,10315,video
CompanyJ_12118,Justin Tucker did DaBaby s bop via thecheckdown ,48,16459,100159,116618,video
CompanyJ_12119,JOKIC BIG GUARD ,16,6203,37899,44102,video
CompanyJ_12120, JColeNC s got serious range via Cbrickley603 ,46,5865,28205,34070,video
CompanyJ_12121,Mamba x The Brow Kobe in attendance for Mavs vs Lakers tonight via Lakers ,74,1172,11560,12732,video
CompanyJ_12122,Russell Wilson Pinpoint pass via NFL ,37,302,3088,3390,video
CompanyJ_12123,Bron gets assist number 9 000 Only fitting it went to AD via NBA ,65,959,9110,10069,video
CompanyJ_12124,Zo put on an offensive clinic tonight vs Houston 27 PTS 10 REB 8 AST 7 12 3 PT More to come ,92,3164,23076,26240,photo
CompanyJ_12125,BEAST MODE ACTIVATED via NFL ,29,3153,20916,24069,video
CompanyJ_12126,Skittles SZN back in Seattle via Seahawks ,42,370,3244,3614,video
CompanyJ_12127,Kings of the NFC West Jimmy Garoppolo leads 49ers to 26 21 win over Seahawks and clinch No 1 seed in NFC ,105,2045,9278,11323,photo
CompanyJ_12128,LeBron and Kobe reunite at Staples via NBA ,43,4116,36286,40402,video
CompanyJ_12129,Shai capped off his 32 point night with the go ahead bucket against the defending champs RockstarGames ,103,179,2142,2321,video
CompanyJ_12130,In a league of his own ,23,4119,22319,26438,photo
CompanyJ_12131,Luka said Kobe was speaking to him in Slovenian from the sidelines He was talking Slovenian So I was like who s talking my language I saw Kobe and was really surprised via BenGolliver ,184,8341,64112,72453,video
CompanyJ_12132, 6 10 Missed playoffs Beat by 1 14 Bengals Freddie Kitchens fired hours after season ends Browns locker room brgridiron ,120,2904,13646,16550,video
CompanyJ_12133, 3x champ 3x Finals MVP 4x MVP 6x All Defensive 15x All Star 15x All NBA 4th in career points 9th in career assists Playoff points leader 35 years of wearing the crown Happy birthday KingJames ,193,17009,60264,77273,video
CompanyJ_12134,Only Mamba ,11,1324,13684,15008,photo
CompanyJ_12135,Drew Lock has BARS Broncos rookie QB was rapping Jeezy s Put On to perfection via thecheckdown ,95,2602,26704,29306,video
CompanyJ_12136,Bron reached 9K career assists last night Mentality started early ,66,1885,13942,15827,photo
CompanyJ_12137,Bron has been doing it all for 17 seasons Doesn t seem to be slowing down on his 35th birthday via NBA ,103,8438,32025,40463,video
CompanyJ_12138,Warriors are reportedly monitoring Karl Anthony Towns situation in Minnesota per SherwoodStrauss Multiple team executives believe Towns is unhappy in Minnesota ,160,1536,11458,12994,photo
CompanyJ_12139,Sheesh coach brgridiron ,24,3195,25693,28888,photo
CompanyJ_12140,Even with Steph sidelined Luka pays him the ultimate respect ,61,1139,11260,12399,video
CompanyJ_12141,Birthday Bron was clowning the Brow ,36,3453,28159,31612,video
CompanyJ_12142,Someone asked Gardner Minshew about putting up similar numbers to fellow rookies Kyler Murray and Daniel Jones Minshew corrected the question Better via _John_Shipley JaguarMaven ,179,1170,12211,13381,video
CompanyJ_12143, CountOnVic gives a tour of the freshest kicks from the brkicks drop up 1800Tequila ,84,29,224,253,video
CompanyJ_12144,JK Dobbins has declared for the NFL draft The Ohio State running back rushed for 2 003 yards and 21 TDs in 2019 ,112,2250,22204,24454,photo
CompanyJ_12145,Mamba has Dirk s respect ,25,2246,15262,17508,photo
CompanyJ_12146,Vince getting tricky in year 22 ,32,1982,19179,21161,video
CompanyJ_12147,Vince Carter s mom was there to cheer him on as he received a standing O from his home state of Florida via NBA ,112,1033,11286,12319,video
CompanyJ_12148,Giannis makes this look way too easy ,37,662,6573,7235,video
CompanyJ_12149,Coby White has MOVES RockstarGames ,35,223,2192,2415,video
CompanyJ_12150,Melo been hitting this for 17 years now ,40,4653,39453,44106,video
CompanyJ_12151,Dame hit 5 threes in the first quarter ,39,781,6581,7362,video
CompanyJ_12152,RKO OUTTA NOWHERE ,18,2305,15208,17513,link
CompanyJ_12153,James was involved in a car accident back in September that took his mom s life Tonight Portland invited James and his basketball team to meet CJ and the rest of the Blazers ,174,881,9659,10540,video
CompanyJ_12154,Kelly Oubre hit a big shot for the Suns late and blew kisses to Blazers fans ,77,1735,14684,16419,video
CompanyJ_12155, 2chainz getting that jumper right via LethalShooter__ ,55,885,7240,8125,video
CompanyJ_12156,Uncle DwyaneWade helping Bryce James get shots up at halftime of the Sierra Canyon game All in the family brhoops ,114,3162,34874,38036,video
CompanyJ_12157,Messi was watching Messi highlights at the gym via Valenjure1 ,62,702,8932,9634,photo
CompanyJ_12158,Giannis MVP season 27 7 PTS 12 5 REB 52 threes in 72 games Giannis so far this season 30 3 PTS 12 8 REB 53 threes in 32 games Greek Freak only getting better ,158,2637,20444,23081,photo
CompanyJ_12159,Ready for ,10,1996,16147,18143,photo
CompanyJ_12160,Not even working out can stop Todd Gurley from getting his 2K on You know he s picking his guy Melo GoogleStadia TG3II ad ,122,105,802,907,video
CompanyJ_12161,B R s All Decade NBA Awards MVP LeBron Defensive Player Draymond Green Best Team Warriors Best Playoff Series 2016 Finals Best Game 2016 WCF Game 6 Best Shot Ray Allen Game 6 2013 Coach Pop Trade Harden to the Rockets Signing The Decision ,239,4258,24360,28618,photo
CompanyJ_12162,AB says the Saints workout was a publicity stunt and they know what the film says New Orleans signed WR Tim White from the same workout yesterday brgridiron ,157,2096,16143,18239,video
CompanyJ_12163,Casual double meg via calebhendrikse_7 IG ,42,787,8926,9713,video
CompanyJ_12164,Browns and GM John Dorsey are leaning towards splitting today per AdamSchefter and mortreport ,94,196,1858,2054,photo
CompanyJ_12165, ,1,1700,14895,16595,photo
CompanyJ_12166, Gosh dang it I was spitting though Drew Lock on the viral clip of him rapping Put On during the game via RyanCBS4 ,115,5022,34854,39876,video
CompanyJ_12167,Playoff mode Texans have officially activated J J Watt The superstar was believed to be out for the year after tearing his pec in October ,138,1486,15108,16594,photo
CompanyJ_12168,As far back as Josh Allen can remember he s wanted to be part of the Bills Mafia New GridironHeights StateFarm ,111,778,2976,3754,video
CompanyJ_12169,2016 was the wildest year of the decade ,40,10683,53168,63851,photo
CompanyJ_12170,Zion and Pelicans are hopeful for his debut in January per ShamsCharania No 1 pick is expected to return to practice on shortly after the new year ,147,897,8562,9459,photo
CompanyJ_12171,New look for Kuz heading into 2020 via ali_behpoornia ,54,437,6873,7310,photo
CompanyJ_12172,Herm Edwards got a Frosted Flakes bath after winning the Sun Bowl via CBSSports ,80,654,6212,6866,video
